project_id,project_description,managing_agency_id,managing_agency,ten_year_plan_category,community_boards_served,borough,budget_lines,original_budget,city_prior_actuals,city2021,city2022,city2023,city2024,city2025,city_r_t_c,city_total,non_city_prior_actuals,non_city2021,non_city2022,non_city2023,non_city2024,non_city2025,non_city_r_t_c,non_city_total,combined_prior_actuals,combined2021,combined2022,combined2023,combined2024,combined2025,combined_r_t_c,combined_total,explanation_for_delay,project_location,scope_summary,source_pdf
LB20DUMBO,ADAMS STREET LIBRARY FIT OUT,038,BROOKLYN PUBLIC LIBRARY,ESSENTIAL RECONSTRUCTION OF FACILITIES,301,BROOKLYN,LB-0101 LB-0108 LB-0104,5000,0,5000,0,0,0,0,0,5000,0,5000,0,0,0,0,0,5000,0,10000,0,0,0,0,0,10000,PROJECT DELAYED DUE TO CHANGES IN SCOPE/DESIGN,,NEW BRANCH FIT OUT,cpd11-20bk.pdf
LBC17DRBR,DYKER INTERIOR RENOVATION,038,BROOKLYN PUBLIC LIBRARY,ESSENTIAL RECONSTRUCTION OF FACILITIES,310,BROOKLYN,LB-D104 LB-K001,1000,0,0,0,100,807,750,0,1657,0,0,0,100,807,750,0,1657,0,0,0,200,1614,1500,0,3314,,,DYKER INTERIOR RENOVATION,cpd11-20bk.pdf
LBC18CTRF,CORTELYOU ROOF,038,BROOKLYN PUBLIC LIBRARY,ESSENTIAL RECONSTRUCTION OF FACILITIES,314,BROOKLYN,LB-D104,850,0,0,0,0,1266,0,0,1266,0,0,0,0,1266,0,0,1266,0,0,0,0,2532,0,0,2532,PROJECT DELAYED DUE TO CHANGES IN SCOPE/DESIGN,,CORTELYOU ROOF,cpd11-20bk.pdf
LBC18FHSG,FT HAMILTON ROOF,038,BROOKLYN PUBLIC LIBRARY,ESSENTIAL RECONSTRUCTION OF FACILITIES,310,BROOKLYN,LB-D104,175,0,0,18,138,0,0,0,156,0,0,18,138,0,0,0,156,0,0,36,276,0,0,0,312,PROJECT DELAYED DUE TO CHANGES IN SCOPE/DESIGN,,FT HAMILTON ROOF,cpd11-20bk.pdf
LBC18GSMR,GRAVESEND MEETING ROOM,038,BROOKLYN PUBLIC LIBRARY,ESSENTIAL RECONSTRUCTION OF FACILITIES,315,BROOKLYN,LB-D104,300,0,0,30,242,0,0,0,272,0,0,30,242,0,0,0,272,0,0,60,484,0,0,0,544,PROJECT DELAYED DUE TO CHANGES IN SCOPE/DESIGN,,GRAVESEND MEETING ROOM,cpd11-20bk.pdf
LBC18KBFS,KINGS BAY FIRE SAFETY,038,BROOKLYN PUBLIC LIBRARY,ESSENTIAL RECONSTRUCTION OF FACILITIES,315,BROOKLYN,LB-D104,250,0,0,0,25,202,0,0,227,0,0,0,25,202,0,0,227,0,0,0,50,404,0,0,454,PROJECT DELAYED DUE TO CHANGES IN SCOPE/DESIGN,,KINGSBAY FIRE SAFETY,cpd11-20bk.pdf
LBC18KBHC,KINGS BAY BOILER,038,BROOKLYN PUBLIC LIBRARY,ESSENTIAL RECONSTRUCTION OF FACILITIES,315,BROOKLYN,LB-D104,750,0,0,0,75,606,0,0,681,0,0,0,75,606,0,0,681,0,0,0,150,1212,0,0,1362,PROJECT DELAYED DUE TO CHANGES IN SCOPE/DESIGN,,KINGSBAY BOILER,cpd11-20bk.pdf
LBC19CHEL,Clinton Hill Wiring Upgrade,038,BROOKLYN PUBLIC LIBRARY,ESSENTIAL RECONSTRUCTION OF FACILITIES,302,BROOKLYN,LB-D104,150,0,0,0,0,150,0,0,150,0,0,0,0,150,0,0,150,0,0,0,0,300,0,0,300,PROJECT DELAYED DUE TO CHANGES IN SCOPE/DESIGN,,CLINTON HILL WIRING UPGRADE.,cpd11-20bk.pdf
LBC20CTOP,CORTELYOU OUTDOOR PLAZA,038,BROOKLYN PUBLIC LIBRARY,ESSENTIAL RECONSTRUCTION OF FACILITIES,314,BROOKLYN,LB-D104,350,0,0,0,0,350,0,0,350,0,0,0,0,350,0,0,350,0,0,0,0,700,0,0,700,PROJECT DELAYED DUE TO CHANGES IN SCOPE/DESIGN,,CORTELYOU OUTDOOR PLAZA,cpd11-20bk.pdf
LBC20MPMR,MCKINLEY PARK MEETING ROOM,038,BROOKLYN PUBLIC LIBRARY,ESSENTIAL RECONSTRUCTION OF FACILITIES,310,BROOKLYN,LB-D104,250,0,0,0,250,0,0,0,250,0,0,0,250,0,0,0,250,0,0,0,500,0,0,0,500,PROJECT DELAYED DUE TO CHANGES IN SCOPE/DESIGN,,MCKINLEY PARK MEETING ROOM,cpd11-20bk.pdf
LBC20SAAD,STONE AVENUE ADA ACCESSIBILITY,038,BROOKLYN PUBLIC LIBRARY,ESSENTIAL RECONSTRUCTION OF FACILITIES,316,BROOKLYN,LB-D104,400,0,0,0,0,400,0,0,400,0,0,0,0,400,0,0,400,0,0,0,0,800,0,0,800,,,STONE AVENUE ADA ACCESSIBILITY,cpd11-20bk.pdf
LBC20SCBM,SPRING CREEK BMS,038,BROOKLYN PUBLIC LIBRARY,ESSENTIAL RECONSTRUCTION OF FACILITIES,305,BROOKLYN,LB-D104,150,0,0,0,0,150,0,0,150,0,0,0,0,150,0,0,150,0,0,0,0,300,0,0,300,,,SPRING CREEK BMS,cpd11-20bk.pdf
LBC21MNRF,MACOM ROOF REPLACEMENT,038,BROOKLYN PUBLIC LIBRARY,ESSENTIAL RECONSTRUCTION OF FACILITIES,303,BROOKLYN,LB-D104,0,0,0,0,150,1191,0,0,1341,0,0,0,150,1191,0,0,1341,0,0,0,300,2382,0,0,2682,,,LIBRARY ROOF RENOVATION.,cpd11-20bk.pdf
LBCENPH2,CENTRAL RENOVATION - PHASE 2,038,BROOKLYN PUBLIC LIBRARY,ESSENTIAL RECONSTRUCTION OF FACILITIES,301,BROOKLYN,LB-0104,26345,0,0,0,0,0,26345,0,26345,0,0,0,0,0,26345,0,26345,0,0,0,0,0,52690,0,52690,PROJECT DELAYED DUE TO CHANGES IN SCOPE/DESIGN,,CENTRAL RENOVATION - PHASE 2,cpd11-20bk.pdf
LBEM05SWR,SYSTEM-WIDE FUNDING,038,BROOKLYN PUBLIC LIBRARY,ESSENTIAL RECONSTRUCTION OF FACILITIES,301,BROOKLYN,LB-0104 LB-D104,43121,0,0,0,6265,0,4326,3306,13897,0,0,0,6265,0,4326,3306,13897,0,0,0,12530,0,8652,6612,27794,,,RENOVATIONS /REHABILITTION/ACQUISTION/INITAL OUTFITTING - SYSTEM WIDECAPITAL INITIATIVES,cpd11-20bk.pdf
LBK16HLRF,Highlawn - Roof Replacement,038,BROOKLYN PUBLIC LIBRARY,ESSENTIAL RECONSTRUCTION OF FACILITIES,311,BROOKLYN,LB-K001 LB-D104 LB-0101,988,0,0,86,818,0,0,0,904,0,0,86,818,0,0,0,904,0,0,172,1636,0,0,0,1808,PROJECT DELAYED DUE TO CHANGES IN SCOPE/DESIGN,,HIGHLAWN - ROOF REPLACEMENT,cpd11-20bk.pdf
LBK16SCRF,SPRING CREEK ROOF REPLACEMENT,038,BROOKLYN PUBLIC LIBRARY,ESSENTIAL RECONSTRUCTION OF FACILITIES,305,BROOKLYN,LB-D104 LB-K001,850,0,0,0,0,385,85,300,770,0,0,0,0,385,85,300,770,0,0,0,0,770,170,600,1540,,,SPRING CREEK ROOF REPLACEMENT,cpd11-20bk.pdf
LBM18NLOH,NEW LOTS BRANCH OVERHAUL,038,BROOKLYN PUBLIC LIBRARY,ESSENTIAL RECONSTRUCTION OF FACILITIES,305,BROOKLYN,LB-0104 LB-D104,28405,0,0,0,28405,0,0,0,28405,0,0,0,28405,0,0,0,28405,0,0,0,56810,0,0,0,56810,,,NEW LOTS OVERHAUL,cpd11-20bk.pdf
LBM19BPLB,Brower Park Library Fit Out,038,BROOKLYN PUBLIC LIBRARY,ESSENTIAL RECONSTRUCTION OF FACILITIES,308,BROOKLYN,LB-0107 LB-D107 LB-K107,3300,0,5200,0,0,0,0,0,5200,0,5200,0,0,0,0,0,5200,0,10400,0,0,0,0,0,10400,,,BROWER PARK LIBRARY FIT OUT,cpd11-20bk.pdf
LBM19CAOH,CANARSIE BRANCH OVERHAUL,038,BROOKLYN PUBLIC LIBRARY,ESSENTIAL RECONSTRUCTION OF FACILITIES,318,BROOKLYN,LB-0104,20000,0,0,0,5000,0,15000,0,20000,0,0,0,5000,0,15000,0,20000,0,0,0,10000,0,30000,0,40000,,,CANARSIE BRANCH OVERHAUL,cpd11-20bk.pdf
LBP18BHBR,BROOKLYN HEIGHTS BRANCH FIT OUT,038,BROOKLYN PUBLIC LIBRARY,ESSENTIAL RECONSTRUCTION OF FACILITIES,302,BROOKLYN,LB-0101 LB-0108 LB-0104,11000,0,16350,0,0,0,0,0,16350,0,16350,0,0,0,0,0,16350,0,32700,0,0,0,0,0,32700,,,BROOKLYN HEIGHTS BRANCH FIT OUT,cpd11-20bk.pdf
LBP18LDIN,LEONARD INFRASTRUCTURE UPGRADE,038,BROOKLYN PUBLIC LIBRARY,ESSENTIAL RECONSTRUCTION OF FACILITIES,301,BROOKLYN,LB-0101,3000,0,0,0,0,0,3000,0,3000,0,0,0,0,0,3000,0,3000,0,0,0,0,0,6000,0,6000,PROJECT DELAYED DUE TO CHANGES IN SCOPE/DESIGN,,LEONARD INFRASTRUCTURE UPGRADE,cpd11-20bk.pdf
LBP18PCAD,PACIFIC ADA COMPLIANCE,038,BROOKLYN PUBLIC LIBRARY,ESSENTIAL RECONSTRUCTION OF FACILITIES,306,BROOKLYN,LB-0101 LB-D104,3500,0,0,0,0,3725,0,0,3725,0,0,0,0,3725,0,0,3725,0,0,0,0,7450,0,0,7450,PROJECT DELAYED DUE TO CHANGES IN SCOPE/DESIGN,,PACIFIC ADA COMPLIANCE,cpd11-20bk.pdf
BY001-021,Quad Rehab Project,042,CITY UNIVERSITY,MISCELLANEOUS RECONSTRUCTION,300,BROOKLYN,HN-D300,500,0,500,0,0,0,0,0,500,0,500,0,0,0,0,0,500,0,1000,0,0,0,0,0,1000,,,QUAD REHAB PROJECT,cpd11-20bk.pdf
BY003-021,Ingersoll Lecture Hall Upgrades,042,CITY UNIVERSITY,MISCELLANEOUS RECONSTRUCTION,300,BROOKLYN,HN-D300,2000,0,821,1179,0,0,0,0,2000,0,821,1179,0,0,0,0,2000,0,1642,2358,0,0,0,0,4000,,,BROOKLYN COLLEGE,cpd11-20bk.pdf
BY024-012,Haitian Studies Institute Initial Outfitting,042,CITY UNIVERSITY,MISCELLANEOUS RECONSTRUCTION,300,BROOKLYN,HN-D300,100,0,0,0,0,100,0,0,100,0,0,0,0,100,0,0,100,0,0,0,0,200,0,0,200,PROJECT DELAYED DUE TO CHANGES IN SCOPE/DESIGN,,TECHNOLOGY AND CAPITAL IMPROVEMENT,cpd11-20bk.pdf
BY025-012,Haitian Studies Institute Initial Outfitting,042,CITY UNIVERSITY,MISCELLANEOUS RECONSTRUCTION,300,BROOKLYN,HN-D300,100,0,0,0,0,100,0,0,100,0,0,0,0,100,0,0,100,0,0,0,0,200,0,0,200,PROJECT DELAYED DUE TO CHANGES IN SCOPE/DESIGN,,TECHNOLOGY AND CAPITAL IMPROVEMENT,cpd11-20bk.pdf
BY026-013,Renovation of Ingersoll Extension,042,CITY UNIVERSITY,MISCELLANEOUS RECONSTRUCTION,314,BROOKLYN,HN-D300,1000,5797,0,0,0,459,0,0,6256,5797,0,0,0,459,0,0,6256,11594,0,0,0,918,0,0,12512,PROJECT DELAYED DUE TO CHANGES IN SCOPE/DESIGN,,RENOVATION OF INGERSOLL EXTENSION,cpd11-20bk.pdf
BY031-017,Electrical Upgrades,042,CITY UNIVERSITY,MISCELLANEOUS RECONSTRUCTION,300,BROOKLYN,HN-K300,500,0,0,0,0,500,0,0,500,0,0,0,0,500,0,0,500,0,0,0,0,1000,0,0,1000,PROJECT DELAYED DUE TO CHANGES IN SCOPE/DESIGN,,ELECTRICAL UPGRADES,cpd11-20bk.pdf
BY032-018,ADA Upgrades for the Brooklyn College Student Center,042,CITY UNIVERSITY,MISCELLANEOUS RECONSTRUCTION,300,BROOKLYN,HN-D300,2500,0,0,0,0,2500,0,0,2500,0,0,0,0,2500,0,0,2500,0,0,0,0,5000,0,0,5000,PROJECT DELAYED DUE TO CHANGES IN SCOPE/DESIGN,,ADA UPGRADES FOR THE BROOKLYN COLLEGE STUDENT CENTER,cpd11-20bk.pdf
BY033-019,Ingersoll Lecture Halls,042,CITY UNIVERSITY,MISCELLANEOUS RECONSTRUCTION,300,BROOKLYN,HN-D300,2000,0,0,2000,0,0,0,0,2000,0,0,2000,0,0,0,0,2000,0,0,4000,0,0,0,0,4000,PROJECT DELAYED DUE TO CHANGES IN SCOPE/DESIGN,,INGERSALL LECTURE HALLS,cpd11-20bk.pdf
BY034-019,Restoration of Main Quad,042,CITY UNIVERSITY,MISCELLANEOUS RECONSTRUCTION,300,BROOKLYN,HN-D300,724,0,0,0,0,724,0,0,724,0,0,0,0,724,0,0,724,0,0,0,0,1448,0,0,1448,PROJECT DELAYED DUE TO BUDGETARY CONSTRAINTS,,RESTORATION OF MAIN QUAD,cpd11-20bk.pdf
BY036-020,Main Quad Restoration,042,CITY UNIVERSITY,MISCELLANEOUS RECONSTRUCTION,300,BROOKLYN,HN-K300 HN-D300,2500,0,0,0,0,2500,0,0,2500,0,0,0,0,2500,0,0,2500,0,0,0,0,5000,0,0,5000,PROJECT DELAYED DUE TO CHANGES IN SCOPE/DESIGN,,MAIN QUAD RESTORATION,cpd11-20bk.pdf
BY037-020,Ingersoll Lecture Halls Upgrade,042,CITY UNIVERSITY,MISCELLANEOUS RECONSTRUCTION,300,BROOKLYN,HN-D300,2000,0,0,2000,0,0,0,0,2000,0,0,2000,0,0,0,0,2000,0,0,4000,0,0,0,0,4000,,,INGERSOLL LECTURE HALLS UPGRADE,cpd11-20bk.pdf
CA034KG13,Gas Booster Pump Upgrade,042,CITY UNIVERSITY,MISCELLANEOUS RECONSTRUCTION,300,BROOKLYN,HN-D005,127,28,0,0,99,0,0,0,127,28,0,0,99,0,0,0,127,56,0,0,198,0,0,0,254,,,GAS BOOSTER PUMP UPGRADE,cpd11-20bk.pdf
CA234KG13,Library Roof Replacement,042,CITY UNIVERSITY,MISCELLANEOUS RECONSTRUCTION,300,BROOKLYN,HN-0206,550,675,13132,379,0,0,0,0,14186,675,13132,379,0,0,0,0,14186,1350,26264,758,0,0,0,0,28372,,,LIBRARY ROOF REPLACEMENT,cpd11-20bk.pdf
KG001-021,LIbrary Building,042,CITY UNIVERSITY,MISCELLANEOUS RECONSTRUCTION,300,BROOKLYN,HN-D004,2000,0,2000,0,0,0,0,0,2000,0,2000,0,0,0,0,0,2000,0,4000,0,0,0,0,0,4000,,,KINGSBOROUGH COMMUNITY COLLEGE,cpd11-20bk.pdf
KG028-011,Performing Arts Center Renovations,042,CITY UNIVERSITY,MISCELLANEOUS RECONSTRUCTION,300,BROOKLYN,HN-0206 HN-D002 HN-K250,3000,644,0,0,1000,3000,2463,0,7107,644,0,0,1000,3000,2463,0,7107,1288,0,0,2000,6000,4926,0,14214,PROJECT DELAYED DUE TO BUDGETARY CONSTRAINTS,,PERFORMING ARTS CENTER RENOVATIONS,cpd11-20bk.pdf
KG030-012,Critical Maintenance A/P/U Buildings,042,CITY UNIVERSITY,MISCELLANEOUS RECONSTRUCTION,300,BROOKLYN,HN-D002 HN-D004,3000,3811,0,1100,0,0,0,0,4911,3811,0,1100,0,0,0,0,4911,7622,0,2200,0,0,0,0,9822,PROJECT DELAYED DUE TO CHANGES IN SCOPE/DESIGN,,CRITICAL MAINTENANCE A/P/U BUILDINGS,cpd11-20bk.pdf
KG031-013,Renovation of Pool Facilities,042,CITY UNIVERSITY,MISCELLANEOUS RECONSTRUCTION,300,BROOKLYN,HN-0206 HN-K250 HN-D002,1000,405,0,500,0,1595,0,0,2500,405,0,500,0,1595,0,0,2500,810,0,1000,0,3190,0,0,5000,PROJECT DELAYED DUE TO CHANGES IN SCOPE/DESIGN,,RENOVATION OF POOL FACILITIES,cpd11-20bk.pdf
KG033-017,Roof Replacements,042,CITY UNIVERSITY,MISCELLANEOUS RECONSTRUCTION,300,BROOKLYN,HN-D002,1000,0,0,1000,0,0,0,0,1000,0,0,1000,0,0,0,0,1000,0,0,2000,0,0,0,0,2000,PROJECT DELAYED DUE TO BUDGETARY CONSTRAINTS,,ROOF REPLACEMENTS,cpd11-20bk.pdf
KG043-018,Campus Roadway Improvements,042,CITY UNIVERSITY,MISCELLANEOUS RECONSTRUCTION,300,BROOKLYN,HN-D004,750,0,0,0,0,750,0,0,750,0,0,0,0,750,0,0,750,0,0,0,0,1500,0,0,1500,PROJECT DELAYED DUE TO CHANGES IN SCOPE/DESIGN,,CAMPUS ROADWAYS UPGRADES,cpd11-20bk.pdf
KG044-020,Marina Rehabilitation,042,CITY UNIVERSITY,MISCELLANEOUS RECONSTRUCTION,300,BROOKLYN,HN-D002,2000,0,0,0,2000,0,0,0,2000,0,0,0,2000,0,0,0,2000,0,0,0,4000,0,0,0,4000,,,MARINA REHABILITATION,cpd11-20bk.pdf
KG045-020,Performing Arts Center Upgrades,042,CITY UNIVERSITY,MISCELLANEOUS RECONSTRUCTION,300,BROOKLYN,HN-D002,2000,0,0,0,0,2000,0,0,2000,0,0,0,0,2000,0,0,2000,0,0,0,0,4000,0,0,4000,PROJECT DELAYED DUE TO CHANGES IN SCOPE/DESIGN,,PERFORMING ARTS CENTER UPGRADES,cpd11-20bk.pdf
KG201-006,Additional Roof Replacement,042,CITY UNIVERSITY,MISCELLANEOUS RECONSTRUCTION,300,BROOKLYN,HN-0206,1500,2132,0,203,0,0,0,0,2335,2132,0,203,0,0,0,0,2335,4264,0,406,0,0,0,0,4670,PROJECT DELAYED DUE TO CHANGES IN SCOPE/DESIGN,,CONTINUATION OF ROOF REPLACEMENT AT VARIOUS BUILDINGS.,cpd11-20bk.pdf
KG203-006,Gymnasium,042,CITY UNIVERSITY,"ATHLETIC FIELDS, GYMNASIUMS AND EQUIPMENT",300,BROOKLYN,HN-0206,3030,225,0,302,0,0,0,0,527,225,0,302,0,0,0,0,527,450,0,604,0,0,0,0,1054,PROJECT DELAYED DUE TO BUDGETARY CONSTRAINTS,,THIS PROJECT WILL BRING CHILLED WATER EXTENSION PIPING FROM EXISTING UNDERGROUND,cpd11-20bk.pdf
ME001-021,Athletic Center,042,CITY UNIVERSITY,MISCELLANEOUS RECONSTRUCTION,300,BROOKLYN,HN-D300,3000,0,3000,0,0,0,0,0,3000,0,3000,0,0,0,0,0,3000,0,6000,0,0,0,0,0,6000,,,MEDGAR EVERS,cpd11-20bk.pdf
ME018-005,LIBRARY EXPANSION,042,CITY UNIVERSITY,MISCELLANEOUS RECONSTRUCTION,300,BROOKLYN,HN-0206,5230,9651,0,0,75,0,0,0,9726,9651,0,0,75,0,0,0,9726,19302,0,0,150,0,0,0,19452,PROJECT DELAYED DUE TO CHANGES IN SCOPE/DESIGN,,NEW,cpd11-20bk.pdf
ME027-011,Carroll Street Building Upgrade,042,CITY UNIVERSITY,MISCELLANEOUS RECONSTRUCTION,300,BROOKLYN,HN-0206,1000,5000,0,0,219,0,0,0,5219,5000,0,0,219,0,0,0,5219,10000,0,0,438,0,0,0,10438,PROJECT DELAYED DUE TO CHANGES IN SCOPE/DESIGN,,ADDITIONAL FUNDING FOR UPGRADE OF BUILDING,cpd11-20bk.pdf
ME031-013,Virtual Desktop Infrastructure,042,CITY UNIVERSITY,MISCELLANEOUS RECONSTRUCTION,300,BROOKLYN,HN-D300,1400,1353,0,47,0,0,0,0,1400,1353,0,47,0,0,0,0,1400,2706,0,94,0,0,0,0,2800,PROJECT DELAYED DUE TO CHANGES IN SCOPE/DESIGN,,VIRTUAL DESKTOP INFRASTRUCTURE #3,cpd11-20bk.pdf
ME037-016,College Prep School Classroom Improvements,042,CITY UNIVERSITY,MISCELLANEOUS RECONSTRUCTION,300,BROOKLYN,HN-D300,65,0,0,0,65,0,0,0,65,0,0,0,65,0,0,0,65,0,0,0,130,0,0,0,130,PROJECT DELAYED DUE TO CHANGES IN SCOPE/DESIGN,,COLLEGE PREP SCHOOL CLASSROOM IMPROVEMENTS,cpd11-20bk.pdf
ME038-016,Child Development Center Upgrades,042,CITY UNIVERSITY,MISCELLANEOUS RECONSTRUCTION,300,BROOKLYN,HN-D300,1500,0,0,0,0,1500,0,0,1500,0,0,0,0,1500,0,0,1500,0,0,0,0,3000,0,0,3000,PROJECT DELAYED DUE TO CHANGES IN SCOPE/DESIGN,,CHILD DEVELOPMENT CENTER UPGRADES,cpd11-20bk.pdf
ME039-017,Student Lounge Upgrades,042,CITY UNIVERSITY,MISCELLANEOUS RECONSTRUCTION,300,BROOKLYN,HN-D300,1500,0,0,1500,0,0,0,0,1500,0,0,1500,0,0,0,0,1500,0,0,3000,0,0,0,0,3000,PROJECT DELAYED DUE TO CHANGES IN SCOPE/DESIGN,,STUDENT LOUNGE UPGRADES,cpd11-20bk.pdf
ME040-018,Differently-Abled Lab,042,CITY UNIVERSITY,MISCELLANEOUS RECONSTRUCTION,,BROOKLYN,HN-K300 HN-D300,1000,0,0,1550,0,0,0,0,1550,0,0,1550,0,0,0,0,1550,0,0,3100,0,0,0,0,3100,PROJECT DELAYED DUE TO CHANGES IN SCOPE/DESIGN,,DIFERENTLY-ABLED LAB,cpd11-20bk.pdf
ME041-018,Art and Historic Space Renovation,042,CITY UNIVERSITY,MISCELLANEOUS RECONSTRUCTION,300,BROOKLYN,HN-D300,1500,0,0,0,1500,0,0,0,1500,0,0,0,1500,0,0,0,1500,0,0,0,3000,0,0,0,3000,PROJECT DELAYED DUE TO CHANGES IN SCOPE/DESIGN,,ART AND HISTORIC SPACE RENOVATION,cpd11-20bk.pdf
ME042-019,Founder's Auditorium Renovation & Upgrades,042,CITY UNIVERSITY,MISCELLANEOUS RECONSTRUCTION,300,BROOKLYN,HN-D300,2250,0,0,0,2250,0,0,0,2250,0,0,0,2250,0,0,0,2250,0,0,0,4500,0,0,0,4500,PROJECT DELAYED DUE TO CHANGES IN SCOPE/DESIGN,,FOUNDER'S AUDITORIUM RENOVATION & UPGRADES,cpd11-20bk.pdf
ME043-020,Open Computer and Lab Digital Interactive Learning Spaces,042,CITY UNIVERSITY,MISCELLANEOUS RECONSTRUCTION,300,BROOKLYN,HN-K300,1000,0,0,1000,0,0,0,0,1000,0,0,1000,0,0,0,0,1000,0,0,2000,0,0,0,0,2000,,,OPEN COMPUTER AND LAB DIGITAL INTERACTIVE LEARNING SPACES,cpd11-20bk.pdf
ME044-020,Athletic Center,042,CITY UNIVERSITY,MISCELLANEOUS RECONSTRUCTION,300,BROOKLYN,HN-D300 HN-K300,2000,0,5000,0,0,0,0,0,5000,0,5000,0,0,0,0,0,5000,0,10000,0,0,0,0,0,10000,PROJECT DELAYED DUE TO CHANGES IN SCOPE/DESIGN,,ATHLETIC CENTER,cpd11-20bk.pdf
NY008-010,Student Lounge/Eating/Study Space Build-out,042,CITY UNIVERSITY,MISCELLANEOUS RECONSTRUCTION,302,BROOKLYN,HN-K300,734,0,0,0,0,0,734,0,734,0,0,0,0,0,734,0,734,0,0,0,0,0,1468,0,1468,PROJECT DELAYED PENDING RESOLUTION OF LEGAL ISSUES,,STUDENT LOUNGE/EATING/STUDY SPACE BUILD-OUT,cpd11-20bk.pdf
NY010-011,Library And Student Facilities Upgrade,042,CITY UNIVERSITY,MISCELLANEOUS RECONSTRUCTION,302,BROOKLYN,HN-K300,750,0,750,0,0,0,0,0,750,0,750,0,0,0,0,0,750,0,1500,0,0,0,0,0,1500,PROJECT DELAYED DUE TO CHANGES IN SCOPE/DESIGN,,LIBRARY AND STUDENT FACILITIES UPGRADE,cpd11-20bk.pdf
NY012-011,Initial Outfitting of the Biological Science Labs,042,CITY UNIVERSITY,MISCELLANEOUS RECONSTRUCTION,300,BROOKLYN,HN-D300,217,109,0,0,0,91,0,0,200,109,0,0,0,91,0,0,200,218,0,0,0,182,0,0,400,PROJECT DELAYED DUE TO CHANGES IN SCOPE/DESIGN,,INITIAL OUTFITTING OF THE BIOLOGICAL SCIENCE LABS,cpd11-20bk.pdf
NY013-012,Network Upgrades,042,CITY UNIVERSITY,MISCELLANEOUS RECONSTRUCTION,300,BROOKLYN,HN-D300,1500,1472,0,247,28,0,0,0,1747,1472,0,247,28,0,0,0,1747,2944,0,494,56,0,0,0,3494,PROJECT DELAYED DUE TO CHANGES IN SCOPE/DESIGN,,NETWORK UPGRADES,cpd11-20bk.pdf
NY014-013,Upgrade of Hospitality and Culinary Arts Facilities,042,CITY UNIVERSITY,MISCELLANEOUS RECONSTRUCTION,302,BROOKLYN,HN-K300,750,0,0,750,0,0,0,0,750,0,0,750,0,0,0,0,750,0,0,1500,0,0,0,0,1500,PROJECT DELAYED DUE TO CHANGES IN SCOPE/DESIGN,,UPGRADE OF HOSPITALITY AND CULINARY ARTS FACILITIES,cpd11-20bk.pdf
NY018-014,Dental Hygiene Facilities Upgrade,042,CITY UNIVERSITY,MISCELLANEOUS RECONSTRUCTION,300,BROOKLYN,HN-D300,400,0,0,400,0,0,0,0,400,0,0,400,0,0,0,0,400,0,0,800,0,0,0,0,800,PROJECT DELAYED DUE TO CHANGES IN SCOPE/DESIGN,,DENTAL HYGIENE FACILITIES UPGRADE,cpd11-20bk.pdf
NY019-015,Fabrication Laboratory,042,CITY UNIVERSITY,MISCELLANEOUS RECONSTRUCTION,300,BROOKLYN,HN-K300,400,0,0,0,0,0,400,0,400,0,0,0,0,0,400,0,400,0,0,0,0,0,800,0,800,PROJECT DELAYED DUE TO CHANGES IN SCOPE/DESIGN,,FABRICATION LABORATORY,cpd11-20bk.pdf
NY020-015,Academic Learning Center Renovations,042,CITY UNIVERSITY,MISCELLANEOUS RECONSTRUCTION,300,BROOKLYN,HN-D300,400,0,0,0,0,400,0,0,400,0,0,0,0,400,0,0,400,0,0,0,0,800,0,0,800,PROJECT DELAYED DUE TO CHANGES IN SCOPE/DESIGN,,ACADEMIC LEARNING CENTER RENOVATIONS,cpd11-20bk.pdf
NY021-016,Academic Learning Center Renovations and Equipment,042,CITY UNIVERSITY,MISCELLANEOUS RECONSTRUCTION,300,BROOKLYN,HN-D300,1290,0,0,0,0,1290,0,0,1290,0,0,0,0,1290,0,0,1290,0,0,0,0,2580,0,0,2580,PROJECT DELAYED DUE TO CHANGES IN SCOPE/DESIGN,,ACADEMIC LEARNING CENTER RENOVATIONS & EQUIPMENT,cpd11-20bk.pdf
NY023-017,Science Lab Renovations,042,CITY UNIVERSITY,MISCELLANEOUS RECONSTRUCTION,300,BROOKLYN,HN-D300,2500,0,0,2500,0,0,0,0,2500,0,0,2500,0,0,0,0,2500,0,0,5000,0,0,0,0,5000,PROJECT DELAYED DUE TO CHANGES IN SCOPE/DESIGN,,SCIENCE LAB RENOVATIONS,cpd11-20bk.pdf
NY024-018,Exterior Space Improvements,042,CITY UNIVERSITY,MISCELLANEOUS RECONSTRUCTION,300,BROOKLYN,HN-D300,500,0,0,500,0,0,0,0,500,0,0,500,0,0,0,0,500,0,0,1000,0,0,0,0,1000,PROJECT DELAYED DUE TO CHANGES IN SCOPE/DESIGN,,UPGRADE EXTERIOR SPACES AT NEW YORK CITY TECH,cpd11-20bk.pdf
NY025-018,Pearl Street Building Renovation,042,CITY UNIVERSITY,MISCELLANEOUS RECONSTRUCTION,300,BROOKLYN,HN-D300 HN-D004 HN-0300 HN-K002 HN-K300,2500,1761,950,555,0,0,0,0,3266,1761,950,555,0,0,0,0,3266,3522,1900,1110,0,0,0,0,6532,PROJECT DELAYED DUE TO CHANGES IN SCOPE/DESIGN,,PEARL STREET BUILDING RENOVATION,cpd11-20bk.pdf
NY028-020,Pearl Building Renovations,042,CITY UNIVERSITY,MISCELLANEOUS RECONSTRUCTION,300,BROOKLYN,HN-D300,2500,0,0,2500,0,0,0,0,2500,0,0,2500,0,0,0,0,2500,0,0,5000,0,0,0,0,5000,PROJECT DELAYED DUE TO CHANGES IN SCOPE/DESIGN,,PEARL BUILDING RENOVATIONS,cpd11-20bk.pdf
SAND-KG02,HVAC Repair/Replacement - Sandy Related,042,CITY UNIVERSITY,MISCELLANEOUS RECONSTRUCTION,300,BROOKLYN,HN-0206,285,28,0,0,486,0,0,0,514,28,0,0,486,0,0,0,514,56,0,0,972,0,0,0,1028,PROJECT DELAYED DUE TO CHANGES IN SCOPE/DESIGN,,HVAC REPAIR/REPLACEMENT - SANDY RELATED,cpd11-20bk.pdf
SAND-KG03,Marina Reconstruction,042,CITY UNIVERSITY,MISCELLANEOUS RECONSTRUCTION,300,BROOKLYN,HN-K250 HN-0206,2592,43,0,2500,1270,0,0,0,3813,43,0,2500,1270,0,0,0,3813,86,0,5000,2540,0,0,0,7626,PROJECT DELAYED DUE TO CHANGES IN SCOPE/DESIGN,,MARINA RECONSTRUCTION,cpd11-20bk.pdf
NDF-PENN,NDF - 127 Pennsylvania Ave Community Center,056,POLICE DEPARTMENT,NEIGHBORHOOD REVITALIZATION,300,BROOKLYN,ED-0384,4909,9019,1680,0,0,0,0,0,10699,9019,1680,0,0,0,0,0,10699,18038,3360,0,0,0,0,0,21398,,,NYPD - 127 PENNSYLVANIA AVENUE COMMUNICATIONS CENTER,cpd11-20bk.pdf
PO7911FR,11 FRONT STR RENOVATION,056,POLICE DEPARTMENT,POLICE FACILITIES,300,BROOKLYN,PO-0079,3747,5857,193,0,0,0,0,0,6050,5857,193,0,0,0,0,0,6050,11714,386,0,0,0,0,0,12100,,,11 FRONT STR RENOVATION,cpd11-20bk.pdf
PO79BMAHS,FIRING RANGE RECONSTRUCTION AT CONEY ISLAND,056,POLICE DEPARTMENT,POLICE FACILITIES,300 313,BROOKLYN,PO-0079,2591,443,2147,0,0,0,0,0,2590,443,2147,0,0,0,0,0,2590,886,4294,0,0,0,0,0,5180,PROJECT DELAYED DUE TO CHANGES IN SCOPE/DESIGN,"2556 MCDONALD AV, BRROKLYN NY",RANGE RECONSTRUCTION,cpd11-20bk.pdf
PO79BMAKG,FBF AVIATION AND DRIVER TRAINING UNIT ROOF REHABILITATION,056,POLICE DEPARTMENT,POLICE FACILITIES,300,BROOKLYN,PO-0079,2756,0,350,1500,906,0,0,0,2756,0,350,1500,906,0,0,0,2756,0,700,3000,1812,0,0,0,5512,,,SCOPE DESCRIPTION,cpd11-20bk.pdf
PO79BMAKJ,REHABILITATION OF 67TH PCT ELEVATOR,056,POLICE DEPARTMENT,POLICE FACILITIES,300,BROOKLYN,PO-0079,1500,0,0,1500,0,0,0,0,1500,0,0,1500,0,0,0,0,1500,0,0,3000,0,0,0,0,3000,,,ESTIMATE,cpd11-20bk.pdf
PO79BMAKQ,66TH PCT RENOVATION,056,POLICE DEPARTMENT,POLICE FACILITIES,300,BROOKLYN,PO-0079,600,0,100,581,0,0,0,0,681,0,100,581,0,0,0,0,681,0,200,1162,0,0,0,0,1362,,,ESTIMATE,cpd11-20bk.pdf
PO79BMAKR,88TH PCT ROOF REPLACEMENT,056,POLICE DEPARTMENT,POLICE FACILITIES,300,BROOKLYN,PO-0079,600,0,600,0,0,0,0,0,600,0,600,0,0,0,0,0,600,0,1200,0,0,0,0,0,1200,,,ESTIMATE,cpd11-20bk.pdf
PO79BMAKS,81ST PCT ROOF REPLACEMENT,056,POLICE DEPARTMENT,POLICE FACILITIES,300,BROOKLYN,PO-0079,600,0,600,0,0,0,0,0,600,0,600,0,0,0,0,0,600,0,1200,0,0,0,0,0,1200,,,ESTIMATE,cpd11-20bk.pdf
PO79BMAKT,60TH PCT ROOF REPLACEMENT,056,POLICE DEPARTMENT,POLICE FACILITIES,300,BROOKLYN,PO-0079,600,0,200,0,400,0,0,0,600,0,200,0,400,0,0,0,600,0,400,0,800,0,0,0,1200,,,ESTIMATE,cpd11-20bk.pdf
PO79BMAKW,245 GLENMORE ROOF REPLACEMENT,056,POLICE DEPARTMENT,POLICE FACILITIES,300,BROOKLYN,PO-0079,300,0,300,0,0,0,0,0,300,0,300,0,0,0,0,0,300,0,600,0,0,0,0,0,600,,,ESTIMATE,cpd11-20bk.pdf
PO79TD32,TRANSIT DISTRICT 32 ROOF RENOVATION,056,POLICE DEPARTMENT,POLICE FACILITIES,300,BROOKLYN,PO-0079,480,539,325,0,0,0,0,0,864,539,325,0,0,0,0,0,864,1078,650,0,0,0,0,0,1728,PROJECT DELAYED DUE TO UNFORESEEN SITE/FIELD CONDITION,"960 CAROLL STREET, BROOKLYN",ROOF RENOVATION,cpd11-20bk.pdf
PODMTRPE,Mounted Unit facility betterment,056,POLICE DEPARTMENT,POLICE FACILITIES,300,BROOKLYN,PO-D079 PO-0079,104,0,123,0,0,0,0,0,123,0,123,0,0,0,0,0,123,0,246,0,0,0,0,0,246,,,ESTIMATE,cpd11-20bk.pdf
PO-KVEST,PEOPLE'S PRECINCTS VESTIBULE REDESIGN,056,POLICE DEPARTMENT,POLICE FACILITIES,300,BROOKLYN,PO-K079,1000,228,772,0,0,0,0,0,1000,228,772,0,0,0,0,0,1000,456,1544,0,0,0,0,0,2000,,,RENOVATION,cpd11-20bk.pdf
SANDCD13,PROPERTY CLERK ELECTRICAL CONDUIT,056,POLICE DEPARTMENT,POLICE FACILITIES,300,BROOKLYN,PO-0079,9704,0,971,0,0,0,0,0,971,0,971,0,0,0,0,0,971,0,1942,0,0,0,0,0,1942,PROJECT DELAYED DUE TO UNFORESEEN SITE/FIELD CONDITION,ERIE BASIN PROPERTY CLERK,PROPERTY CLERK,cpd11-20bk.pdf
SANDCD3,POLICE SERVICE AREA 1 (PSA1),056,POLICE DEPARTMENT,POLICE FACILITIES,300,BROOKLYN,PO-0079,322,6,27,0,0,0,0,0,33,6,27,0,0,0,0,0,33,12,54,0,0,0,0,0,66,PROJECT DELAYED DUE TO UNFORESEEN SITE/FIELD CONDITION,2860 WEST 23RD STREET BROOKLYN,ELECTRICAL REHABILITATION,cpd11-20bk.pdf
SANDCD4,FLOYD BENNETT FIELD ELECTRICAL,056,POLICE DEPARTMENT,POLICE FACILITIES,300,BROOKLYN,PO-0079,575,0,58,0,0,0,0,0,58,0,58,0,0,0,0,0,58,0,116,0,0,0,0,0,116,PROJECT DELAYED DUE TO UNFORESEEN SITE/FIELD CONDITION,,ELECTRICAL REHABILITATION,cpd11-20bk.pdf
SANDCD5,TRANSIT DISTRICT 34 ELECTRICAL,056,POLICE DEPARTMENT,POLICE FACILITIES,300,BROOKLYN,PO-0079,1058,7,99,0,0,0,0,0,106,7,99,0,0,0,0,0,106,14,198,0,0,0,0,0,212,PROJECT DELAYED DUE TO UNFORESEEN SITE/FIELD CONDITION,,ELECTRICAL REHABILITATION,cpd11-20bk.pdf
SANDWARE,23RD STR WAREHOUSE RECONSTRUCTION,056,POLICE DEPARTMENT,POLICE FACILITIES,300,BROOKLYN,PO-0079,8434,0,872,0,0,0,0,0,872,0,872,0,0,0,0,0,872,0,1744,0,0,0,0,0,1744,,,RECONSTRUCTION,cpd11-20bk.pdf
ACEFDN701,FDNY - LED LIGHTING UPGRADE AT 14 FDNY FACILITIES,057,FIRE DEPARTMENT,"BUILDING CONSTRUCTION, RECONSTRUCTION OR RETROFIT",301,BROOKLYN,PU-0025,1084,427,656,0,0,0,0,0,1083,427,656,0,0,0,0,0,1083,854,1312,0,0,0,0,0,2166,,,FDNY - LED LIGHTING UPGRADE AT 14 FDNY FACILITIES,cpd11-20bk.pdf
ACEFDN703,FDNY - DESIGN & INSTALLATION OF 37 KW SOLAR SYSTEM AT EC332,057,FIRE DEPARTMENT,"BUILDING CONSTRUCTION, RECONSTRUCTION OR RETROFIT",301,BROOKLYN,PU-0025,235,44,518,0,0,0,0,0,562,44,518,0,0,0,0,0,562,88,1036,0,0,0,0,0,1124,,,FDNY - DESIGN & INSTALLATION OF 37 KW SOLAR PHOTOVOLTAIC SYSTEM AT EC3332,cpd11-20bk.pdf
ACEFDN801,FDNY - Solar Photo-voltaic system at EMS 58,057,FIRE DEPARTMENT,"BUILDING CONSTRUCTION, RECONSTRUCTION OR RETROFIT",301,BROOKLYN,PU-0025,257,37,0,221,0,0,0,0,258,37,0,221,0,0,0,0,258,74,0,442,0,0,0,0,516,,,SOLAR PHOTO-VOLTAIC SYSTEM AT EMS 58,cpd11-20bk.pdf
F175MC218,Multi-Component Renovations - EC218,057,FIRE DEPARTMENT,NEW FACILITIES AND RENOVATIONS,304,BROOKLYN,F-0175,5598,676,0,5250,0,0,0,0,5926,676,0,5250,0,0,0,0,5926,1352,0,10500,0,0,0,0,11852,PROJECT DELAYED DUE TO BUDGETARY CONSTRAINTS,,MULTI-COMPONENT RENOVATIONS - EC218,cpd11-20bk.pdf
F175MC224,"FLOOR, KITCHEN L-OHD - EC224",057,FIRE DEPARTMENT,NEW FACILITIES AND RENOVATIONS,302,BROOKLYN,F-0175,2282,8123,2822,0,0,0,0,0,10945,8123,2822,0,0,0,0,0,10945,16246,5644,0,0,0,0,0,21890,PROJECT DELAYED DUE TO BUDGETARY CONSTRAINTS,,"FLOOR, KITCHEN L-OHD - EC224",cpd11-20bk.pdf
FD175E249,ROOF REPLACEMENT - EC249,057,FIRE DEPARTMENT,NEW FACILITIES AND RENOVATIONS,309,BROOKLYN,F-D175,50,0,0,0,0,0,0,50,50,0,0,0,0,0,0,50,50,0,0,0,0,0,0,100,100,PROJECT DELAYED DUE TO BUDGETARY CONSTRAINTS,,ROOF REPLACEMENT,cpd11-20bk.pdf
FD175W245,WINDOW REPLACEMENT - EC245,057,FIRE DEPARTMENT,NEW FACILITIES AND RENOVATIONS,313,BROOKLYN,F-D175,750,261,488,0,0,0,0,0,749,261,488,0,0,0,0,0,749,522,976,0,0,0,0,0,1498,PROJECT DELAYED DUE TO BUDGETARY CONSTRAINTS,,WINDOW REPLACEMENT - EC245,cpd11-20bk.pdf
FD175W248,WINDOW REPLACEMENT - EC248,057,FIRE DEPARTMENT,NEW FACILITIES AND RENOVATIONS,317,BROOKLYN,F-D175,375,161,214,0,0,0,0,0,375,161,214,0,0,0,0,0,375,322,428,0,0,0,0,0,750,PROJECT DELAYED DUE TO BUDGETARY CONSTRAINTS,,WINDOW REPLACEMENT - EC248,cpd11-20bk.pdf
FD175W330,Window Replacement - EC330,057,FIRE DEPARTMENT,NEW FACILITIES AND RENOVATIONS,311,BROOKLYN,F-D175 F-0175,582,249,478,0,0,0,0,0,727,249,478,0,0,0,0,0,727,498,956,0,0,0,0,0,1454,,,WINDOW REPLACEMENT - EC330,cpd11-20bk.pdf
JJZROSSLB,THE CROSSROADS JUVENILE CENTER - LIBRARY RENOVATION,068,ADMIN FOR CHILDREN'S SERVICES,SOCIAL SERVICE BUILDINGS,316,BROOKLYN,CS-K001,250,144,100,0,0,0,0,0,244,144,100,0,0,0,0,0,244,288,200,0,0,0,0,0,488,PROJECT DELAYED DUE TO CHANGES IN SCOPE/DESIGN,,RENOVATION OF LIBRARY ROOM AND EQUIPMENT PURCHASE,cpd11-20bk.pdf
HH112AUBR,AUBURN ADULT RESIDENCE - BATHROOM UPGRADE,071,DEPT OF HOMELESS SERVICES,SHELTERS FOR HOMELESS INDIVIDUALS,,BROOKLYN,HH-0112,5150,8766,120,0,0,0,0,0,8886,8766,120,0,0,0,0,0,8886,17532,240,0,0,0,0,0,17772,PROJECT DELAYED DUE TO CHANGES IN SCOPE/DESIGN,,"AUBURN ADULT RESIDENCE - ALL ARCHITECTURAL , MECHANICAL AND PLUMBING WORK REQUIRED TO",cpd11-20bk.pdf
HH112HWCR,HELP WOMEN'S CENTER ROOF,071,DEPT OF HOMELESS SERVICES,SHELTERS FOR HOMELESS INDIVIDUALS,,BROOKLYN,HH-0112,780,60,0,720,0,0,0,0,780,60,0,720,0,0,0,0,780,120,0,1440,0,0,0,0,1560,,,HELP WOMEN'S CENTER ROOF,cpd11-20bk.pdf
HH112LFER,LINDEN MEN'S SHELTER - ELEVATOR REPLACEMENT,071,DEPT OF HOMELESS SERVICES,SHELTERS FOR HOMELESS INDIVIDUALS,305,BROOKLYN,HH-0112,530,80,80,450,0,0,0,0,610,80,80,450,0,0,0,0,610,160,160,900,0,0,0,0,1220,,,LINDEN MEN'S SHELTER - ELEVATOR REPLACEMENT,cpd11-20bk.pdf
HH112LINT,85 LEXINGTON AVE BATHROOM RECONSTRUCTION,071,DEPT OF HOMELESS SERVICES,SHELTERS FOR HOMELESS INDIVIDUALS,,BROOKLYN,HH-0112,504,0,0,42,0,462,0,0,504,0,0,42,0,462,0,0,504,0,0,84,0,924,0,0,1008,,,BATHROOM RECONSTRUCTION,cpd11-20bk.pdf
HH112LMEP,LINDEN BOILER RECONSTRUCTION,071,DEPT OF HOMELESS SERVICES,SHELTERS FOR HOMELESS INDIVIDUALS,,BROOKLYN,HH-0112,1950,0,300,0,1650,0,0,0,1950,0,300,0,1650,0,0,0,1950,0,600,0,3300,0,0,0,3900,,,BOILER RECONSTRUCTION,cpd11-20bk.pdf
HH112PAFL,PAMOJA HOUSE FLOOR,071,DEPT OF HOMELESS SERVICES,SHELTERS FOR HOMELESS INDIVIDUALS,303,BROOKLYN,HH-0112,1475,125,0,0,1350,0,0,0,1475,125,0,0,1350,0,0,0,1475,250,0,0,2700,0,0,0,2950,,,RECONSTRUCT DORM FLOORS,cpd11-20bk.pdf
HH112PJBP,PAMOJA HOUSE INSTALLATION OF BLACK FLOW PREVENTER,071,DEPT OF HOMELESS SERVICES,SHELTERS FOR HOMELESS INDIVIDUALS,303,BROOKLYN,HH-0112,175,175,0,0,0,146,0,0,321,175,0,0,0,146,0,0,321,350,0,0,0,292,0,0,642,PROJECT DELAYED DUE TO CHANGES IN SCOPE/DESIGN,,PAMOJA HOUSE-INSTALLATION OF BACK FLOW PREVENTER TO AVOID CONTAMINATION DUE TO BACK,cpd11-20bk.pdf
HH112PJRR,PAMOJA HOUSE - ROOF REPLACEMENT,071,DEPT OF HOMELESS SERVICES,SHELTERS FOR HOMELESS INDIVIDUALS,303,BROOKLYN,HH-0112,1999,3032,0,0,3207,2550,0,0,8789,3032,0,0,3207,2550,0,0,8789,6064,0,0,6414,5100,0,0,17578,PROJECT DELAYED DUE TO BUDGETARY CONSTRAINTS,,PAMOJA HOUSE - ROOF REPLACEMENT,cpd11-20bk.pdf
HH112PREK,RENOVATION AND IMPROVEMENTS TO THE PARK SLOPE ARMORY,071,DEPT OF HOMELESS SERVICES,SHELTERS FOR HOMELESS INDIVIDUALS,306,BROOKLYN,HH-D025,1500,0,0,1500,0,0,0,0,1500,0,0,1500,0,0,0,0,1500,0,0,3000,0,0,0,0,3000,PROJECT DELAYED DUE TO CHANGES IN SCOPE/DESIGN,,PARK SLOPE ARMORY-REHABILITATION OF ROOMS FOR PRE-K PROGRAM,cpd11-20bk.pdf
HH112PSR1,PARK SLOPE - ROOF REPLACEMENT,071,DEPT OF HOMELESS SERVICES,SHELTERS FOR HOMELESS INDIVIDUALS,306,BROOKLYN,HH-0112,5250,3719,450,0,0,0,0,0,4169,3719,450,0,0,0,0,0,4169,7438,900,0,0,0,0,0,8338,,,PARK SLOPE - ROOF REPLACEMENT,cpd11-20bk.pdf
HH115BFRR,Bushwick Family Roof Replacement,071,DEPT OF HOMELESS SERVICES,SHELTERS FOR HOMELESS INDIVIDUALS,,BROOKLYN,HH-0115,2600,200,400,0,2400,0,0,0,3000,200,400,0,2400,0,0,0,3000,400,800,0,4800,0,0,0,6000,,,ROOF REPLACEMENT,cpd11-20bk.pdf
HH115BINT,BUSHWICK FAMILY FACADE RECONSTRUCTION,071,DEPT OF HOMELESS SERVICES,SHELTERS FOR HOMELESS FAMILIES,,BROOKLYN,HH-0112,1920,0,0,0,160,0,1760,0,1920,0,0,0,160,0,1760,0,1920,0,0,0,320,0,3520,0,3840,,,RECONSTRUCT FACADE,cpd11-20bk.pdf
HH115FBME,FANNIE BARNES BOILER RECONSTRUCTION,071,DEPT OF HOMELESS SERVICES,SHELTERS FOR HOMELESS FAMILIES,316,BROOKLYN,HH-0112,1008,0,924,0,0,0,0,0,924,0,924,0,0,0,0,0,924,0,1848,0,0,0,0,0,1848,,,RECON BOILER,cpd11-20bk.pdf
HH115FLRF,FLATLANDS ROOF REPLACEMENT,071,DEPT OF HOMELESS SERVICES,SHELTERS FOR HOMELESS FAMILIES,318,BROOKLYN,HH-0115,1950,150,0,1800,0,0,0,0,1950,150,0,1800,0,0,0,0,1950,300,0,3600,0,0,0,0,3900,,,ROOF REPLACEMENT AT FLATLANDS FAMILY RESIDENCE,cpd11-20bk.pdf
HH115MMEP,WAYSIDE MACDONOUGH BOILER RECONS,071,DEPT OF HOMELESS SERVICES,SHELTERS FOR HOMELESS INDIVIDUALS,,BROOKLYN,HH-0115,300,25,275,0,0,0,0,0,300,25,275,0,0,0,0,0,300,50,550,0,0,0,0,0,600,,,RECONSTRUCT BOILER,cpd11-20bk.pdf
HH115RMCX,ROSE MCCARTHY - WINDOW REPLACEMENT AND EXTERIOR RECONSTRUCT,071,DEPT OF HOMELESS SERVICES,SHELTERS FOR HOMELESS FAMILIES,,BROOKLYN,HH-0115,0,115,0,0,483,0,0,0,598,115,0,0,483,0,0,0,598,230,0,0,966,0,0,0,1196,PROJECT DELAYED DUE TO BUDGETARY CONSTRAINTS,,ROSE MCCARTHY - WINDOW REPLACEMENT AND EXTERIOR RECONSTRUCTION,cpd11-20bk.pdf
HH115SAEU,FANNIE BARNES EXTERIOR UPGRADE,071,DEPT OF HOMELESS SERVICES,SHELTERS FOR HOMELESS FAMILIES,316,BROOKLYN,HH-0115,3900,300,0,0,1600,2000,0,0,3900,300,0,0,1600,2000,0,0,3900,600,0,0,3200,4000,0,0,7800,,,FANNIE BARNES EXTERIOR UPGRADE,cpd11-20bk.pdf
HH115SEXT,STOCKHOLM FAMILY CENTER - ROOF AND FACADE RECONSTRUCTION,071,DEPT OF HOMELESS SERVICES,SHELTERS FOR HOMELESS FAMILIES,,BROOKLYN,HH-0112,1008,0,0,84,0,924,0,0,1008,0,0,84,0,924,0,0,1008,0,0,168,0,1848,0,0,2016,,,ROOF AND FACADE,cpd11-20bk.pdf
HH115STEP,STOCKHOLM FAMILY CENTER -BOILER RECONSTRUCTION,071,DEPT OF HOMELESS SERVICES,SHELTERS FOR HOMELESS FAMILIES,,BROOKLYN,HH-0115,1152,96,0,1056,0,0,0,0,1152,96,0,1056,0,0,0,0,1152,192,0,2112,0,0,0,0,2304,,,BOILER RECON,cpd11-20bk.pdf
HHCN001,BROOKLYN NEIGHBORHOOD IMPROVEMENT DIST.-BEDFORD AVE. RENOVAT,071,DEPT OF HOMELESS SERVICES,SHELTERS FOR HOMELESS FAMILIES,,BROOKLYN,HH-D025,300,0,0,384,0,0,0,0,384,0,0,384,0,0,0,0,384,0,0,768,0,0,0,0,768,PROJECT DELAYED DUE TO BUDGETARY CONSTRAINTS,,BROOKLYN NEIGHBORHOOD IMPROVEMENT DIST.-BEDFORD AVE. RENOVATION,cpd11-20bk.pdf
HHCN002,RENOVATION OF BEDFORD ATLANTIC ARMORY INTO RECREATIONAL CTR.,071,DEPT OF HOMELESS SERVICES,SHELTERS FOR HOMELESS FAMILIES,308,BROOKLYN,HH-D025,3000,0,0,0,0,3000,0,0,3000,0,0,0,0,3000,0,0,3000,0,0,0,0,6000,0,0,6000,PROJECT DELAYED DUE TO BUDGETARY CONSTRAINTS,,RENOVATION OF BEDFORD ATLANTIC ARMORY INTO RECREATIONAL CTR.,cpd11-20bk.pdf
HHCN003,BEDFORD ATLANTIC ARMORY ATHLETIC CENTER,071,DEPT OF HOMELESS SERVICES,SHELTERS FOR HOMELESS INDIVIDUALS,309,BROOKLYN,HH-D112,250,0,0,0,250,0,0,0,250,0,0,0,250,0,0,0,250,0,0,0,500,0,0,0,500,PROJECT DELAYED DUE TO BUDGETARY CONSTRAINTS,,BEDFORD ATHLETIC ARMORY ATHLETIC CENTER,cpd11-20bk.pdf
SOLARDHS3,Solar PV system - Flatlands Residence,071,DEPT OF HOMELESS SERVICES,MISCELLANEOUS ENERGY EFFICIENCY AND SUSTAINABILITY,301,BROOKLYN,PU-0025,339,0,0,309,0,0,0,0,309,0,0,309,0,0,0,0,309,0,0,618,0,0,0,0,618,,,"SOLAR PV SYSTEM - FLATLANDS RESIDENCE LOCATED AT 108-75 AVENUE D, BROOKLYN",cpd11-20bk.pdf
HR25BRCS,Brownsville Community Center,096,HUMAN RESOURCES ADMINISTRATION,SOCIAL SERVICES BUILDINGS,,BROOKLYN,HR-0025,22167,0,0,0,0,0,0,22165,22165,0,0,0,0,0,0,22165,22165,0,0,0,0,0,0,44330,44330,,,BROWNSVILLE COMMUNITY CENTER,cpd11-20bk.pdf
HR25ENY,"East New York Office, 2440 Fulton Street, Brooklyn",096,HUMAN RESOURCES ADMINISTRATION,SOCIAL SERVICES BUILDINGS,300,BROOKLYN,HR-0025,52924,0,0,0,5284,16444,13160,0,34888,0,0,0,5284,16444,13160,0,34888,0,0,0,10568,32888,26320,0,69776,PROJECT DELAYED DUE TO CHANGES IN SCOPE/DESIGN,,"CONSTRUCTION AT 2440 FULTON STREET, BROOKLYN.",cpd11-20bk.pdf
HR25FOSF2,Initial Outfitting of 102-50 Foster Avenue (Warehouse Space),096,HUMAN RESOURCES ADMINISTRATION,SOCIAL SERVICES BUILDINGS,314,BROOKLYN,HR-0025,501,0,0,256,0,0,0,0,256,0,0,256,0,0,0,0,256,0,0,512,0,0,0,0,512,,,,cpd11-20bk.pdf
HR25FOST2,Construction at 102-50 Foster Ave to accomodate warehouses,096,HUMAN RESOURCES ADMINISTRATION,SOCIAL SERVICES BUILDINGS,314,BROOKLYN,HR-0025,7539,0,0,1571,2752,0,0,0,4323,0,0,1571,2752,0,0,0,4323,0,0,3142,5504,0,0,0,8646,,,,cpd11-20bk.pdf
HRCNBDST,"Bedford Stuyvesant MSC Boiler Replacement, 1958 Fulton St",096,HUMAN RESOURCES ADMINISTRATION,SOCIAL SERVICES BUILDINGS,303,BROOKLYN,HR-D002,1070,0,0,0,0,1070,0,0,1070,0,0,0,0,1070,0,0,1070,0,0,0,0,2140,0,0,2140,PROJECT DELAYED DUE TO CHANGES IN SCOPE/DESIGN,1958 FULTON ST//1001 HERKIMER ST BK 11233-3104,EXTERIOR RENOVATIONS,cpd11-20bk.pdf
AGREDHOOK,PB,125,DEPARTMENT FOR THE AGING,DEPARTMENT FOR THE AGING BUILDING RECONSTRUCTION,300,BROOKLYN,AG-D001,0,0,0,1260,0,0,0,0,1260,0,0,1260,0,0,0,0,1260,0,0,2520,0,0,0,0,2520,,,PB,cpd11-20bk.pdf
PV230-SEA,WCS - New York Aquarium - Sea Cliffs Exhibit,126,DEPARTMENT OF CULTURAL AFFAIRS,ESSENTIAL RECONSTRUCTION OF FACILITIES,313,BROOKLYN,PV-0230 PV-K230 PV-D230 PV-D467,1000,0,0,0,0,9686,0,0,9686,0,0,0,0,9686,0,0,9686,0,0,0,0,19372,0,0,19372,PROJECT DELAYED DUE TO BUDGETARY CONSTRAINTS,,NY AQUARIUM SEA CLIFF EXHIBIT,cpd11-20bk.pdf
PV235AFAR,BMA - Brooklyn Museum - African Art Gallery Renovations,126,DEPARTMENT OF CULTURAL AFFAIRS,ESSENTIAL RECONSTRUCTION OF FACILITIES,,BROOKLYN,PV-0235 PV-D235,3711,0,0,0,0,7911,0,0,7911,0,0,0,0,7911,0,0,7911,0,0,0,0,15822,0,0,15822,,"200 EASTERN PARKWAY, BROOKLYN, NY",AFRICAN ART GALLERY IN BROOKLYN MUSEUM.,cpd11-20bk.pdf
PV235EDUC,BMA - Brooklyn Museum - Education Space,126,DEPARTMENT OF CULTURAL AFFAIRS,ESSENTIAL RECONSTRUCTION OF FACILITIES,,BROOKLYN,PV-K235 PV-0235 PV-D235,3040,0,0,0,0,6025,0,0,6025,0,0,0,0,6025,0,0,6025,0,0,0,0,12050,0,0,12050,PROJECT DELAYED DUE TO BUDGETARY CONSTRAINTS,,DESIGN AND CONSTRUCTION OF EDUCATION SPACE IN BROOKLYN MUSEUM'S HALL,cpd11-20bk.pdf
PV236AUDI,BBG - Auditorium Renovations,126,DEPARTMENT OF CULTURAL AFFAIRS,ESSENTIAL RECONSTRUCTION OF FACILITIES,309,BROOKLYN,PV-D236 PV-K236 PV-0236,1878,0,0,0,0,2000,3439,0,5439,0,0,0,0,2000,3439,0,5439,0,0,0,0,4000,6878,0,10878,PROJECT DELAYED DUE TO CHANGES IN SCOPE/DESIGN,"1000 WASHINGTON AVENUE, BROOKLYN NY",BBG AUDITORIUM RENOVATION,cpd11-20bk.pdf
PV236BCSG,BBG - Brooklyn Botanic Garden - Sustainable Gardening Center,126,DEPARTMENT OF CULTURAL AFFAIRS,ESSENTIAL RECONSTRUCTION OF FACILITIES,308 309,BROOKLYN,PV-D236 PV-K236,1500,0,0,0,0,2183,0,3100,5283,0,0,0,0,2183,0,3100,5283,0,0,0,0,4366,0,6200,10566,PROJECT DELAYED DUE TO CHANGES IN SCOPE/DESIGN,,BROOKLYN BOTANIC GARDEN,cpd11-20bk.pdf
PV236ROSE,BBG -Brooklyn Botanic Garden - Accessibility Improvements,126,DEPARTMENT OF CULTURAL AFFAIRS,ESSENTIAL RECONSTRUCTION OF FACILITIES,,BROOKLYN,PV-D236,2000,0,0,0,0,2000,0,0,2000,0,0,0,0,2000,0,0,2000,0,0,0,0,4000,0,0,4000,PROJECT DELAYED DUE TO BUDGETARY CONSTRAINTS,"1000 WASHINGTON, BROOKLYN",SITE WIDE AND BUILDING WIDE AADA IMPROVEMENTS.,cpd11-20bk.pdf
PV262HVAC,BCM - Brooklyn Children's Museum - HVAC,126,DEPARTMENT OF CULTURAL AFFAIRS,ESSENTIAL RECONSTRUCTION OF FACILITIES,,BROOKLYN,PV-D262 PV-K262,1000,0,0,0,0,1000,1000,0,2000,0,0,0,0,1000,1000,0,2000,0,0,0,0,2000,2000,0,4000,,,BROOKLYN CHILDREN'S MUSEUM - HVAC,cpd11-20bk.pdf
PV262PRNG,BCM - FHWA Parking Lot - 906 Prospect Place,126,DEPARTMENT OF CULTURAL AFFAIRS,ESSENTIAL RECONSTRUCTION OF FACILITIES,308,BROOKLYN,PV-D262 PV-0262,6590,0,0,0,0,189,3200,0,3389,0,0,0,0,189,3200,0,3389,0,0,0,0,378,6400,0,6778,PROJECT DELAYED DUE TO CHANGES IN SCOPE/DESIGN,"MUSEUM, 145 BROOKLYN AVENUE, BROOKLYN. PENDING SITE ACQUISITION AND DEVELOPMENT OF 906","DEVELOPMENT OF PARKING LOT; PRE-PLANNING STUDIES, DESIGN AND CONSTRUCTION.",cpd11-20bk.pdf
PV264-PJS,BAM - Peter J. Sharp Infrastructure Improvments Escalator,126,DEPARTMENT OF CULTURAL AFFAIRS,ESSENTIAL RECONSTRUCTION OF FACILITIES,,BROOKLYN,PV-D264,0,0,0,0,0,525,0,0,525,0,0,0,0,525,0,0,525,0,0,0,0,1050,0,0,1050,,,BAM INFRASTRUCURE IMPROVEMENTS AT PJS INCLUDING ESCALATOR,cpd11-20bk.pdf
PV264ROSE,BAM - Rose Renovation,126,DEPARTMENT OF CULTURAL AFFAIRS,ESSENTIAL RECONSTRUCTION OF FACILITIES,,BROOKLYN,PV-K264 PV-D264,7000,0,0,4500,0,0,0,0,4500,0,0,4500,0,0,0,0,4500,0,0,9000,0,0,0,0,9000,,,BAM - ROSE RENOVATION,cpd11-20bk.pdf
PV467BKLN,DCA - Brooklyn Fund,126,DEPARTMENT OF CULTURAL AFFAIRS,ESSENTIAL RECONSTRUCTION OF FACILITIES,,BROOKLYN,PV-0467,2200,0,0,0,0,0,0,2200,2200,0,0,0,0,0,0,2200,2200,0,0,0,0,0,0,4400,4400,,,DCA FUNDS TO SUPPORT NON-PROFIT CULTURAL ORGANIZATIONS IN BROOKLYN,cpd11-20bk.pdf
PV467SWBB,Spaceworks Brooklyn Bridge Park,126,DEPARTMENT OF CULTURAL AFFAIRS,ESSENTIAL RECONSTRUCTION OF FACILITIES,302,BROOKLYN,PV-0467,6200,0,0,0,0,0,3000,0,3000,0,0,0,0,0,3000,0,3000,0,0,0,0,0,6000,0,6000,PROJECT DELAYED DUE TO CHANGES IN SCOPE/DESIGN,"334 FURMAN STREET, BROOKLYN, NY",RECONSTRUCTION OF TWO FLOORS AT 334 FURMAN STREET IN BROOKLYN BRIDGE PARK FOR ARTIST,cpd11-20bk.pdf
BAMNSITEA,BAM Cultural District - North Site Condemnation,801,DEPT OF SMALL BUSINESS SERVICES,MISCELLANEOUS,302,BROOKLYN,ED-0075,5128,2199,0,0,0,0,187,0,2386,2199,0,0,0,0,187,0,2386,4398,0,0,0,0,374,0,4772,PROJECT DELAYED DUE TO CHANGES IN SCOPE/DESIGN,,BAM LDC - CONDEMNATION OF LIQUOR STORE ON NORTH SITE AND ASSOCIATED COSTS,cpd11-20bk.pdf
BAMPARK,BAM Park Renovation,801,DEPT OF SMALL BUSINESS SERVICES,MISCELLANEOUS,302,BROOKLYN,ED-D075 ED-0384 ED-D380 ED-K075,300,0,1400,0,0,0,0,0,1400,0,1400,0,0,0,0,0,1400,0,2800,0,0,0,0,0,2800,PROJECT DELAYED DUE TO CHANGES IN SCOPE/DESIGN,,BAM PARK RENOVATION,cpd11-20bk.pdf
BAMSTRTS,BAM Cultural District Streetscapes,801,DEPT OF SMALL BUSINESS SERVICES,MISCELLANEOUS,300 302,BROOKLYN,ED-K075 ED-D380,1000,1442,203,0,0,118,0,0,1763,1442,203,0,0,118,0,0,1763,2884,406,0,0,236,0,0,3526,PROJECT DELAYED DUE TO CHANGES IN SCOPE/DESIGN,,DESIGN AND CONSTRUCTION OF BAM STREETSCAPE AND PUBLIC SPACE,cpd11-20bk.pdf
BAT4LAN,BAT Pier 4,801,DEPT OF SMALL BUSINESS SERVICES,WATERFRONT DEVELOPMENT,307,BROOKLYN,ED-0409 ED-0404 ED-0373 ED-0075 ED-0401,500,3137,3398,2800,2800,0,0,2403,14538,3137,3398,2800,2800,0,0,2403,14538,6274,6796,5600,5600,0,0,4806,29076,PROJECT DELAYED DUE TO CHANGES IN SCOPE/DESIGN,,FERRY LANDING REHABILITATION,cpd11-20bk.pdf
BATANCHOR,BAT Anchor Tenant Strategy,801,DEPT OF SMALL BUSINESS SERVICES,INDUSTRIAL DEVELOPMENT,300,BROOKLYN,ED-0373,36000,0,0,0,0,0,0,15405,15405,0,0,0,0,0,0,15405,15405,0,0,0,0,0,0,30810,30810,PROJECT DELAYED DUE TO CHANGES IN SCOPE/DESIGN,,BAT ANCHOR TENANT STRATEGY - 100K JOBS PLAN,cpd11-20bk.pdf
BATBEYOND,BAT New Needs,801,DEPT OF SMALL BUSINESS SERVICES,INDUSTRIAL DEVELOPMENT,300,BROOKLYN,ED-0075 ED-0373 ED-K075,100000,117433,6076,5778,597,0,0,0,129884,117433,6076,5778,597,0,0,0,129884,234866,12152,11556,1194,0,0,0,259768,PROJECT DELAYED DUE TO CHANGES IN SCOPE/DESIGN,,BAT NEW NEEDS,cpd11-20bk.pdf
BATIMPRO,BAT Improvements,801,DEPT OF SMALL BUSINESS SERVICES,INDUSTRIAL DEVELOPMENT,300,BROOKLYN,ED-0373,3152,12601,386,0,0,0,0,0,12987,12601,386,0,0,0,0,0,12987,25202,772,0,0,0,0,0,25974,PROJECT DELAYED DUE TO CHANGES IN SCOPE/DESIGN,,BAT IMPROVEMENTS,cpd11-20bk.pdf
BATLOGIST,Brooklyn Army Terminal Logistics Center,801,DEPT OF SMALL BUSINESS SERVICES,INDUSTRIAL DEVELOPMENT,300,BROOKLYN,ED-0373,50000,0,0,0,0,0,0,30000,30000,0,0,0,0,0,0,30000,30000,0,0,0,0,0,0,60000,60000,PROJECT DELAYED DUE TO CHANGES IN SCOPE/DESIGN,,BAT LOGISTICS CENTER,cpd11-20bk.pdf
BATPLUGIN,BAT Plug-In Industrial Strategy,801,DEPT OF SMALL BUSINESS SERVICES,INDUSTRIAL DEVELOPMENT,300,BROOKLYN,ED-0373,13000,0,0,0,0,0,13000,0,13000,0,0,0,0,0,13000,0,13000,0,0,0,0,0,26000,0,26000,PROJECT DELAYED DUE TO CHANGES IN SCOPE/DESIGN,,BAT PLUG-IN INDUSTRIAL STRATEGY - 100K JOBS PLAN,cpd11-20bk.pdf
BCTBERTH,Brooklyn Cruise Terminal - New Berth and Landside Redevelop,801,DEPT OF SMALL BUSINESS SERVICES,WATERFRONT DEVELOPMENT,300,BROOKLYN,ED-K409,1000,0,0,0,500,0,500,0,1000,0,0,0,500,0,500,0,1000,0,0,0,1000,0,1000,0,2000,PROJECT DELAYED DUE TO CHANGES IN SCOPE/DESIGN,,BROOKLYN CRUISE TERMINAL,cpd11-20bk.pdf
BCTPIER11,Brooklyn Cruise Terminal Pier 11,801,DEPT OF SMALL BUSINESS SERVICES,MISCELLANEOUS,300,BROOKLYN,ED-D075 ED-0409,3000,938,347,0,0,0,738,1322,3345,938,347,0,0,0,738,1322,3345,1876,694,0,0,0,1476,2644,6690,PROJECT DELAYED DUE TO CHANGES IN SCOPE/DESIGN,,BROOKLYN CRUISE TERMINAL PIER 11,cpd11-20bk.pdf
BKBRESP,Brooklyn Bridge Esplanade,801,DEPT OF SMALL BUSINESS SERVICES,MISCELLANEOUS,300,BROOKLYN,ED-0075 ED-0409 ED-M075 ED-D075,20000,0,372,3244,3244,0,0,1000,7860,0,372,3244,3244,0,0,1000,7860,0,744,6488,6488,0,0,2000,15720,,,BROOKLYN BRIDGE ESPLANADE,cpd11-20bk.pdf
BKCRUISE,Brooklyn Cruise Terminal Substructre Rehab,801,DEPT OF SMALL BUSINESS SERVICES,PORT DEVELOPMENT,306,BROOKLYN,ED-K409 ED-0409,5000,0,0,0,0,0,2700,836,3536,0,0,0,0,0,2700,836,3536,0,0,0,0,0,5400,1672,7072,PROJECT DELAYED DUE TO CHANGES IN SCOPE/DESIGN,,BROOKLYN CRUISE TERMINAL SUBSTRUCTRE REHAB,cpd11-20bk.pdf
BKCTPIER,Brooklyn Cruise Terminal Pier 12 Substructure Rehab,801,DEPT OF SMALL BUSINESS SERVICES,MISCELLANEOUS,300,BROOKLYN,ED-0409,1500,872,6091,5600,5600,0,0,0,18163,872,6091,5600,5600,0,0,0,18163,1744,12182,11200,11200,0,0,0,36326,PROJECT DELAYED DUE TO CHANGES IN SCOPE/DESIGN,,BROOKLYN CRUISE TERMINAL PIER 12 SUBSTRUCTURE REHAB,cpd11-20bk.pdf
BKWMMIMP,Brooklyn Wholesale Meat Markets Building Improvement,801,DEPT OF SMALL BUSINESS SERVICES,MISCELLANEOUS,300,BROOKLYN,ED-0075,2194,2025,0,0,0,0,169,0,2194,2025,0,0,0,0,169,0,2194,4050,0,0,0,0,338,0,4388,PROJECT DELAYED DUE TO CHANGES IN SCOPE/DESIGN,,BROOKLYN WHOLESALE MEAT MARKETS BUILDING IMPROVEMENTS,cpd11-20bk.pdf
BNY5THST,BNYDC 5th Street Reconstruction,801,DEPT OF SMALL BUSINESS SERVICES,INDUSTRIAL DEVELOPMENT,300,BROOKLYN,ED-0319,1233,0,300,933,0,0,0,0,1233,0,300,933,0,0,0,0,1233,0,600,1866,0,0,0,0,2466,PROJECT DELAYED DUE TO CHANGES IN SCOPE/DESIGN,,BNYDC 5TH STREET RECONSTRUCTION,cpd11-20bk.pdf
BNY910SBB,"BNYDC Berths 9, 10 and Small Boat Basin Structural Work",801,DEPT OF SMALL BUSINESS SERVICES,INDUSTRIAL DEVELOPMENT,300,BROOKLYN,ED-0319,46047,1577,823,17418,5000,17229,4000,0,46047,1577,823,17418,5000,17229,4000,0,46047,3154,1646,34836,10000,34458,8000,0,92094,,,"RECONSTRUCTION OF THE STRUCTURAL FOUNDATIONS OF BERTHS 9, 10 AND THE SMALL BOAT BASIN,",cpd11-20bk.pdf
BNYB131RM,BNYDC Building 131 Asbestos and Mold Remediation - 1st Floor,801,DEPT OF SMALL BUSINESS SERVICES,INDUSTRIAL DEVELOPMENT,300,BROOKLYN,ED-0319,1600,0,1600,0,0,0,0,0,1600,0,1600,0,0,0,0,0,1600,0,3200,0,0,0,0,0,3200,,,REMEDIATION OF MOLD AND ASBESTOS CONDITIONS ON THE 1ST FLOOR OF BUILDING 131 AT THE,cpd11-20bk.pdf
BNYB280RF,BNYDC Building 280 Roof,801,DEPT OF SMALL BUSINESS SERVICES,INDUSTRIAL DEVELOPMENT,300,BROOKLYN,ED-0319,1500,0,1500,0,0,0,0,0,1500,0,1500,0,0,0,0,0,1500,0,3000,0,0,0,0,0,3000,,,"FULL REPLACEMENT OF THE ROOF AT BUILDING 280, LOCATED IN THE BROOKLYNNAVY YARD",cpd11-20bk.pdf
BNYB3SUBD,BNYDC Building 3 Subdivision,801,DEPT OF SMALL BUSINESS SERVICES,INDUSTRIAL DEVELOPMENT,300,BROOKLYN,ED-0319,3476,0,3476,0,0,0,0,0,3476,0,3476,0,0,0,0,0,3476,0,6952,0,0,0,0,0,6952,,,"SUBDIVISION OF THE 7TH AND 9TH FLOORS OF BUILDING 3, LOCATED AT THE BROOKLYN NAVY YARD",cpd11-20bk.pdf
BNYB74DEM,BNYDC Demolition of Building 74 and Parking Lot,801,DEPT OF SMALL BUSINESS SERVICES,INDUSTRIAL DEVELOPMENT,300,BROOKLYN,ED-0319,3500,0,500,3000,0,0,0,0,3500,0,500,3000,0,0,0,0,3500,0,1000,6000,0,0,0,0,7000,,,DEMOLITION OF BUILDING 74 AT THE BROOKLYN NAVY YARD AND CONSTRUCTION OF A NEW PARKING,cpd11-20bk.pdf
BNYBD132,BNYDC Building 132 Roof Rehabilitation,801,DEPT OF SMALL BUSINESS SERVICES,INDUSTRIAL DEVELOPMENT,300,BROOKLYN,ED-0319,1055,46,1009,0,0,0,0,0,1055,46,1009,0,0,0,0,0,1055,92,2018,0,0,0,0,0,2110,,,BNYDC BUILDING 132,cpd11-20bk.pdf
BNYBDELEV,BNYDC Elevator Reconstruction and Replacement,801,DEPT OF SMALL BUSINESS SERVICES,INDUSTRIAL DEVELOPMENT,300,BROOKLYN,ED-0319 ED-K319,16500,310,1250,6192,3472,0,0,0,11224,310,1250,6192,3472,0,0,0,11224,620,2500,12384,6944,0,0,0,22448,PROJECT DELAYED DUE TO CHANGES IN SCOPE/DESIGN,,BROOKLYN NAVY YARD-WIDE REPAIRS AND RECONSTRUCTION OF BUILDING ELEVATORS,cpd11-20bk.pdf
BNYBLD292,BNYDC Building 292 Roof Replacement,801,DEPT OF SMALL BUSINESS SERVICES,INDUSTRIAL DEVELOPMENT,300,BROOKLYN,ED-0319,1499,1443,56,0,0,0,0,0,1499,1443,56,0,0,0,0,0,1499,2886,112,0,0,0,0,0,2998,PROJECT DELAYED DUE TO CHANGES IN SCOPE/DESIGN,,DESIGN AND RECONSTRUCTION OF ROOFING SSYTEM FOR BUILDING 292 IN BROOKLYN NAVY YARD.,cpd11-20bk.pdf
BNYBLDG50,BNYDC Building 50 Roof Rehabilitation,801,DEPT OF SMALL BUSINESS SERVICES,INDUSTRIAL DEVELOPMENT,300,BROOKLYN,ED-0319,1055,49,1652,0,0,0,0,0,1701,49,1652,0,0,0,0,0,1701,98,3304,0,0,0,0,0,3402,,,BNYDC BUILDING 50 ROOF REPLACEMENT,cpd11-20bk.pdf
BNYDCSUBF,BNYDC Con Edison Substation F Upgrade,801,DEPT OF SMALL BUSINESS SERVICES,INDUSTRIAL DEVELOPMENT,300,BROOKLYN,ED-0319,4232,622,1510,2300,4050,0,0,0,8482,622,1510,2300,4050,0,0,0,8482,1244,3020,4600,8100,0,0,0,16964,PROJECT DELAYED DUE TO UNFORESEEN SITE/FIELD CONDITION,,POWER SUBSTATION UPGRADE,cpd11-20bk.pdf
BNYDCWELD,BNYDC Welding Lab,801,DEPT OF SMALL BUSINESS SERVICES,INDUSTRIAL DEVELOPMENT,300,BROOKLYN,ED-K319 ED-D319,3000,0,3000,0,0,0,0,0,3000,0,3000,0,0,0,0,0,3000,0,6000,0,0,0,0,0,6000,PROJECT DELAYED DUE TO CHANGES IN SCOPE/DESIGN,,DESIGN AND CONSTRUCTION OF A WELDING LAB AT THE BROOKLYN NAVY YARD,cpd11-20bk.pdf
BNYELEV22,BNYDC Building 22 Elevator Modernization,801,DEPT OF SMALL BUSINESS SERVICES,INDUSTRIAL DEVELOPMENT,300,BROOKLYN,ED-0319,276,193,83,0,0,0,0,0,276,193,83,0,0,0,0,0,276,386,166,0,0,0,0,0,552,PROJECT DELAYED DUE TO CHANGES IN SCOPE/DESIGN,,BNYDC BUILDING 22 ELEVATOR MODERNIZATION,cpd11-20bk.pdf
BNYFNCLIN,BNYDC Fence Line Restructuring,801,DEPT OF SMALL BUSINESS SERVICES,INDUSTRIAL DEVELOPMENT,300,BROOKLYN,ED-D319 ED-K319 ED-0319,1926,426,2750,2800,1250,0,0,0,7226,426,2750,2800,1250,0,0,0,7226,852,5500,5600,2500,0,0,0,14452,PROJECT DELAYED DUE TO CHANGES IN SCOPE/DESIGN,,BNY FENCE LINE RESTRUCTURING - VARIOUS LOCATIONS,cpd11-20bk.pdf
BNYHARBOR,BNYDC PS 331 NY Harbor School Trailer Installation,801,DEPT OF SMALL BUSINESS SERVICES,INDUSTRIAL DEVELOPMENT,300,BROOKLYN,ED-K319,242,0,0,242,0,0,0,0,242,0,0,242,0,0,0,0,242,0,0,484,0,0,0,0,484,PROJECT DELAYED DUE TO CHANGES IN SCOPE/DESIGN,,NY HARBOR SCHOOL TRAILER INSTALLATION,cpd11-20bk.pdf
BNYHITN,BNYDC HITN Eco-Rooftop Production Studio,801,DEPT OF SMALL BUSINESS SERVICES,INDUSTRIAL DEVELOPMENT,300,BROOKLYN,ED-K319,500,0,1500,0,0,0,0,0,1500,0,1500,0,0,0,0,0,1500,0,3000,0,0,0,0,0,3000,PROJECT DELAYED DUE TO CHANGES IN SCOPE/DESIGN,,BNYDC HISPANIC INFORMATION AND TELECOMMUNICATION NETWORK ECO ROOFTOP PRODUCTION,cpd11-20bk.pdf
BNYINF-BD,BNYDC Infrastructure Building Rehab,801,DEPT OF SMALL BUSINESS SERVICES,INDUSTRIAL DEVELOPMENT,302,BROOKLYN,ED-0319,4207,2366,1954,10232,63315,60405,80809,63920,283001,2366,1954,10232,63315,60405,80809,63920,283001,4732,3908,20464,126630,120810,161618,127840,566002,PROJECT DELAYED DUE TO CHANGES IN SCOPE/DESIGN,,BNYDC INFRASTRUCTURE BUILDING REHAB,cpd11-20bk.pdf
BNYINFRAW,BNYDC Infrastructure - Water Projects,801,DEPT OF SMALL BUSINESS SERVICES,INDUSTRIAL DEVELOPMENT,300,BROOKLYN,ED-0319,32950,32389,2500,2500,2497,0,0,0,39886,32389,2500,2500,2497,0,0,0,39886,64778,5000,5000,4994,0,0,0,79772,PROJECT DELAYED DUE TO CHANGES IN SCOPE/DESIGN,,WEST 125TH STREET/MANHATTANVILLE,cpd11-20bk.pdf
BNYINF-ST,BNYDC Infrastructure Steam,801,DEPT OF SMALL BUSINESS SERVICES,INDUSTRIAL DEVELOPMENT,300,BROOKLYN,ED-0319,19169,0,2676,3106,2300,5200,1200,0,14482,0,2676,3106,2300,5200,1200,0,14482,0,5352,6212,4600,10400,2400,0,28964,PROJECT DELAYED DUE TO CHANGES IN SCOPE/DESIGN,,BNYDC INFRASTRUCTURE STEAM,cpd11-20bk.pdf
BNYINF-WF,BNYDC Infrastructure Waterfront,801,DEPT OF SMALL BUSINESS SERVICES,INDUSTRIAL DEVELOPMENT,300,BROOKLYN,ED-0319,29790,16807,1290,66,3309,1057,8500,33714,64743,16807,1290,66,3309,1057,8500,33714,64743,33614,2580,132,6618,2114,17000,67428,129486,PROJECT DELAYED DUE TO CHANGES IN SCOPE/DESIGN,,BNYDC INFRASTRUCTURE WATERFRONT,cpd11-20bk.pdf
BNYLIGHT,BNYDC Lighting Replacement,801,DEPT OF SMALL BUSINESS SERVICES,INDUSTRIAL DEVELOPMENT,300,BROOKLYN,ED-0319,5000,0,1000,2000,2000,0,0,0,5000,0,1000,2000,2000,0,0,0,5000,0,2000,4000,4000,0,0,0,10000,,,BNYDC LIGHTING REPLACEMENT,cpd11-20bk.pdf
BNYLL11,BNYDC Local Law 11 Compliance - Buildings 3 and 5,801,DEPT OF SMALL BUSINESS SERVICES,MISCELLANEOUS,300,BROOKLYN,ED-0319,6390,0,2400,3990,0,0,0,0,6390,0,2400,3990,0,0,0,0,6390,0,4800,7980,0,0,0,0,12780,PROJECT DELAYED DUE TO UNFORESEEN SITE/FIELD CONDITION,,LOCAL LAW 11 COMPLIANCE - BUILDINGS 3 AND 5,cpd11-20bk.pdf
BNYMACRO,BNYDC Macro Sea,801,DEPT OF SMALL BUSINESS SERVICES,MISCELLANEOUS,300,BROOKLYN,ED-D319,7000,6920,0,0,80,0,0,0,7000,6920,0,0,80,0,0,0,7000,13840,0,0,160,0,0,0,14000,PROJECT DELAYED DUE TO CHANGES IN SCOPE/DESIGN,,"MACRO SEA DESIGN AND FABRICATION CENTER, A TENANT OF THE GREEN MANUFACTURING CENTER",cpd11-20bk.pdf
BNYMWBEEI,BNYDC MWBE Equity Incubator,801,DEPT OF SMALL BUSINESS SERVICES,INDUSTRIAL DEVELOPMENT,300,BROOKLYN,ED-D319,2000,0,2000,0,0,0,0,0,2000,0,2000,0,0,0,0,0,2000,0,4000,0,0,0,0,0,4000,,,BNYDC MWBE EQUITY INCUBATOR DESIGN AND CONSTRUCTION,cpd11-20bk.pdf
BNYROOF77,BNYDC - Building 77 Roof,801,DEPT OF SMALL BUSINESS SERVICES,INDUSTRIAL DEVELOPMENT,300,BROOKLYN,ED-D319,500,0,0,0,500,0,0,0,500,0,0,0,500,0,0,0,500,0,0,0,1000,0,0,0,1000,PROJECT DELAYED DUE TO CHANGES IN SCOPE/DESIGN,,BUILDING 77 ROOF,cpd11-20bk.pdf
BNYRPZBFL,BNYDC Installation of RPZ Backflow Devices,801,DEPT OF SMALL BUSINESS SERVICES,INDUSTRIAL DEVELOPMENT,300,BROOKLYN,ED-0319,3703,276,3427,0,0,0,0,0,3703,276,3427,0,0,0,0,0,3703,552,6854,0,0,0,0,0,7406,PROJECT DELAYED DUE TO CHANGES IN SCOPE/DESIGN,,NYCDEP REQUIRES EACH PERIMETER SERVICE CONNECTIONS RETROFITED WITH BACKFLOW,cpd11-20bk.pdf
BNYSPKFIR,BNYDC Sprinkler and Fire Alarm System Upgrades,801,DEPT OF SMALL BUSINESS SERVICES,INDUSTRIAL DEVELOPMENT,300,BROOKLYN,ED-0319,8318,250,3000,12592,0,0,0,0,15842,250,3000,12592,0,0,0,0,15842,500,6000,25184,0,0,0,0,31684,PROJECT DELAYED DUE TO UNFORESEEN SITE/FIELD CONDITION,,BNYDC SPRINKLER AND FIRE ALARM SYSTEM UPGRADE,cpd11-20bk.pdf
BNYTIFUND,BNYDC Tenant Improvement Fund,801,DEPT OF SMALL BUSINESS SERVICES,INDUSTRIAL DEVELOPMENT,300,BROOKLYN,ED-0319,6179,0,500,1250,1250,750,500,0,4250,0,500,1250,1250,750,500,0,4250,0,1000,2500,2500,1500,1000,0,8500,PROJECT DELAYED DUE TO CHANGES IN SCOPE/DESIGN,,BNY TENANT IMPROVEMENT FUND,cpd11-20bk.pdf
BNYUBFARM,BNYDC Urban Farm Incubator,801,DEPT OF SMALL BUSINESS SERVICES,INDUSTRIAL DEVELOPMENT,300,BROOKLYN,ED-K319,1000,0,500,500,0,0,0,0,1000,0,500,500,0,0,0,0,1000,0,1000,1000,0,0,0,0,2000,PROJECT DELAYED DUE TO CHANGES IN SCOPE/DESIGN,,ROOFTOP FARMING FOR PUBLIC CONSUMPTION,cpd11-20bk.pdf
BNYUPSTM,BNYDC Above Ground Steam Main,801,DEPT OF SMALL BUSINESS SERVICES,INDUSTRIAL DEVELOPMENT,300,BROOKLYN,ED-0319,1313,170,1580,0,0,0,0,0,1750,170,1580,0,0,0,0,0,1750,340,3160,0,0,0,0,0,3500,PROJECT DELAYED DUE TO UNFORESEEN SITE/FIELD CONDITION,,ABOVE GROUND STEAM MAIN RELOCATION,cpd11-20bk.pdf
BUSHDEVSP,Bush Terminal Development Site Preparation,801,DEPT OF SMALL BUSINESS SERVICES,MISCELLANEOUS ENERGY EFFICIENCY AND SUSTAINABILITY,300,BROOKLYN,ED-0075 ED-0373,10000,0,5000,10000,0,0,0,0,15000,0,5000,10000,0,0,0,0,15000,0,10000,20000,0,0,0,0,30000,,,BUSHDEVSP,cpd11-20bk.pdf
BUSHTCAFE,Bush Terminal Cafe Building Improvements,801,DEPT OF SMALL BUSINESS SERVICES,MISCELLANEOUS,300,BROOKLYN,ED-0075,3000,317,0,0,0,0,1073,1610,3000,317,0,0,0,0,1073,1610,3000,634,0,0,0,0,2146,3220,6000,PROJECT DELAYED DUE TO CHANGES IN SCOPE/DESIGN,,BUSH TERMINAL CAFÔ BUILDING IMPROVEMENTS,cpd11-20bk.pdf
BUSHTPARK,Bush Terminal Park,801,DEPT OF SMALL BUSINESS SERVICES,COMMUNITY DEVELOPMENT,300,BROOKLYN,ED-0410 P-D017,2000,1850,151,0,0,0,0,0,2001,1850,151,0,0,0,0,0,2001,3700,302,0,0,0,0,0,4002,,,BUSH TERMINAL PARK,cpd11-20bk.pdf
BUSHUNTAC,Bush Terminal Made in NY Unit A and C,801,DEPT OF SMALL BUSINESS SERVICES,MISCELLANEOUS,300,BROOKLYN,ED-0410 ED-0075,53501,10706,27408,61478,61413,0,0,0,161005,10706,27408,61478,61413,0,0,0,161005,21412,54816,122956,122826,0,0,0,322010,PROJECT DELAYED DUE TO CHANGES IN SCOPE/DESIGN,,CONSTRUCTION AND RENOVATION OF UNIT A AT BUSH TERMINAL,cpd11-20bk.pdf
BUSHUNTBD,BUSH MINY--UNIT B & D,801,DEPT OF SMALL BUSINESS SERVICES,MISCELLANEOUS,300,BROOKLYN,ED-0075,50000,7587,2000,0,0,0,0,50413,60000,7587,2000,0,0,0,0,50413,60000,15174,4000,0,0,0,0,100826,120000,PROJECT DELAYED DUE TO CHANGES IN SCOPE/DESIGN,,BUSH MINY--BUILDING B/D,cpd11-20bk.pdf
BUSHUTIL,Bush Terminal Site and Utility Improvements,801,DEPT OF SMALL BUSINESS SERVICES,MISCELLANEOUS,300,BROOKLYN,ED-0410 ED-0075,39301,19942,12899,20643,3840,0,0,0,57324,19942,12899,20643,3840,0,0,0,57324,39884,25798,41286,7680,0,0,0,114648,PROJECT DELAYED DUE TO CHANGES IN SCOPE/DESIGN,,BUSH TERMINAL UTILITY IMPROVEMENTS,cpd11-20bk.pdf
CANTONBLK,Canton Court Bulkhead Replacement,801,DEPT OF SMALL BUSINESS SERVICES,MISCELLANEOUS,300,BROOKLYN,RE-0025,4400,2542,0,0,0,1000,1459,0,5001,2542,0,0,0,1000,1459,0,5001,5084,0,0,0,2000,2918,0,10002,PROJECT DELAYED DUE TO CHANGES IN SCOPE/DESIGN,,CANTON COURT BULKHEAD REPLACEMENT BROOKLYN,cpd11-20bk.pdf
CNEDST,CNED - Bedford Stuyvesant,801,DEPT OF SMALL BUSINESS SERVICES,NEIGHBORHOOD REVITALIZATION,303,BROOKLYN,ED-K384,7882,7760,0,0,0,0,0,172,7932,7760,0,0,0,0,0,172,7932,15520,0,0,0,0,0,344,15864,PROJECT DELAYED DUE TO CHANGES IN SCOPE/DESIGN,,CNED BEDFORD STUYVESANT,cpd11-20bk.pdf
COLUMBST,Columbia Street Platform Rehabilitation,801,DEPT OF SMALL BUSINESS SERVICES,MISCELLANEOUS,300,BROOKLYN,RE-0025,1375,1802,0,198,0,0,0,0,2000,1802,0,198,0,0,0,0,2000,3604,0,396,0,0,0,0,4000,PROJECT DELAYED DUE TO CHANGES IN SCOPE/DESIGN,,COLUMBIA STREET PLATFORM REHABILITATION,cpd11-20bk.pdf
CONEYPLAZ,Coney Island Steeplechase Plaza,801,DEPT OF SMALL BUSINESS SERVICES,NEIGHBORHOOD REVITALIZATION,313,BROOKLYN,ED-0404,34582,29718,89,0,0,0,0,0,29807,29718,89,0,0,0,0,0,29807,59436,178,0,0,0,0,0,59614,PROJECT DELAYED DUE TO BUDGETARY CONSTRAINTS,,CONEY ISLAND STEEPLECHASE PLAZA,cpd11-20bk.pdf
CONEYSIGN,Coney Island Signs,801,DEPT OF SMALL BUSINESS SERVICES,MISCELLANEOUS,300,BROOKLYN,ED-0075,400,0,0,0,0,0,0,400,400,0,0,0,0,0,0,400,400,0,0,0,0,0,0,800,800,PROJECT DELAYED DUE TO CHANGES IN SCOPE/DESIGN,,"ACQUISITION, SITE DEVELOPMENT, CONSTRUCTION & RECONSTRUCTION, CITYWIDE -- CONEY ISLAND",cpd11-20bk.pdf
CONEYWEST,Coney Island West,801,DEPT OF SMALL BUSINESS SERVICES,MISCELLANEOUS,300,BROOKLYN,ED-0075 SE-0200K SE-0002K WM-0006 WM-0001,181000,119357,8194,0,0,4506,81338,0,213395,119357,8194,0,0,4506,81338,0,213395,238714,16388,0,0,9012,162676,0,426790,PROJECT DELAYED DUE TO CHANGES IN SCOPE/DESIGN,,CONEY ISLAND WEST,cpd11-20bk.pdf
CWFSHOMEP,New York City Ferry - Homeport,801,DEPT OF SMALL BUSINESS SERVICES,WATERFRONT DEVELOPMENT,300,BROOKLYN,ED-0409,41033,47478,2785,0,0,0,0,0,50263,47478,2785,0,0,0,0,0,50263,94956,5570,0,0,0,0,0,100526,PROJECT DELAYED DUE TO CHANGES IN SCOPE/DESIGN,,HOMEPORT PIER AT THE BROOKLYN NAVY YARD FOR CITYWIDE FERRY SERVICE,cpd11-20bk.pdf
DEO-OWLS,Owls Head Pier Emergency Dredging,801,DEPT OF SMALL BUSINESS SERVICES,PLANT UPGRADING AND RECONSTRUCTION,300,BROOKLYN,WP-0112,2200,1349,0,0,0,0,0,851,2200,1349,0,0,0,0,0,851,2200,2698,0,0,0,0,0,1702,4400,PROJECT DELAYED DUE TO CHANGES IN SCOPE/DESIGN,,OWLS HEAD PIER EMERGENCY DREDGING,cpd11-20bk.pdf
DTBKFLATM,Downtown Brooklyn Redevelopment - Flatbush Myrtle Street,801,DEPT OF SMALL BUSINESS SERVICES,MISCELLANEOUS,302,BROOKLYN,HW-1684,13000,24660,0,0,0,0,0,126,24786,24660,0,0,0,0,0,126,24786,49320,0,0,0,0,0,252,49572,PROJECT DELAYED DUE TO CHANGES IN SCOPE/DESIGN,,DOWNTOWN BROOKLYN,cpd11-20bk.pdf
DTBKLYNDV,Downtown Brooklyn Redevelopment,801,DEPT OF SMALL BUSINESS SERVICES,COMMERCIAL DEVELOPMENT,302,BROOKLYN,ED-0075,57239,17370,0,0,0,0,0,5696,23066,17370,0,0,0,0,0,5696,23066,34740,0,0,0,0,0,11392,46132,PROJECT DELAYED DUE TO CHANGES IN SCOPE/DESIGN,BROOKLYN,REDEVELOPMENT,cpd11-20bk.pdf
DTBKLYNFM,Downtown Brooklyn Redevelopment - Fulton Mall,801,DEPT OF SMALL BUSINESS SERVICES,COMMERCIAL DEVELOPMENT,303,BROOKLYN,HW-0001K,11150,17818,59,0,0,0,0,367,18244,17818,59,0,0,0,0,367,18244,35636,118,0,0,0,0,734,36488,PROJECT DELAYED DUE TO CHANGES IN SCOPE/DESIGN,,FULTON MALL,cpd11-20bk.pdf
DTBKWSPK,Downtown Brooklyn - Willoughby Square Park,801,DEPT OF SMALL BUSINESS SERVICES,MISCELLANEOUS,302,BROOKLYN,ED-0075 ED-K075 ED-D075,8500,334,7317,0,0,0,0,0,7651,334,7317,0,0,0,0,0,7651,668,14634,0,0,0,0,0,15302,PROJECT DELAYED DUE TO CHANGES IN SCOPE/DESIGN,,DESIGN AND CONSTRUCTION OF WILLOUGHBY SQUARE PARK,cpd11-20bk.pdf
EASTNYINC,East New York Incubator Improvements,801,DEPT OF SMALL BUSINESS SERVICES,MISCELLANEOUS,300,BROOKLYN,ED-0404,1500,1311,0,0,0,0,0,190,1501,1311,0,0,0,0,0,190,1501,2622,0,0,0,0,0,380,3002,PROJECT DELAYED DUE TO CHANGES IN SCOPE/DESIGN,,EAST NEW YORK INCUBATOR IMPROVEMENTS,cpd11-20bk.pdf
ERFERRY,East River Ferry Route,801,DEPT OF SMALL BUSINESS SERVICES,WATERFRONT DEVELOPMENT,301,BROOKLYN,ED-0075,4900,0,0,0,0,0,0,0,0,0,0,0,0,0,0,0,0,0,0,0,0,0,0,0,0,PROJECT DELAYED DUE TO CHANGES IN SCOPE/DESIGN,,GREENPOINT & NORTH WILLIAMSBURG FERRIES,cpd11-20bk.pdf
FLATNOST,Flatbush - Nostrand Avenue Streetscapes,801,DEPT OF SMALL BUSINESS SERVICES,MISCELLANEOUS,300 303 308 309,BROOKLYN,ED-D384 HW-1684,4500,3850,0,0,0,505,0,202,4557,3850,0,0,0,505,0,202,4557,7700,0,0,0,1010,0,404,9114,PROJECT DELAYED DUE TO CHANGES IN SCOPE/DESIGN,,FLATBUSH - NOSTRAND AVENUE STREETSCAPES,cpd11-20bk.pdf
FLATREV,Flatbush Revitalization,801,DEPT OF SMALL BUSINESS SERVICES,NEIGHBORHOOD REVITALIZATION,,BROOKLYN,ED-0075,50000,52550,0,0,0,0,0,450,53000,52550,0,0,0,0,0,450,53000,105100,0,0,0,0,0,900,106000,PROJECT DELAYED DUE TO CHANGES IN SCOPE/DESIGN,,FLATBUSH REVITALIZATION,cpd11-20bk.pdf
FREIGHTSP,Freight NYC - Rail Transload,801,DEPT OF SMALL BUSINESS SERVICES,MISCELLANEOUS,300,BROOKLYN,ED-0410,15800,0,0,0,0,0,8670,7129,15799,0,0,0,0,0,8670,7129,15799,0,0,0,0,0,17340,14258,31598,PROJECT DELAYED DUE TO CHANGES IN SCOPE/DESIGN,,FREIGHT NYC - SUNSET PARK RAIL - 100K JOBS PLAN,cpd11-20bk.pdf
GK26W5-05,DSGN & CONS OF ROW GI IN 26W-005,801,DEPT OF SMALL BUSINESS SERVICES,GREEN INFRASTRUCTURE PROGRAM,300,BROOKLYN,WP-0169,45271,106870,61863,0,0,0,0,0,168733,106870,61863,0,0,0,0,0,168733,213740,123726,0,0,0,0,0,337466,PROJECT DELAYED DUE TO CHANGES IN SCOPE/DESIGN,,GI - DESIGN AND CONSTRUCTION OF RIGHTOF WAY BIOSWALES AND STORMAWATERGREENSTREETS,cpd11-20bk.pdf
GKNC15-02,GI - Green Infrastructure in Newtown Creek Drainage Area,801,DEPT OF SMALL BUSINESS SERVICES,GREEN INFRASTRUCTURE PROGRAM,300,BROOKLYN,WP-0169,48795,49438,15482,0,0,0,0,0,64920,49438,15482,0,0,0,0,0,64920,98876,30964,0,0,0,0,0,129840,PROJECT DELAYED DUE TO CHANGES IN SCOPE/DESIGN,,GREEN INFRASTRUCTURE IN NEWTOWN CREEK DRAINAGE AREA,cpd11-20bk.pdf
GRAFNYC,Graffiti Free Customized Cargo Truck Purchase,801,DEPT OF SMALL BUSINESS SERVICES,MISCELLANEOUS,300,BROOKLYN,ED-0075,1540,1443,0,0,0,0,97,0,1540,1443,0,0,0,0,97,0,1540,2886,0,0,0,0,194,0,3080,PROJECT DELAYED DUE TO CHANGES IN SCOPE/DESIGN,,GRAFFITI FREE CARGO TRUCK PURCHASE,cpd11-20bk.pdf
GREEN,Green Infrastructure 26W,801,DEPT OF SMALL BUSINESS SERVICES,GREEN INFRASTRUCTURE PROGRAM,300,BROOKLYN,WP-0169,48855,44231,15328,0,0,0,0,0,59559,44231,15328,0,0,0,0,0,59559,88462,30656,0,0,0,0,0,119118,PROJECT DELAYED DUE TO CHANGES IN SCOPE/DESIGN,,GREEN INFRASTRUCTURE 26W,cpd11-20bk.pdf
GREENPNT,Greenpoint Waterfront Esplanade,801,DEPT OF SMALL BUSINESS SERVICES,WATERFRONT DEVELOPMENT,301,BROOKLYN,P-0839 ED-0401,3470,9789,0,0,0,0,0,0,9789,9789,0,0,0,0,0,0,9789,19578,0,0,0,0,0,0,19578,PROJECT DELAYED DUE TO CHANGES IN SCOPE/DESIGN,BROOKLYN,GREENPOINT ESPLANADE,cpd11-20bk.pdf
HBPD200KA,PED BRIDGE - WEST 8 ST (BIN 2269260),801,DEPT OF SMALL BUSINESS SERVICES,COMMUNITY DEVELOPMENT,313,BROOKLYN,HB-0215 HW-0001K,9335,3282,0,0,0,0,0,37,3319,3282,0,0,0,0,0,37,3319,6564,0,0,0,0,0,74,6638,PROJECT DELAYED DUE TO CHANGES IN SCOPE/DESIGN,,CONEY ISLAND - WEST 8TH ST PEDESTRIAN BRIDGE DEMOLITION,cpd11-20bk.pdf
HWKFHAWF,Hamilton Ave - DOT Asphalt Plant (Waterfront),801,DEPT OF SMALL BUSINESS SERVICES,MISCELLANEOUS ENERGY EFFICIENCY AND SUSTAINABILITY,300,BROOKLYN,PU-0200,5575,0,0,0,0,0,5068,0,5068,0,0,0,0,0,5068,0,5068,0,0,0,0,0,10136,0,10136,PROJECT DELAYED DUE TO CHANGES IN SCOPE/DESIGN,HAMILTON AVE - DOT ASPHALT PLANT (WATERFRONT),HAMILTON AVE - DOT ASPHALT PLANT (WATERFRONT),cpd11-20bk.pdf
METBIDWAY,FA - Metrotech BID Wayfinding,801,DEPT OF SMALL BUSINESS SERVICES,NEIGHBORHOOD REVITALIZATION,302,BROOKLYN,ED-D384,1250,410,0,0,400,0,0,0,810,410,0,0,400,0,0,0,810,820,0,0,800,0,0,0,1620,PROJECT DELAYED DUE TO CHANGES IN SCOPE/DESIGN,,FA - METROTECH BID WAYFINDING,cpd11-20bk.pdf
MILLREHAB,Mill Basin - Waterfront Rehabilitation,801,DEPT OF SMALL BUSINESS SERVICES,MISCELLANEOUS,300,BROOKLYN,ED-0409,3250,2759,491,0,0,0,0,0,3250,2759,491,0,0,0,0,0,3250,5518,982,0,0,0,0,0,6500,PROJECT DELAYED DUE TO CHANGES IN SCOPE/DESIGN,,MILL BASIN WATERFRONT REHABILITATION,cpd11-20bk.pdf
MOOREROOF,Moore Street Market Roof Rehabilitation,801,DEPT OF SMALL BUSINESS SERVICES,MARKET DEVELOPMENT,300,BROOKLYN,ED-K384 ED-D384,200,0,700,0,0,0,1500,0,2200,0,700,0,0,0,1500,0,2200,0,1400,0,0,0,3000,0,4400,PROJECT DELAYED DUE TO CHANGES IN SCOPE/DESIGN,,MOORE STREET MARKET ROOF REHABILITATION,cpd11-20bk.pdf
MOOREST,Moore Street Market,801,DEPT OF SMALL BUSINESS SERVICES,MISCELLANEOUS,301,BROOKLYN,ED-K075 ED-D384,200,542,500,157,0,0,0,0,1199,542,500,157,0,0,0,0,1199,1084,1000,314,0,0,0,0,2398,PROJECT DELAYED DUE TO CHANGES IN SCOPE/DESIGN,,MOORE STREET MARKET PROJECT,cpd11-20bk.pdf
MYRTLEBK,Myrtle Ave Acquisition,801,DEPT OF SMALL BUSINESS SERVICES,MISCELLANEOUS,300 302 303 304,BROOKLYN,ED-D384,500,0,0,0,500,0,0,0,500,0,0,0,500,0,0,0,500,0,0,0,1000,0,0,0,1000,PROJECT DELAYED DUE TO CHANGES IN SCOPE/DESIGN,,MYRTLE AVE COMMERCIAL REVITALIZATION & DEVELOPMENT,cpd11-20bk.pdf
NDF-BROAD,NDF - ENY IBZ Infrastructure - Broadband,801,DEPT OF SMALL BUSINESS SERVICES,NEIGHBORHOOD REVITALIZATION,300,BROOKLYN,ED-0384,2500,0,0,0,0,0,0,2500,2500,0,0,0,0,0,0,2500,2500,0,0,0,0,0,0,5000,5000,PROJECT DELAYED DUE TO CHANGES IN SCOPE/DESIGN,,NDF-ENY IBZ BROADBAND,cpd11-20bk.pdf
NDF-CCIMP,NDF - Commercial Corridor Improvements,801,DEPT OF SMALL BUSINESS SERVICES,NEIGHBORHOOD REVITALIZATION,300,BROOKLYN,ED-0384,500,0,0,0,0,0,0,500,500,0,0,0,0,0,0,500,500,0,0,0,0,0,0,1000,1000,PROJECT DELAYED DUE TO CHANGES IN SCOPE/DESIGN,,NDF - COMMERCIAL CORRIDOR IMPROVEMENTS,cpd11-20bk.pdf
NDF-IBMOD,NDF - ENY Industiral Buiding Modernization and Activation,801,DEPT OF SMALL BUSINESS SERVICES,NEIGHBORHOOD REVITALIZATION,300,BROOKLYN,ED-0384,4500,3504,995,0,0,0,0,0,4499,3504,995,0,0,0,0,0,4499,7008,1990,0,0,0,0,0,8998,PROJECT DELAYED DUE TO CHANGES IN SCOPE/DESIGN,,INDUSTRIAL BUILDING MODERNIZATION AND ACTIVATION,cpd11-20bk.pdf
NEWKIRK,FA - Newkirk Plaza Reconstruction,801,DEPT OF SMALL BUSINESS SERVICES,MISCELLANEOUS,314,BROOKLYN,ED-D075,463,463,0,0,50,0,0,0,513,463,0,0,50,0,0,0,513,926,0,0,100,0,0,0,1026,PROJECT DELAYED DUE TO CHANGES IN SCOPE/DESIGN,NEWKIRK,NEWKIRK PLAZA,cpd11-20bk.pdf
NOSTRAND,FA - Nostrand Avenue Merchants Assoc. (Flatbush Gateway),801,DEPT OF SMALL BUSINESS SERVICES,COMMERCIAL DEVELOPMENT,309,BROOKLYN,ED-D384,850,0,0,0,850,0,0,0,850,0,0,0,850,0,0,0,850,0,0,0,1700,0,0,0,1700,PROJECT DELAYED DUE TO CHANGES IN SCOPE/DESIGN,BOROWIDE,COMMERCIAL REVITALIZATION,cpd11-20bk.pdf
NWBURGFL,North Williamsburg Ferry Landing,801,DEPT OF SMALL BUSINESS SERVICES,WATERFRONT DEVELOPMENT,301,BROOKLYN,ED-0075 ED-D401 FA-0027,1176,536,42,1,0,0,0,0,579,536,42,1,0,0,0,0,579,1072,84,2,0,0,0,0,1158,PROJECT DELAYED DUE TO CHANGES IN SCOPE/DESIGN,,"CONSTRUCTION OF BARGE FERRY LANDING AT THE NORTH 5TH ST PIER IN NORTHWILLIAMSBURG,",cpd11-20bk.pdf
NYCFHP2,NYC Ferry Homeport 2,801,DEPT OF SMALL BUSINESS SERVICES,MISCELLANEOUS,300,BROOKLYN,ED-0409,65000,8374,28626,28000,0,0,0,0,65000,8374,28626,28000,0,0,0,0,65000,16748,57252,56000,0,0,0,0,130000,,,HOMEPORT 2 AT ATLANTIC BASIN,cpd11-20bk.pdf
P-213CNTR,Seaside Park and Community Arts Center Acquisitions,801,DEPT OF SMALL BUSINESS SERVICES,MISCELLANEOUS,300,BROOKLYN,ED-0075,17168,16100,0,0,0,0,0,1068,17168,16100,0,0,0,0,0,1068,17168,32200,0,0,0,0,0,2136,34336,PROJECT DELAYED DUE TO CHANGES IN SCOPE/DESIGN,,SEASIDE PARK AND COMMUNITY ARTS CENTER ACQUISITIONS,cpd11-20bk.pdf
P-2GPWB07,GPWB - Box Street and Newtown Barge Parks,801,DEPT OF SMALL BUSINESS SERVICES,NEIGHBORHOOD PARKS AND PLAYGROUNDS,301,BROOKLYN,P-0839 WP-0283,10670,3352,959,0,0,0,0,0,4311,3352,959,0,0,0,0,0,4311,6704,1918,0,0,0,0,0,8622,PROJECT DELAYED DUE TO UNFORESEEN SITE/FIELD CONDITION,DUPONT ST - BKLYN,GPWB - DUPONT ST NEWTOWN BARGE PLGRD,cpd11-20bk.pdf
P-2GPWB08,GPWB - 65 Commercial St Soccer Pk-MTA Reloc. & Park Develop.,801,DEPT OF SMALL BUSINESS SERVICES,NEIGHBORHOOD PARKS AND PLAYGROUNDS,301,BROOKLYN,P-1018 P-0839 ED-0384,15400,9886,501,0,0,0,44,0,10431,9886,501,0,0,0,44,0,10431,19772,1002,0,0,0,88,0,20862,PROJECT DELAYED DUE TO UNFORESEEN SITE/FIELD CONDITION,65 COMMERCIAL ST - BKLYN,GPWB - 65 COMMERCIAL ST SOCCER PK,cpd11-20bk.pdf
P-2GPWB24,GPWB- Bayside Demolition,801,DEPT OF SMALL BUSINESS SERVICES,"LARGE, MAJOR AND REGIONAL PARK RECONSTRUCTION",300 301,BROOKLYN,P-0839,22000,6157,707,0,0,15136,0,0,22000,6157,707,0,0,15136,0,0,22000,12314,1414,0,0,30272,0,0,44000,PROJECT DELAYED DUE TO CHANGES IN SCOPE/DESIGN,GREENPOINT WILLIAMSBURG SECTION OF BROOKLYN,BAYSIDE DEMOLITION,cpd11-20bk.pdf
P-2GPWBOX,GPWB - Box Street Park,801,DEPT OF SMALL BUSINESS SERVICES,NEIGHBORHOOD PARKS AND PLAYGROUNDS,301,BROOKLYN,P-0839 P-1018,18000,0,5150,11000,0,0,0,0,16150,0,5150,11000,0,0,0,0,16150,0,10300,22000,0,0,0,0,32300,PROJECT DELAYED DUE TO CHANGES IN SCOPE/DESIGN,,CONSTRUCTION OF BOX STREET PARK,cpd11-20bk.pdf
P-2GPWNB,GPWB - Newtown Barge Park,801,DEPT OF SMALL BUSINESS SERVICES,NEIGHBORHOOD PARKS AND PLAYGROUNDS,301,BROOKLYN,P-0839 WP-0283 P-1018,20608,15395,732,0,0,0,0,0,16127,15395,732,0,0,0,0,0,16127,30790,1464,0,0,0,0,0,32254,PROJECT DELAYED DUE TO CHANGES IN SCOPE/DESIGN,,NEWTOWN BARGE PARK,cpd11-20bk.pdf
PIER69TH,Pier Substructure Rehabilitation - 69th St. Pier,801,DEPT OF SMALL BUSINESS SERVICES,WATERFRONT DEVELOPMENT,310,BROOKLYN,ED-0409,6569,5201,0,0,0,0,0,0,5201,5201,0,0,0,0,0,0,5201,10402,0,0,0,0,0,0,10402,PROJECT DELAYED DUE TO CHANGES IN SCOPE/DESIGN,,,cpd11-20bk.pdf
PROSPPLC,Prospect Park Lakeside Center,801,DEPT OF SMALL BUSINESS SERVICES,"LARGE, MAJOR AND REGIONAL PARK RECONSTRUCTION",306 307 308 309 314 300,BROOKLYN,P-0245K P-D017,31313,48087,0,0,0,48,0,0,48135,48087,0,0,0,48,0,0,48135,96174,0,0,0,96,0,0,96270,PROJECT DELAYED DUE TO CHANGES IN SCOPE/DESIGN,,PROSPECT PARK LAKESIDE CENTER - ICE RINK AND LANDSCAPING,cpd11-20bk.pdf
PV230-SHA,FA - WCS - New York Aquarium,801,DEPT OF SMALL BUSINESS SERVICES,NEW TECHNOLOGY AND CONSTRUCTION,313,BROOKLYN,PV-K230 PV-0230,37735,117651,0,0,0,1519,0,0,119170,117651,0,0,0,1519,0,0,119170,235302,0,0,0,3038,0,0,238340,PROJECT DELAYED DUE TO CHANGES IN SCOPE/DESIGN,"BOARDWALK AT WEST 8TH STREET & SURF AVENUE, BROOKLYN NY, 11224",CONSTRUCTION OF NEW SHARK EXHIBIT ON AQUARIUM GROUNDS,cpd11-20bk.pdf
PV264CINE,BAM - BAM South Site Theaters,801,DEPT OF SMALL BUSINESS SERVICES,MISCELLANEOUS,399,BROOKLYN,PV-0264 PV-K264 PV-D264 PV-0467,7500,10198,13655,0,0,0,0,0,23853,10198,13655,0,0,0,0,0,23853,20396,27310,0,0,0,0,0,47706,PROJECT DELAYED DUE TO CHANGES IN SCOPE/DESIGN,,BAM - BAM SOUTH SITE THEATERS,cpd11-20bk.pdf
PV264HART,Brooklyn Academy of Music (BAM),801,DEPT OF SMALL BUSINESS SERVICES,ESSENTIAL RECONSTRUCTION OF FACILITIES,300,BROOKLYN,PV-0264 PV-0467,4426,22148,0,0,311,0,0,0,22459,22148,0,0,311,0,0,0,22459,44296,0,0,622,0,0,0,44918,PROJECT DELAYED DUE TO CHANGES IN SCOPE/DESIGN,,"BAM DEVELOPMENT AND EXPANSION OF HARVEY THEATRE INCLUSING ELEVATOR TOGALLERY,",cpd11-20bk.pdf
PV467SOST,DBCD South Site Cultural Condo Fitout,801,DEPT OF SMALL BUSINESS SERVICES,ESSENTIAL RECONSTRUCTION OF FACILITIES,302,BROOKLYN,PV-0467,1000,4182,4237,0,0,0,0,0,8419,4182,4237,0,0,0,0,0,8419,8364,8474,0,0,0,0,0,16838,PROJECT DELAYED DUE TO CHANGES IN SCOPE/DESIGN,20 LAFAYETTE AVENUE BROOKLYN,DBCD SOUTH SITE CULTURAL CONDO FITOUT OF COMMON AREAS,cpd11-20bk.pdf
PV467STFO,651 Arts South Site Studios Fitout,801,DEPT OF SMALL BUSINESS SERVICES,ESSENTIAL RECONSTRUCTION OF FACILITIES,302,BROOKLYN,PV-0467 PV-D467,7750,7399,8352,0,0,0,0,0,15751,7399,8352,0,0,0,0,0,15751,14798,16704,0,0,0,0,0,31502,PROJECT DELAYED DUE TO CHANGES IN SCOPE/DESIGN,20 LAFAYETTE AVENUE BROOKLYN,651 ARTS SOUTH SITE STUDIOS FITOUT,cpd11-20bk.pdf
PWKNTH,Northside Town Hall,801,DEPT OF SMALL BUSINESS SERVICES,MISCELLANEOUS CONSTRUCTION,301,BROOKLYN,PW-K007 PW-0077 PW-D007,4692,0,3242,1450,0,0,0,0,4692,0,3242,1450,0,0,0,0,4692,0,6484,2900,0,0,0,0,9384,PROJECT DELAYED DUE TO CHANGES IN SCOPE/DESIGN,,NORTHSIDE TOWN HALL,cpd11-20bk.pdf
PWKNTH2,Northside Town Hall - Renovations to Historic Firehouse,801,DEPT OF SMALL BUSINESS SERVICES,MISCELLANEOUS CONSTRUCTION,,BROOKLYN,PW-K007,250,0,250,0,0,0,0,0,250,0,250,0,0,0,0,0,250,0,500,0,0,0,0,0,500,PROJECT DELAYED DUE TO CHANGES IN SCOPE/DESIGN,,NORTHSIDE TOWN HALL COMMUNITY AND CULTURAL CENTER,cpd11-20bk.pdf
RE25HC,"RECONSTRUCT BULKHEAD 1ST AVE AND 52ND ST, BKLYN",801,DEPT OF SMALL BUSINESS SERVICES,REHABILITATION OF WATERFRONT PROPERTIES,301,BROOKLYN,RE-0025,4281,2687,0,0,0,0,1176,0,3863,2687,0,0,0,0,1176,0,3863,5374,0,0,0,0,2352,0,7726,PROJECT DELAYED DUE TO CHANGES IN SCOPE/DESIGN,,"RECONSTRUCT BULKHEAD 1ST AVE AND 52ND ST, BROOKLYN",cpd11-20bk.pdf
REDHOOK,Red Hook Library,801,DEPT OF SMALL BUSINESS SERVICES,MISCELLANEOUS,306 300,BROOKLYN,LB-D104 LB-0104,2835,1077,0,14471,0,0,0,0,15548,1077,0,14471,0,0,0,0,15548,2154,0,28942,0,0,0,0,31096,,,RED HOOK LIBRARY,cpd11-20bk.pdf
RS-CIC,Raise Shoreline - Coney Island Creek,801,DEPT OF SMALL BUSINESS SERVICES,MISCELLANEOUS ENERGY EFFICIENCY AND SUSTAINABILITY,300,BROOKLYN,PU-0100,32000,0,0,0,0,32000,0,0,32000,0,0,0,0,32000,0,0,32000,0,0,0,0,64000,0,0,64000,PROJECT DELAYED DUE TO CHANGES IN SCOPE/DESIGN,,FUNDING TO RAISE SHORELINE - CONEY ISLAND CREEK,cpd11-20bk.pdf
SAND2601C,CIH,801,DEPT OF SMALL BUSINESS SERVICES,ROUTINE RECONSTRUCTION,313,BROOKLYN,HO-0214,7700,0,0,0,0,0,0,0,0,0,0,0,0,0,0,0,0,0,0,0,0,0,0,0,0,,"2601 OCEAN PARKWAY, BROOKLYN, NY 11235",RENOVATE EXISTING SPACE ON THE 5TH FLOOR OF THE MAIN HOSPITAL BUILDING TO RELOCATE,cpd11-20bk.pdf
SAND2603C,CIH,801,DEPT OF SMALL BUSINESS SERVICES,ROUTINE RECONSTRUCTION,313,BROOKLYN,HO-0214,3876,0,0,0,0,0,0,0,0,0,0,0,0,0,0,0,0,0,0,0,0,0,0,0,0,,"2601 OCEAN PARKWAY, BROOKLYN, NY 11235","RENOVATE APPROXIMATELY 11,000 SQ. FT. OF VACANT SPACE ON THE FIRST FLOOR OF THE MAIN",cpd11-20bk.pdf
SAND2605,CIH,801,DEPT OF SMALL BUSINESS SERVICES,MISCELLANEOUS,300,BROOKLYN,HO-0214,1084343,23472,44726,0,0,0,0,0,68198,23472,44726,0,0,0,0,0,68198,46944,89452,0,0,0,0,0,136396,PROJECT DELAYED DUE TO CHANGES IN SCOPE/DESIGN,,CONEY ISLAND HOSPITAL DESIGN AND CONSTRUCTION,cpd11-20bk.pdf
SANDB3416,BNYDC - PW 3416 - Berth 6 Concrete Slab,801,DEPT OF SMALL BUSINESS SERVICES,INDUSTRIAL DEVELOPMENT,300,BROOKLYN,ED-0319,335,11,0,23,0,0,0,0,34,11,0,23,0,0,0,0,34,22,0,46,0,0,0,0,68,PROJECT DELAYED DUE TO CHANGES IN SCOPE/DESIGN,,PW 3416 - CONCRETE SLAB,cpd11-20bk.pdf
SANDB3820,"BNYDC - PW 3820 - Substations - Buildings 127, 275, 293",801,DEPT OF SMALL BUSINESS SERVICES,INDUSTRIAL DEVELOPMENT,300,BROOKLYN,ED-0319,3191,47,146,0,0,0,0,0,193,47,146,0,0,0,0,0,193,94,292,0,0,0,0,0,386,PROJECT DELAYED DUE TO CHANGES IN SCOPE/DESIGN,,"PW 3820 - SUBSTATIONS - BUILDINGS 127, 275, 293",cpd11-20bk.pdf
SANDB4225,"BNYDC - PW 4225 Dry-Dock /Caisson Gate #5,#6, Pump Well #156",801,DEPT OF SMALL BUSINESS SERVICES,INDUSTRIAL DEVELOPMENT,300,BROOKLYN,ED-0319,15897,172,0,911,0,0,0,0,1083,172,0,911,0,0,0,0,1083,344,0,1822,0,0,0,0,2166,PROJECT DELAYED DUE TO CHANGES IN SCOPE/DESIGN,,"PW 4225 - DRY-DOCK /CAISSON GATE #5,#6, PUMP WELL #156 - RESTORATION AND MITIGATION",cpd11-20bk.pdf
SANDB4270,BNYDC - PW 4270 - BNYDC SITE-WIDE CONDUIT - PAAP,801,DEPT OF SMALL BUSINESS SERVICES,INDUSTRIAL DEVELOPMENT,300,BROOKLYN,ED-0319,1184,13,0,65,0,0,0,0,78,13,0,65,0,0,0,0,78,26,0,130,0,0,0,0,156,PROJECT DELAYED DUE TO CHANGES IN SCOPE/DESIGN,,PW 4270 - BNYDC SITE-WIDE CONDUIT - PAAP - RESTORATION AND MITIGATION,cpd11-20bk.pdf
SANDB4271,BNYDC - PW 4271 - Substations No. 292 and No. 542,801,DEPT OF SMALL BUSINESS SERVICES,INDUSTRIAL DEVELOPMENT,300,BROOKLYN,ED-0319,3071,25,0,175,0,0,0,0,200,25,0,175,0,0,0,0,200,50,0,350,0,0,0,0,400,PROJECT DELAYED DUE TO CHANGES IN SCOPE/DESIGN,,PW 4271 - SUBSTATIONS NO. 292 AND NO. 542 - RESTORATION AND MITIGATION,cpd11-20bk.pdf
SANDB4273,BNYDC - PW 4273 - Steam Generating Back-Up Plant - Bldg #41A,801,DEPT OF SMALL BUSINESS SERVICES,INDUSTRIAL DEVELOPMENT,300,BROOKLYN,ED-0319,1441,18,0,79,0,0,0,0,97,18,0,79,0,0,0,0,97,36,0,158,0,0,0,0,194,PROJECT DELAYED DUE TO CHANGES IN SCOPE/DESIGN,,PW 4273 - STEAM GENERATING BACK-UP PLANT - BLDG #41A - RESTORATION AND MITIGATION,cpd11-20bk.pdf
SANDB4274,BNYDC - PW 4274 - Dry Dock 1,801,DEPT OF SMALL BUSINESS SERVICES,INDUSTRIAL DEVELOPMENT,300,BROOKLYN,ED-0319,2931,115,0,179,0,0,0,0,294,115,0,179,0,0,0,0,294,230,0,358,0,0,0,0,588,PROJECT DELAYED DUE TO CHANGES IN SCOPE/DESIGN,,PW 4274 - DRY DOCK 1,cpd11-20bk.pdf
SANDB4275,BNYDC - PW 4275 - SUB STATION G BUILDING 386,801,DEPT OF SMALL BUSINESS SERVICES,INDUSTRIAL DEVELOPMENT,300,BROOKLYN,ED-0319,14243,153,0,744,0,0,0,0,897,153,0,744,0,0,0,0,897,306,0,1488,0,0,0,0,1794,PROJECT DELAYED DUE TO CHANGES IN SCOPE/DESIGN,,PW 4275 - SUB STATION G BUILDING 386 - RESTORATION AND MITIGATION,cpd11-20bk.pdf
SANDB4307,BNYDC - PW 4307 Substation B,801,DEPT OF SMALL BUSINESS SERVICES,INDUSTRIAL DEVELOPMENT,300,BROOKLYN,ED-0319,8184,78,0,440,0,0,0,0,518,78,0,440,0,0,0,0,518,156,0,880,0,0,0,0,1036,PROJECT DELAYED DUE TO CHANGES IN SCOPE/DESIGN,,PW 4307 - SUBSTATION B - RESTORATION AND MITIGATION,cpd11-20bk.pdf
SANDB4388,BNYDC - PW 4388 - Boiler Replacement,801,DEPT OF SMALL BUSINESS SERVICES,INDUSTRIAL DEVELOPMENT,300,BROOKLYN,ED-0319,1079,25,0,43,0,0,0,0,68,25,0,43,0,0,0,0,68,50,0,86,0,0,0,0,136,PROJECT DELAYED DUE TO CHANGES IN SCOPE/DESIGN,,PW 4388 - BOILER REPLACEMENT - RESTORATION AND MITIGATION,cpd11-20bk.pdf
SANDB4582,"BNYDC - PW 4582 - BERTH 9,9A",801,DEPT OF SMALL BUSINESS SERVICES,INDUSTRIAL DEVELOPMENT,300,BROOKLYN,ED-0319,10502,0,0,697,0,0,0,0,697,0,0,697,0,0,0,0,697,0,0,1394,0,0,0,0,1394,PROJECT DELAYED DUE TO CHANGES IN SCOPE/DESIGN,,"PW 4582 - BERTH 9,9A - RESTORATION AND MITIGATION",cpd11-20bk.pdf
SANDB4583,BNYDC - PW 4583 - BERTH 10 & 10A,801,DEPT OF SMALL BUSINESS SERVICES,INDUSTRIAL DEVELOPMENT,300,BROOKLYN,ED-0319,11538,0,0,723,0,0,0,0,723,0,0,723,0,0,0,0,723,0,0,1446,0,0,0,0,1446,PROJECT DELAYED DUE TO CHANGES IN SCOPE/DESIGN,,PW 4583 - BERTH 10 & 10A - RESTORATION AND MITIGATION,cpd11-20bk.pdf
SANDBCT,EDC - Hurricane Sandy - BCT Repairs,801,DEPT OF SMALL BUSINESS SERVICES,MISCELLANEOUS,306 307,BROOKLYN,ED-0404,3000,0,0,0,300,0,0,0,300,0,0,0,300,0,0,0,300,0,0,0,600,0,0,0,600,PROJECT DELAYED DUE TO CHANGES IN SCOPE/DESIGN,,REPAIRS AT THE BCT PROJECT AS A RESULT OF HURRICANE SANDY,cpd11-20bk.pdf
SANDBNYAM,BNYDC Hurricane Sandy Asset Management Repairs,801,DEPT OF SMALL BUSINESS SERVICES,INDUSTRIAL DEVELOPMENT,300,BROOKLYN,ED-0319,3610,0,629,3371,545,0,0,0,4545,0,629,3371,545,0,0,0,4545,0,1258,6742,1090,0,0,0,9090,,,BROOKLYN NAVY YARD - HURRICANE SANDY RECOVERY LOCAL MATCH,cpd11-20bk.pdf
SANDBNYEC,BNYDC Hurricane Sandy Electrical Repairs,801,DEPT OF SMALL BUSINESS SERVICES,MISCELLANEOUS,300,BROOKLYN,ED-0319,3100,0,0,320,0,0,0,0,320,0,0,320,0,0,0,0,320,0,0,640,0,0,0,0,640,PROJECT DELAYED DUE TO CHANGES IN SCOPE/DESIGN,,ELECTRICAL REPAIRS IN THE BROOKLYN NAVY YARD AS A RESULT OF HURRICANESANDY,cpd11-20bk.pdf
SANDBNYWF,BNYDC Hurricane Sandy Waterfront Repair,801,DEPT OF SMALL BUSINESS SERVICES,MISCELLANEOUS,300,BROOKLYN,ED-0319,24850,0,0,1272,0,0,0,0,1272,0,0,1272,0,0,0,0,1272,0,0,2544,0,0,0,0,2544,PROJECT DELAYED DUE TO CHANGES IN SCOPE/DESIGN,,WATERFRONT REPAIRS DUE TO HURRICANE SANDY,cpd11-20bk.pdf
SANDCD9,HARBOR CHARLIE,801,DEPT OF SMALL BUSINESS SERVICES,POLICE FACILITIES,300,BROOKLYN,PO-0079,5368,0,572,0,0,0,0,0,572,0,572,0,0,0,0,0,572,0,1144,0,0,0,0,0,1144,PROJECT DELAYED DUE TO CHANGES IN SCOPE/DESIGN,,HARBOR ELECTRICAL,cpd11-20bk.pdf
SANDG3BAT,FEMA 428 Projects - Group 3 - Brooklyn Army Terminal BAT,801,DEPT OF SMALL BUSINESS SERVICES,MISCELLANEOUS,300,BROOKLYN,ED-0075,6557,0,0,0,0,0,0,0,0,0,0,0,0,0,0,0,0,0,0,0,0,0,0,0,0,PROJECT DELAYED DUE TO CHANGES IN SCOPE/DESIGN,,FEMA 428 PROJECTS - GROUP 3 - BROOKLYN ARMY TERMINAL BAT,cpd11-20bk.pdf
SANDG3BSH,FEMA 428 Projects - Group 3 - BUSH Terminal,801,DEPT OF SMALL BUSINESS SERVICES,MISCELLANEOUS,300,BROOKLYN,ED-0075,13606,0,0,0,0,0,0,0,0,0,0,0,0,0,0,0,0,0,0,0,0,0,0,0,0,PROJECT DELAYED DUE TO CHANGES IN SCOPE/DESIGN,,FEMA 428 PROJECTS - GROUP 3 RESILIENCY PROJECTS - BUSH TERMINAL,cpd11-20bk.pdf
SANDRBCT,FA Resiliency - BCT,801,DEPT OF SMALL BUSINESS SERVICES,MISCELLANEOUS,300,BROOKLYN,FA-0027,10000,201,250,2049,0,0,0,0,2500,201,250,2049,0,0,0,0,2500,402,500,4098,0,0,0,0,5000,PROJECT DELAYED DUE TO CHANGES IN SCOPE/DESIGN,,FA RESILIENCY - BCT,cpd11-20bk.pdf
SANDYNYA,WCS - New York Aquarium Sandy Renovation,801,DEPT OF SMALL BUSINESS SERVICES,NEW TECHNOLOGY AND CONSTRUCTION,313,BROOKLYN,PV-0230 PV-0467,111256,11592,11914,0,0,0,0,0,23506,11592,11914,0,0,0,0,0,23506,23184,23828,0,0,0,0,0,47012,,,SANDY RELATED RENOVATION/RESTORATION - WCS NEW YORK AQUARIUM,cpd11-20bk.pdf
SBMT39P,South Brooklyn Marine Terminal 39th Street Pier Rehab,801,DEPT OF SMALL BUSINESS SERVICES,WATERFRONT DEVELOPMENT,307,BROOKLYN,ED-0409,725,14870,0,1708,1747,0,0,0,18325,14870,0,1708,1747,0,0,0,18325,29740,0,3416,3494,0,0,0,36650,PROJECT DELAYED DUE TO CHANGES IN SCOPE/DESIGN,,SBMT 39TH STREET PIER,cpd11-20bk.pdf
SBMTAUTO,SBMT - Axis,801,DEPT OF SMALL BUSINESS SERVICES,WATERFRONT DEVELOPMENT,307,BROOKLYN,ED-0380 ED-0075 ED-0404 SE-0200K WM-0001,24000,48466,0,0,0,207,0,10,48683,48466,0,0,0,207,0,10,48683,96932,0,0,0,414,0,20,97366,PROJECT DELAYED DUE TO CHANGES IN SCOPE/DESIGN,,SOUTH BROOKLYN MARINE TERMINAL,cpd11-20bk.pdf
SBMTFRT,Freight - SBMT 33rd Street Pier,801,DEPT OF SMALL BUSINESS SERVICES,MISCELLANEOUS,300,BROOKLYN,ED-0404,39400,0,0,3000,19560,0,0,16840,39400,0,0,3000,19560,0,0,16840,39400,0,0,6000,39120,0,0,33680,78800,,,FREIGHT - SBMT 33RD STREET PIER,cpd11-20bk.pdf
SNSTFRGH2,Sunset Park Areawide Infrastructure Improvements,801,DEPT OF SMALL BUSINESS SERVICES,NEIGHBORHOOD REVITALIZATION,300,BROOKLYN,ED-0384,37500,7500,0,0,3358,26642,0,0,37500,7500,0,0,3358,26642,0,0,37500,15000,0,0,6716,53284,0,0,75000,PROJECT DELAYED DUE TO CHANGES IN SCOPE/DESIGN,,SUNSET PARK IMPROVEMENTS - AREA IMPROVEMENTS,cpd11-20bk.pdf
SPUDBARGE,69th Street Pier Reconstruction - Spud Barge,801,DEPT OF SMALL BUSINESS SERVICES,MISCELLANEOUS,307,BROOKLYN,ED-D075,500,0,0,0,0,0,500,0,500,0,0,0,0,0,500,0,500,0,0,0,0,0,1000,0,1000,PROJECT DELAYED DUE TO CHANGES IN SCOPE/DESIGN,,69TH STREET PIER RECONSTRUCTION-SPUD BARGE,cpd11-20bk.pdf
STRAND2,Strand Theater Rehab,801,DEPT OF SMALL BUSINESS SERVICES,MISCELLANEOUS,302,BROOKLYN,ED-0075,2000,1465,12,0,0,0,0,90,1567,1465,12,0,0,0,0,90,1567,2930,24,0,0,0,0,180,3134,PROJECT DELAYED DUE TO CHANGES IN SCOPE/DESIGN,,STRAND THEATER REHAB,cpd11-20bk.pdf
SUNSETPAR,Sunset Park Waterfront Redevelopment,801,DEPT OF SMALL BUSINESS SERVICES,WATERFRONT DEVELOPMENT,307,BROOKLYN,ED-0075 P-D017 ED-D075 P-1245 ED-0410,1382,22470,4704,0,500,0,1728,0,29402,22470,4704,0,500,0,1728,0,29402,44940,9408,0,1000,0,3456,0,58804,PROJECT DELAYED DUE TO CHANGES IN SCOPE/DESIGN,,,cpd11-20bk.pdf
SUNSETWIF,Sunset Park 5th Avenue Wired - Sunset Park BID Free WiFi,801,DEPT OF SMALL BUSINESS SERVICES,NEIGHBORHOOD REVITALIZATION,300,BROOKLYN,ED-K075,35,0,35,0,0,0,0,0,35,0,35,0,0,0,0,0,35,0,70,0,0,0,0,0,70,PROJECT DELAYED DUE TO CHANGES IN SCOPE/DESIGN,,SUNSET PARK BID WIFI,cpd11-20bk.pdf
TIMP-BRCS,Tenant Improvement Fund-Brooklyn Roasting Coffee Shop,801,DEPT OF SMALL BUSINESS SERVICES,INDUSTRIAL DEVELOPMENT,300,BROOKLYN,ED-0380,271,0,0,0,271,0,0,0,271,0,0,0,271,0,0,0,271,0,0,0,542,0,0,0,542,PROJECT DELAYED DUE TO CHANGES IN SCOPE/DESIGN,,THIS CP COVERS THE WORK TO FIT OUT THE SPACE IN PREPARATION FOR THE TENANT'S COFFEE,cpd11-20bk.pdf
WCSNONPW,WCS - NYA Sandy Renovation Non FEMA Eligible,801,DEPT OF SMALL BUSINESS SERVICES,NEW TECHNOLOGY AND CONSTRUCTION,300,BROOKLYN,PV-0230,2049,0,2049,0,0,0,0,0,2049,0,2049,0,0,0,0,0,2049,0,4098,0,0,0,0,0,4098,,,SANDY RELATED WORK,cpd11-20bk.pdf
WLBKWSMM,BROOKLYN WHOLESALE MEAT MARKET,801,DEPT OF SMALL BUSINESS SERVICES,MISCELLANEOUS,300,BROOKLYN,ED-0409,2000,0,400,800,800,0,0,0,2000,0,400,800,800,0,0,0,2000,0,800,1600,1600,0,0,0,4000,,,BROOKLYN WHOLESALE MEAT MARKET,cpd11-20bk.pdf
WLERBRG,EAST RIVER SEAWALL-BROOKLYN BRIDGE ESPLANADE,801,DEPT OF SMALL BUSINESS SERVICES,MISCELLANEOUS,300,BROOKLYN,ED-0409,0,0,1012,2023,2023,0,0,0,5058,0,1012,2023,2023,0,0,0,5058,0,2024,4046,4046,0,0,0,10116,,,EAST RIVER SEAWALL - BROOKLYN BRIDGE ESPLANADE,cpd11-20bk.pdf
WLPIER6,BUSH TERMINAL PIER 6 RECONSTRUCTION,801,DEPT OF SMALL BUSINESS SERVICES,WATERFRONT DEVELOPMENT,300,BROOKLYN,ED-0409,34000,0,5100,14450,14450,0,0,0,34000,0,5100,14450,14450,0,0,0,34000,0,10200,28900,28900,0,0,0,68000,,,BUSH TERMINAL PIER 6 RECONSTRUCTION,cpd11-20bk.pdf
WLPIER7,BUSH TERMINAL PIER 7 DEMOLITION,801,DEPT OF SMALL BUSINESS SERVICES,WATERFRONT DEVELOPMENT,300,BROOKLYN,ED-0409,8500,0,1700,3400,3400,0,0,0,8500,0,1700,3400,3400,0,0,0,8500,0,3400,6800,6800,0,0,0,17000,,,BUSH TERMINAL PIER 7 DEMOLITION,cpd11-20bk.pdf
HAM06BOBK,BOULEVARD BRICKWORK,806,HOUSING PRESERVATION AND DEVEL,LOW TO MODERATE INCOME PUBLIC HOUSING UPGRADE,305,BROOKLYN,HA-0001,7136,4276,2210,0,0,0,0,0,6486,4276,2210,0,0,0,0,0,6486,8552,4420,0,0,0,0,0,12972,,"LINDEN BLVD, ASHFORD ST, WORTMAN AVE, SCHENCK AVE",BRICKWORK,cpd11-20bk.pdf
HAM10WYCR,WYCKOFF GARDENS COMMUNITY ROOM,806,HOUSING PRESERVATION AND DEVEL,LOW TO MODERATE INCOME PUBLIC HOUSING UPGRADE,306,BROOKLYN,HA-D001,450,0,641,0,0,0,0,0,641,0,641,0,0,0,0,0,641,0,1282,0,0,0,0,0,1282,PROJECT DELAYED DUE TO CHANGES IN SCOPE/DESIGN,,WYCKOFF GARDENS COMMUNITY ROOM,cpd11-20bk.pdf
HAM12MCPL,MARCY HOUSES DAY CARE CENTER PLAYGROUND,806,HOUSING PRESERVATION AND DEVEL,LOW TO MODERATE INCOME PUBLIC HOUSING UPGRADE,303,BROOKLYN,HA-D001,209,169,40,0,0,0,0,0,209,169,40,0,0,0,0,0,209,338,80,0,0,0,0,0,418,PROJECT DELAYED DUE TO CHANGES IN SCOPE/DESIGN,,UPGRADE PLAYGROUND AT DAY CARE CENTER,cpd11-20bk.pdf
HAM12UPDO,UNITY PLAZA COMMUNITY CENTER UPGRADE,806,HOUSING PRESERVATION AND DEVEL,LOW TO MODERATE INCOME PUBLIC HOUSING UPGRADE,305,BROOKLYN,HA-D001,1500,0,3000,0,0,0,0,0,3000,0,3000,0,0,0,0,0,3000,0,6000,0,0,0,0,0,6000,PROJECT DELAYED DUE TO UNFORESEEN SITE/FIELD CONDITION,,BUILD DOME FOR RECREATION FACILITY,cpd11-20bk.pdf
HAM12WYCC,WYCKOFF GARDENS COMMUNITY CENTER UPGRADE,806,HOUSING PRESERVATION AND DEVEL,LOW TO MODERATE INCOME PUBLIC HOUSING UPGRADE,306,BROOKLYN,HA-D001,150,0,810,0,0,0,0,0,810,0,810,0,0,0,0,0,810,0,1620,0,0,0,0,0,1620,PROJECT DELAYED DUE TO BUDGETARY CONSTRAINTS,,"UPGRADES TO INCLUDE CLASSROOMS, OPEN SHOP AREA AND OFFICES",cpd11-20bk.pdf
HAM13SURF,SUMNER HOUSES ROOF REPLACEMENT,806,HOUSING PRESERVATION AND DEVEL,LOW TO MODERATE INCOME PUBLIC HOUSING UPGRADE,303,BROOKLYN,HA-0001,11476,9376,1057,0,0,0,0,0,10433,9376,1057,0,0,0,0,0,10433,18752,2114,0,0,0,0,0,20866,PROJECT DELAYED DUE TO CHANGES IN SCOPE/DESIGN,,ROOF REPLACEMENT,cpd11-20bk.pdf
HAM14KBEY,KINGSBOROUGH AND EXTENSION ENERGY IMPROVEMENTS,806,HOUSING PRESERVATION AND DEVEL,LOW TO MODERATE INCOME PUBLIC HOUSING UPGRADE,308,BROOKLYN,HA-0001,2290,3142,3302,0,0,0,0,0,6444,3142,3302,0,0,0,0,0,6444,6284,6604,0,0,0,0,0,12888,PROJECT DELAYED DUE TO BUDGETARY CONSTRAINTS,,ENERGY UPGRADES,cpd11-20bk.pdf
HAM15COBC,CONEY ISLAND HOUSES I (SITE 4 & 5) BASKETBALL COURT RENO,806,HOUSING PRESERVATION AND DEVEL,LOW TO MODERATE INCOME PUBLIC HOUSING UPGRADE,313,BROOKLYN,HA-D001,75,0,75,0,0,0,0,0,75,0,75,0,0,0,0,0,75,0,150,0,0,0,0,0,150,PROJECT DELAYED DUE TO CHANGES IN SCOPE/DESIGN,,RENOVATE BASKETBALL COURT,cpd11-20bk.pdf
HAM15GOGR,GOWANUS HOUSES BASKETBALL COURT AND PLAY AREA,806,HOUSING PRESERVATION AND DEVEL,LOW TO MODERATE INCOME PUBLIC HOUSING UPGRADE,306,BROOKLYN,HA-D001,150,0,150,0,0,0,0,0,150,0,150,0,0,0,0,0,150,0,300,0,0,0,0,0,300,PROJECT DELAYED DUE TO CHANGES IN SCOPE/DESIGN,,BASKETBALL COURT AND PLAY AREA,cpd11-20bk.pdf
HAM15ODPA,O'DWYER GARDENS PLAYGROUND UPGRADES,806,HOUSING PRESERVATION AND DEVEL,LOW TO MODERATE INCOME PUBLIC HOUSING UPGRADE,313,BROOKLYN,HA-D001,100,0,100,0,0,0,0,0,100,0,100,0,0,0,0,0,100,0,200,0,0,0,0,0,200,PROJECT DELAYED DUE TO CHANGES IN SCOPE/DESIGN,,PLAYGROUND UPGRADE,cpd11-20bk.pdf
HAM16BES9,BERRY STREET SOUTH 9TH STREET HOUSES SECURITY UPGRADES,806,HOUSING PRESERVATION AND DEVEL,LOW TO MODERATE INCOME PUBLIC HOUSING UPGRADE,301,BROOKLYN,HA-D001,125,0,90,0,0,0,0,0,90,0,90,0,0,0,0,0,90,0,180,0,0,0,0,0,180,PROJECT DELAYED DUE TO CHANGES IN SCOPE/DESIGN,,SECURITY UPGRADES,cpd11-20bk.pdf
HAM16HPBR,HOPE GARDENS INSTALLATION OF BOILERS AND RELATED EQUIPMENT,806,HOUSING PRESERVATION AND DEVEL,LOW TO MODERATE INCOME PUBLIC HOUSING UPGRADE,304,BROOKLYN,HA-D001 HA-0001,500,0,1500,0,0,0,0,0,1500,0,1500,0,0,0,0,0,1500,0,3000,0,0,0,0,0,3000,PROJECT DELAYED DUE TO CHANGES IN SCOPE/DESIGN,,INSTALLATION AND REPAIRS OF BOILERS AND RELATED EQUIPMENT,cpd11-20bk.pdf
HAM16ITGR,INDEPENDENCE TOWERS GROUNDS IMPROVEMENTS,806,HOUSING PRESERVATION AND DEVEL,LOW TO MODERATE INCOME PUBLIC HOUSING UPGRADE,301,BROOKLYN,HA-D001,300,0,300,0,0,0,0,0,300,0,300,0,0,0,0,0,300,0,600,0,0,0,0,0,600,PROJECT DELAYED DUE TO CHANGES IN SCOPE/DESIGN,,GROUNDS IMPROVEMENTS,cpd11-20bk.pdf
HAM16NHGR,NOSTRAND HOUSES PLAYGROUND RENOVATION,806,HOUSING PRESERVATION AND DEVEL,LOW TO MODERATE INCOME PUBLIC HOUSING UPGRADE,315,BROOKLYN,HA-D001,250,0,710,0,0,0,0,0,710,0,710,0,0,0,0,0,710,0,1420,0,0,0,0,0,1420,PROJECT DELAYED DUE TO CHANGES IN SCOPE/DESIGN,,PLAYGROUND RENOVATION,cpd11-20bk.pdf
HAM16SURF,SURF GARDENS DEVELOPMENT - PLAYGROUND RENOVATION,806,HOUSING PRESERVATION AND DEVEL,LOW TO MODERATE INCOME PUBLIC HOUSING UPGRADE,300,BROOKLYN,HA-K001,250,0,250,0,0,0,0,0,250,0,250,0,0,0,0,0,250,0,500,0,0,0,0,0,500,PROJECT DELAYED DUE TO CHANGES IN SCOPE/DESIGN,,SURF GARDENS DEVELOPMENT - PLAYGROUND RENOVATION,cpd11-20bk.pdf
HAM17BVTV,BAYVIEW HOUSES SECURITY CAMERAS,806,HOUSING PRESERVATION AND DEVEL,LOW TO MODERATE INCOME PUBLIC HOUSING UPGRADE,318,BROOKLYN,HA-D001,250,214,35,0,0,0,0,0,249,214,35,0,0,0,0,0,249,428,70,0,0,0,0,0,498,,,INSTALL SECURITY CAMERAS,cpd11-20bk.pdf
HAM17INSS,INDEPENDENCE TOWERS COMMUNITY CENTER SOUND STUDIO,806,HOUSING PRESERVATION AND DEVEL,LOW TO MODERATE INCOME PUBLIC HOUSING UPGRADE,301,BROOKLYN,HA-D001,100,0,100,0,0,0,0,0,100,0,100,0,0,0,0,0,100,0,200,0,0,0,0,0,200,PROJECT DELAYED DUE TO CHANGES IN SCOPE/DESIGN,,CREATE SOUND STUDIO,cpd11-20bk.pdf
HAM17NSTV,NOSTRAND HOUSES SECURITY CAMERAS,806,HOUSING PRESERVATION AND DEVEL,LOW TO MODERATE INCOME PUBLIC HOUSING UPGRADE,315,BROOKLYN,HA-D001,250,204,46,0,0,0,0,0,250,204,46,0,0,0,0,0,250,408,92,0,0,0,0,0,500,PROJECT DELAYED DUE TO CHANGES IN SCOPE/DESIGN,,INSTALL SECURITY CAMERAS,cpd11-20bk.pdf
HAM18ATBC,ATLANTIC TERMINAL BASKETBALL COURT RENOVATION,806,HOUSING PRESERVATION AND DEVEL,LOW TO MODERATE INCOME PUBLIC HOUSING UPGRADE,302,BROOKLYN,HA-D001,400,53,347,0,0,0,0,0,400,53,347,0,0,0,0,0,400,106,694,0,0,0,0,0,800,,,BASKETBALL COURT RENOVATION,cpd11-20bk.pdf
HAM18BPBC,BORINQUEN PLAZA I BASKETBALL COURT UPGRADE,806,HOUSING PRESERVATION AND DEVEL,LOW TO MODERATE INCOME PUBLIC HOUSING UPGRADE,301,BROOKLYN,HA-0001,400,0,400,0,0,0,0,0,400,0,400,0,0,0,0,0,400,0,800,0,0,0,0,0,800,PROJECT DELAYED DUE TO CHANGES IN SCOPE/DESIGN,,UPGRADE BASKETBALL COURT AT BORINQUEN PLAZA I COMMUNITY CENTER,cpd11-20bk.pdf
HAM18BREV,Brevoort Resident Association - Coliseum Repairs and CCTVs,806,HOUSING PRESERVATION AND DEVEL,LOW TO MODERATE INCOME PUBLIC HOUSING CONSTRUCTION,300,BROOKLYN,HA-K001,500,240,260,0,0,0,0,0,500,240,260,0,0,0,0,0,500,480,520,0,0,0,0,0,1000,,,BREVOORT RESIDENT ASSOCIATION - COLISEUM REPAIRS AND CCTVS,cpd11-20bk.pdf
HAM18BSVB,BROWNSVILLE AND SARATOGA VILLAGE BOILER REPAIR,806,HOUSING PRESERVATION AND DEVEL,LOW TO MODERATE INCOME PUBLIC HOUSING UPGRADE,300,BROOKLYN,HA-0001,12600,0,12600,0,0,0,0,0,12600,0,12600,0,0,0,0,0,12600,0,25200,0,0,0,0,0,25200,,,BROWNSVILLE AND SARATOGA VILLAGE BOILER REPAIR,cpd11-20bk.pdf
HAM18CHBW,CYPRESS HILLS BOILER WORK,806,HOUSING PRESERVATION AND DEVEL,LOW TO MODERATE INCOME PUBLIC HOUSING UPGRADE,300,BROOKLYN,HA-0001,10500,9794,706,0,0,0,0,0,10500,9794,706,0,0,0,0,0,10500,19588,1412,0,0,0,0,0,21000,,,BOILER REPAIR AT CYPRESS HILLS,cpd11-20bk.pdf
HAM18HGCC,HOPE GARDENS COMMUNITY CENTER--MODERNIZE GYM.,806,HOUSING PRESERVATION AND DEVEL,LOW TO MODERATE INCOME PUBLIC HOUSING UPGRADE,304,BROOKLYN,HA-K001 HA-D001,500,0,500,0,0,0,0,0,500,0,500,0,0,0,0,0,500,0,1000,0,0,0,0,0,1000,,,RENOVATION OF THE GYM AT HOPE GARDEN'S COMMUNITY CENTER.,cpd11-20bk.pdf
HAM18HYEL,HYLAN ELEVATORS,806,HOUSING PRESERVATION AND DEVEL,LOW TO MODERATE INCOME PUBLIC HOUSING UPGRADE,301,BROOKLYN,HA-0001,4070,0,3700,0,0,0,0,0,3700,0,3700,0,0,0,0,0,3700,0,7400,0,0,0,0,0,7400,,,ELEVATOR UPGRADE,cpd11-20bk.pdf
HAM18IGIR,INGERSOLL GARDENS INSTALLATION OF IRRIGATION,806,HOUSING PRESERVATION AND DEVEL,LOW TO MODERATE INCOME PUBLIC HOUSING UPGRADE,302,BROOKLYN,HA-D001,500,0,500,0,0,0,0,0,500,0,500,0,0,0,0,0,500,0,1000,0,0,0,0,0,1000,,,INSTALLATION OF IRRIGATION,cpd11-20bk.pdf
HAM18INBC,INGERSOLL HOUSES BASKETBALL COURT RENOVATIONS,806,HOUSING PRESERVATION AND DEVEL,LOW TO MODERATE INCOME PUBLIC HOUSING UPGRADE,302,BROOKLYN,HA-D001,400,53,347,0,0,0,0,0,400,53,347,0,0,0,0,0,400,106,694,0,0,0,0,0,800,,,BASKETBALL COURT RENOVATIONS,cpd11-20bk.pdf
HAM18ITPG,RENOVATION OF PLAYGROUND AT INDEPENDENCE TOWERS,806,HOUSING PRESERVATION AND DEVEL,LOW TO MODERATE INCOME PUBLIC HOUSING UPGRADE,301,BROOKLYN,HA-D001,500,0,500,0,0,0,0,0,500,0,500,0,0,0,0,0,500,0,1000,0,0,0,0,0,1000,,,REPAIR TODDLER PLAYGROUND AT INDEPENDENCE TOWERS.,cpd11-20bk.pdf
HAM18OHPG,OCEAN HILL PLAYGROUND,806,HOUSING PRESERVATION AND DEVEL,LOW TO MODERATE INCOME PUBLIC HOUSING UPGRADE,316,BROOKLYN,HA-D001,500,65,435,0,0,0,0,0,500,65,435,0,0,0,0,0,500,130,870,0,0,0,0,0,1000,,,UPGRADE PLAYGROUND,cpd11-20bk.pdf
HAM18PKTV,PINK CCTV,806,HOUSING PRESERVATION AND DEVEL,LOW TO MODERATE INCOME PUBLIC HOUSING UPGRADE,300,BROOKLYN,HA-0001,3000,0,3000,0,0,0,0,0,3000,0,3000,0,0,0,0,0,3000,0,6000,0,0,0,0,0,6000,,,SECURITY UPGRADES AT PINK HOUSES,cpd11-20bk.pdf
HAM18SUBC,RENOVATION OF A BASKETBALL COURT AT SUMNER HOUSES,806,HOUSING PRESERVATION AND DEVEL,LOW TO MODERATE INCOME PUBLIC HOUSING UPGRADE,303,BROOKLYN,HA-D001,500,0,500,0,0,0,0,0,500,0,500,0,0,0,0,0,500,0,1000,0,0,0,0,0,1000,,,RENOVATION OF A BASKETBALL COURT AT SUMNER HOUSES,cpd11-20bk.pdf
HAM18WBCC,PLAYGROUND UPGRADES AT WILLIAMSBURG DAY CARE CENTER,806,HOUSING PRESERVATION AND DEVEL,LOW TO MODERATE INCOME PUBLIC HOUSING UPGRADE,301,BROOKLYN,HA-D001,350,325,420,0,0,0,0,0,745,325,420,0,0,0,0,0,745,650,840,0,0,0,0,0,1490,,,PLAYGROUND UPGRADES AT WILLIAMSBURG DAY CARE CENTER 222 GRAHAM AVENUE,cpd11-20bk.pdf
HAM18WHIT,NYCHA WHITMAN/WILLOUGHBY SENIOR CENTER HVAC UPGRADE,806,HOUSING PRESERVATION AND DEVEL,LOW TO MODERATE INCOME PUBLIC HOUSING UPGRADE,300,BROOKLYN,HA-D001,400,0,400,0,0,0,0,0,400,0,400,0,0,0,0,0,400,0,800,0,0,0,0,0,800,,,NYCHA WHITMAN/WILLOUGHBY SENIOR CENTER HVAC UPGRADE,cpd11-20bk.pdf
HAM18WIPG,WILLIAMSBURG HOUSES PLAYGROUND UPGRADE,806,HOUSING PRESERVATION AND DEVEL,LOW TO MODERATE INCOME PUBLIC HOUSING UPGRADE,301,BROOKLYN,HA-D001,350,0,280,0,0,0,0,0,280,0,280,0,0,0,0,0,280,0,560,0,0,0,0,0,560,,,WILLIAMSBURG HOUSES PLAYGROUND UPGRADE AT 176 MAUJER,cpd11-20bk.pdf
HAM18WKCC,WYCKOFF GARDENS COMMUNITY CENTER RENOVATION,806,HOUSING PRESERVATION AND DEVEL,LOW TO MODERATE INCOME PUBLIC HOUSING UPGRADE,306,BROOKLYN,HA-D001,414,0,414,0,0,0,0,0,414,0,414,0,0,0,0,0,414,0,828,0,0,0,0,0,828,,,WYCKOFF GARDENS COMMUNITY CENTER RENOVATION,cpd11-20bk.pdf
HAM18WKLG,WYCKOFF GARDENS LIGHTING,806,HOUSING PRESERVATION AND DEVEL,LOW TO MODERATE INCOME PUBLIC HOUSING UPGRADE,306,BROOKLYN,HA-D001,300,0,300,0,0,0,0,0,300,0,300,0,0,0,0,0,300,0,600,0,0,0,0,0,600,,,INSTALLATION OF LIGHTING AT WYCKOFF GARDENS,cpd11-20bk.pdf
HAM18WSEC,WHITMAN BASKETBALL COURT AND SECURITY UPGRADES,806,HOUSING PRESERVATION AND DEVEL,LOW TO MODERATE INCOME PUBLIC HOUSING UPGRADE,302,BROOKLYN,HA-D001,400,53,347,0,0,0,0,0,400,53,347,0,0,0,0,0,400,106,694,0,0,0,0,0,800,,,BASKETBALL COURT RENOVATIONS AND SECURITY UPGRADES,cpd11-20bk.pdf
HAM18WSWT,WOODSON WATER TANK,806,HOUSING PRESERVATION AND DEVEL,LOW TO MODERATE INCOME PUBLIC HOUSING UPGRADE,300,BROOKLYN,HA-0001,1400,0,1400,0,0,0,0,0,1400,0,1400,0,0,0,0,0,1400,0,2800,0,0,0,0,0,2800,,,WOODSON WATER TANK,cpd11-20bk.pdf
HAM19ALPL,ALBANY HOUSES PLAYGROUND,806,HOUSING PRESERVATION AND DEVEL,LOW TO MODERATE INCOME PUBLIC HOUSING UPGRADE,308,BROOKLYN,HA-D001,800,0,800,0,0,0,0,0,800,0,800,0,0,0,0,0,800,0,1600,0,0,0,0,0,1600,,,BUILD A PLAYGROUND,cpd11-20bk.pdf
HAM19BVPU,BAYVIEW HOUSES PLAYGROUND UPGRADE,806,HOUSING PRESERVATION AND DEVEL,LOW TO MODERATE INCOME PUBLIC HOUSING UPGRADE,318,BROOKLYN,HA-D001,250,0,355,0,0,0,0,0,355,0,355,0,0,0,0,0,355,0,710,0,0,0,0,0,710,,,PLAYGROUND UPGRADE,cpd11-20bk.pdf
HAM19CSVE,SARATOGA VILLAGE ELEVATORS,806,HOUSING PRESERVATION AND DEVEL,LOW TO MODERATE INCOME PUBLIC HOUSING UPGRADE,316,BROOKLYN,HA-0001,2000,0,2000,0,0,0,0,0,2000,0,2000,0,0,0,0,0,2000,0,4000,0,0,0,0,0,4000,,,FUNDING FOR SARATOGA VILLAGE ELEVATORS,cpd11-20bk.pdf
HAM19FHSE,FARRAGUT HOUSES SECURITY LIGHTING,806,HOUSING PRESERVATION AND DEVEL,LOW TO MODERATE INCOME PUBLIC HOUSING UPGRADE,302,BROOKLYN,HA-D001,581,0,581,0,0,0,0,0,581,0,581,0,0,0,0,0,581,0,1162,0,0,0,0,0,1162,,,FARRAGUT HOUSES-SECURITY LIGHTING FUNDING TO SUPPORT SECURITY LIGHTING,cpd11-20bk.pdf
HAM19HHTV,HOWARD HOUSES CCTV,806,HOUSING PRESERVATION AND DEVEL,LOW TO MODERATE INCOME PUBLIC HOUSING UPGRADE,300,BROOKLYN,HA-K001 HA-D001,1400,0,1400,0,0,0,0,0,1400,0,1400,0,0,0,0,0,1400,0,2800,0,0,0,0,0,2800,,,HOWARD HOUSES CCTV,cpd11-20bk.pdf
HAM19SBPU,SHEEPSHEAD BAY HOUSES PLAYGROUND UPGRADE,806,HOUSING PRESERVATION AND DEVEL,LOW TO MODERATE INCOME PUBLIC HOUSING UPGRADE,315,BROOKLYN,HA-D001,350,0,350,0,0,0,0,0,350,0,350,0,0,0,0,0,350,0,700,0,0,0,0,0,700,,,PLAYGROUND UPGRADE,cpd11-20bk.pdf
HAM19TCPU,TOMPKINS HOUSES CHILDRENS PARK UPGRADE,806,HOUSING PRESERVATION AND DEVEL,LOW TO MODERATE INCOME PUBLIC HOUSING UPGRADE,303,BROOKLYN,HA-D001,507,0,507,0,0,0,0,0,507,0,507,0,0,0,0,0,507,0,1014,0,0,0,0,0,1014,,,FUNDING FOR CHILDRENS PARK UPGRADE,cpd11-20bk.pdf
HAM19WPLF,WILLIAMS PLAZA LIGHTING AND FENCING IMPROVEMENTS,806,HOUSING PRESERVATION AND DEVEL,LOW TO MODERATE INCOME PUBLIC HOUSING UPGRADE,301,BROOKLYN,HA-D001,100,0,100,0,0,0,0,0,100,0,100,0,0,0,0,0,100,0,200,0,0,0,0,0,200,,,LIGHTING AND FENCING IMPROVEMENTS,cpd11-20bk.pdf
HAM20ALPU,PLAYGROUND RENOVATION- ALBANY HOUSES,806,HOUSING PRESERVATION AND DEVEL,LOW TO MODERATE INCOME PUBLIC HOUSING UPGRADE,308,BROOKLYN,HA-D001,250,0,250,0,0,0,0,0,250,0,250,0,0,0,0,0,250,0,500,0,0,0,0,0,500,,,NYCHA ALBANY HOUSES PLAYGROUND -- FUNDING TO RENOVATE PLAYGROUND,cpd11-20bk.pdf
HAM20BCCG,BUSHWICK HOUSES UPGRADE COMMUNITY CENTER GYM,806,HOUSING PRESERVATION AND DEVEL,LOW TO MODERATE INCOME PUBLIC HOUSING UPGRADE,316,BROOKLYN,HA-0001,1000,0,1000,0,0,0,0,0,1000,0,1000,0,0,0,0,0,1000,0,2000,0,0,0,0,0,2000,,,UPGRADES TO COMMUNITY CENTER GYM,cpd11-20bk.pdf
HAM20BCCS,RECORDING STUDIO- BUSHWICK HOUSES COMMUNITY CENTER,806,HOUSING PRESERVATION AND DEVEL,LOW TO MODERATE INCOME PUBLIC HOUSING UPGRADE,301,BROOKLYN,HA-D001,165,0,165,0,0,0,0,0,165,0,165,0,0,0,0,0,165,0,330,0,0,0,0,0,330,,,A RECORDING STUDIO FOR BUSHWICK HOUSES COMMUNITY CENTER -- FUNDING TOBUILD OUT AND,cpd11-20bk.pdf
HAM20BHPU,BREVOORT UPGRADES TO PLAYGROUND,806,HOUSING PRESERVATION AND DEVEL,LOW TO MODERATE INCOME PUBLIC HOUSING UPGRADE,303,BROOKLYN,HA-D001,800,0,800,0,0,0,0,0,800,0,800,0,0,0,0,0,800,0,1600,0,0,0,0,0,1600,,,BREVOORT HOUSES -- UPGRADES TO BREVOORT PLAYGROUND,cpd11-20bk.pdf
HAM20BVBG,BROWNSVILLE BOXING GYM,806,HOUSING PRESERVATION AND DEVEL,LOW TO MODERATE INCOME PUBLIC HOUSING UPGRADE,316,BROOKLYN,HA-0001,385,0,10053,0,0,0,0,0,10053,0,10053,0,0,0,0,0,10053,0,20106,0,0,0,0,0,20106,,,BOXING GYM AT BROWNSVILLE,cpd11-20bk.pdf
HAM20BVCC,BROWNSVILLE COMMUNITY CENTER,806,HOUSING PRESERVATION AND DEVEL,LOW TO MODERATE INCOME PUBLIC HOUSING UPGRADE,316,BROOKLYN,HA-0001,5000,0,10043,0,0,0,0,0,10043,0,10043,0,0,0,0,0,10043,0,20086,0,0,0,0,0,20086,PROJECT DELAYED DUE TO CHANGES IN SCOPE/DESIGN,,BRONWSVILLE COMMUNITY CENTER RENOVATION,cpd11-20bk.pdf
HAM20BVPL,BAYVIEW HOUSES PLAYGROUND UPGRADE,806,HOUSING PRESERVATION AND DEVEL,LOW TO MODERATE INCOME PUBLIC HOUSING UPGRADE,308,BROOKLYN,HA-D001,291,0,291,0,0,0,0,0,291,0,291,0,0,0,0,0,291,0,582,0,0,0,0,0,582,,,FUNDING TO RENOVATE PLAYGROUND INCLUDES SPECIAL NEEDS EQUIPMENT,cpd11-20bk.pdf
HAM20CPPU,COOPER PARK PLAY GROUND UPGRADE,806,HOUSING PRESERVATION AND DEVEL,LOW TO MODERATE INCOME PUBLIC HOUSING UPGRADE,301,BROOKLYN,HA-0001,500,0,500,0,0,0,0,0,500,0,500,0,0,0,0,0,500,0,1000,0,0,0,0,0,1000,,,UPGRADE OF COOPER PARK HOUSES PLAYGROUND,cpd11-20bk.pdf
HAM20GCBR,GLENWOOD COMMUNITY CENTER RENOVATE BATHROOM,806,HOUSING PRESERVATION AND DEVEL,LOW TO MODERATE INCOME PUBLIC HOUSING UPGRADE,318,BROOKLYN,HA-D001,650,0,650,0,0,0,0,0,650,0,650,0,0,0,0,0,650,0,1300,0,0,0,0,0,1300,,,RENOVATE BATHROOMS AT COMMUNITY CENTER- GLENWOOD,cpd11-20bk.pdf
HAM20GHLC,LED LIGHTING AND CAMERAS GOWANUS HOUSES,806,HOUSING PRESERVATION AND DEVEL,LOW TO MODERATE INCOME PUBLIC HOUSING UPGRADE,306,BROOKLYN,HA-D001,150,0,150,0,0,0,0,0,150,0,150,0,0,0,0,0,150,0,300,0,0,0,0,0,300,,,GOWANUS HOUSES -- LED LIGHTING AND CAMERAS,cpd11-20bk.pdf
HAM20HCAM,PHASE 2 CAMERAS AT LANGSTON HUGES HOUSES,806,HOUSING PRESERVATION AND DEVEL,FINANCING COSTS,316,BROOKLYN,HA-D001,500,0,500,0,0,0,0,0,500,0,500,0,0,0,0,0,500,0,1000,0,0,0,0,0,1000,,,PHASE 2 CAMERAS- LANGSTON HUGHES HOUSES,cpd11-20bk.pdf
HAM20KRWJ,KINGSBOROUGH DEVELOPMENT RESTORATION OF WALLS OF JERICHO,806,HOUSING PRESERVATION AND DEVEL,LOW TO MODERATE INCOME PUBLIC HOUSING UPGRADE,300,BROOKLYN,HA-D001,1800,0,1800,0,0,0,0,0,1800,0,1800,0,0,0,0,0,1800,0,3600,0,0,0,0,0,3600,,,KINGSBOROUGH DEVELOPMENT -- RESTORATION OF WALLS OF JERICHO,cpd11-20bk.pdf
HAM20MGSC,SECURITY CAMERAS MARCUS GARVEY,806,HOUSING PRESERVATION AND DEVEL,LOW TO MODERATE INCOME PUBLIC HOUSING UPGRADE,316,BROOKLYN,HA-K001,75,0,75,0,0,0,0,0,75,0,75,0,0,0,0,0,75,0,150,0,0,0,0,0,150,,,NYCHA SECURITY CAMERAS--SECURITY CAMERAS FOR MARCUS GARVEY HOUSES.,cpd11-20bk.pdf
HAM20SHEL,SHEEPSHEAD HOUSES-EXTERIOR LIGHTING UPGRADE,806,HOUSING PRESERVATION AND DEVEL,LOW TO MODERATE INCOME PUBLIC HOUSING UPGRADE,315,BROOKLYN,HA-D001,300,0,300,0,0,0,0,0,300,0,300,0,0,0,0,0,300,0,600,0,0,0,0,0,600,,,EXTERIOR LIGHTING UPGRADE- SHEEPSHEAD HOUSES,cpd11-20bk.pdf
HAM20TCCU,TOMPKINS - UPGRADE THE SPACE IN THE COMMUNITY CENTER,806,HOUSING PRESERVATION AND DEVEL,LOW TO MODERATE INCOME PUBLIC HOUSING UPGRADE,300,BROOKLYN,HA-D001,500,0,500,0,0,0,0,0,500,0,500,0,0,0,0,0,500,0,1000,0,0,0,0,0,1000,,,TOMPKINS HOUSES COMMUNITY CENTER UPGRADE -- UPGRADE THE SPACE IN THE COMMUNITY,cpd11-20bk.pdf
HAM20THRR,TOMPKINS HOUSES ROOF REPLACEMENT,806,HOUSING PRESERVATION AND DEVEL,LOW TO MODERATE INCOME PUBLIC HOUSING UPGRADE,303,BROOKLYN,HA-K001,50,0,50,0,0,0,0,0,50,0,50,0,0,0,0,0,50,0,100,0,0,0,0,0,100,,,TOMPKINS HOUSES--ROOF REPLACEMENT.,cpd11-20bk.pdf
HAM20VDCC,VAN DYKE 1 HOUSES COMPUTERS FOR NEW DAY CARE CENTER,806,HOUSING PRESERVATION AND DEVEL,LOW TO MODERATE INCOME PUBLIC HOUSING UPGRADE,316,BROOKLYN,HA-D001,64,0,64,0,0,0,0,0,64,0,64,0,0,0,0,0,64,0,128,0,0,0,0,0,128,,,COMPUTERS FOR NEW DAY CARE CENTER- VAN DYKE I 381 SUTTER AVE,cpd11-20bk.pdf
HAM20WHPU,WILLIAMSBURG - PLAYGROUND UPGRADE,806,HOUSING PRESERVATION AND DEVEL,LOW TO MODERATE INCOME PUBLIC HOUSING UPGRADE,301,BROOKLYN,HA-D001,500,0,500,0,0,0,0,0,500,0,500,0,0,0,0,0,500,0,1000,0,0,0,0,0,1000,,,PLAYGROUND UPGRADE FOR WILLIAMSBURG HOUSES -- FUNDING WILL GO TOWARDSUPGRADING ONE,cpd11-20bk.pdf
HAM20WRCS,WYCKOFF GARDENS - RENOVATION OF COMMUNITY SPACE,806,HOUSING PRESERVATION AND DEVEL,LOW TO MODERATE INCOME PUBLIC HOUSING UPGRADE,306,BROOKLYN,HA-D001,2500,0,2500,0,0,0,0,0,2500,0,2500,0,0,0,0,0,2500,0,5000,0,0,0,0,0,5000,,,"WYCKOFF GARDENS -- FUNDING FOR RENOVATIONS OF COMMUNITY SPACES, LIGHTING, CAMERAS AND",cpd11-20bk.pdf
HAM21BHPR,NEW PLAYGROUND-REFURBISH AT BAYVIEW HOUSES,806,HOUSING PRESERVATION AND DEVEL,LOW TO MODERATE INCOME PUBLIC HOUSING UPGRADE,318,BROOKLYN,HA-D001,0,0,250,0,0,0,0,0,250,0,250,0,0,0,0,0,250,0,500,0,0,0,0,0,500,,,BAYVIEW HOUSES - NEW PLAYGROUND-REFURBISH,cpd11-20bk.pdf
HAM21CIHC,CONEY ISLAND HANDBALL COURT,806,HOUSING PRESERVATION AND DEVEL,LOW TO MODERATE INCOME PUBLIC HOUSING UPGRADE,313,BROOKLYN,HA-D001,0,0,500,0,0,0,0,0,500,0,500,0,0,0,0,0,500,0,1000,0,0,0,0,0,1000,,,CONEY ISLAND I(SITE 1B) HANDBALL COURT-FUNDING FOR A HANDBALL COURTATNYCHA'S,cpd11-20bk.pdf
HAM21GHCC,INSTALL AWNING AT GLENWOOD HOUSES,806,HOUSING PRESERVATION AND DEVEL,LOW TO MODERATE INCOME PUBLIC HOUSING UPGRADE,318,BROOKLYN,HA-D001,0,0,135,0,0,0,0,0,135,0,135,0,0,0,0,0,135,0,270,0,0,0,0,0,270,,,PB,cpd11-20bk.pdf
HAM21NHBB,RESURFACE AND CREATE BASKETBALL COURT AT NOSTRAND HOUSES,806,HOUSING PRESERVATION AND DEVEL,LOW TO MODERATE INCOME PUBLIC HOUSING UPGRADE,315,BROOKLYN,HA-D001,0,0,300,0,0,0,0,0,300,0,300,0,0,0,0,0,300,0,600,0,0,0,0,0,600,,,NOSTRAND HOUSES BASKETBALL COURT- RESURFACE AND CREATE NEW FULL COURT,cpd11-20bk.pdf
HAM21SHCC,SHEEPSHEAD HOUSES-COMMUNITY CENTER,806,HOUSING PRESERVATION AND DEVEL,LOW TO MODERATE INCOME PUBLIC HOUSING UPGRADE,315,BROOKLYN,HA-0001,0,0,322,0,0,0,0,0,322,0,322,0,0,0,0,0,322,0,644,0,0,0,0,0,644,,,SHEEPSHEAD HOUSES-COMMUNITY CENTER,cpd11-20bk.pdf
HAM21SVCU,CAMERA UPGRADES AT SARATOGA VILLAGE,806,HOUSING PRESERVATION AND DEVEL,LOW TO MODERATE INCOME PUBLIC HOUSING UPGRADE,316,BROOKLYN,HA-D001,0,0,750,0,0,0,0,0,750,0,750,0,0,0,0,0,750,0,1500,0,0,0,0,0,1500,,,SARATOGA VILLAGE - CAMERAS--CAMERA UPGRADES,cpd11-20bk.pdf
HAM21UPCC,BATHROOM RENOVATION AT UNITY PLAZA COMMUNITY CENTER,806,HOUSING PRESERVATION AND DEVEL,LOW TO MODERATE INCOME PUBLIC HOUSING UPGRADE,305,BROOKLYN,HA-D001,0,0,164,0,0,0,0,0,164,0,164,0,0,0,0,0,164,0,328,0,0,0,0,0,328,,,UNITY PLAZA COMMUNITY CENTER GIRLS,cpd11-20bk.pdf
HAM24VDGR,"VAN DYKE I, II GAS RISERS #10",806,HOUSING PRESERVATION AND DEVEL,LOW TO MODERATE INCOME PUBLIC HOUSING UPGRADE,316,BROOKLYN,HA-0001,7150,0,0,0,0,6500,0,0,6500,0,0,0,0,6500,0,0,6500,0,0,0,0,13000,0,0,13000,,,INSTALLATION OF GAS RISERS #10,cpd11-20bk.pdf
HL82BRNHC,Brownsville Health Center Renovation of interior space,816,DEPARTMENT OF HEALTH AND MENTAL HYGIENE,CLINIC RENOVATION AND REHABILITATION,,BROOKLYN,HL-0082,10000,0,0,0,0,0,4760,274,5034,0,0,0,0,0,4760,274,5034,0,0,0,0,0,9520,548,10068,PROJECT DELAYED DUE TO BUDGETARY CONSTRAINTS,,BROWNSVILLE HEALTH CENTER RENOVATION OF INTERIOR SPACE,cpd11-20bk.pdf
HL82BUSHC,Bushwick Health Center exterior renovation/interior upgrades,816,DEPARTMENT OF HEALTH AND MENTAL HYGIENE,CLINIC RENOVATION AND REHABILITATION,,BROOKLYN,HL-0082,6500,0,0,0,0,164,4000,0,4164,0,0,0,0,164,4000,0,4164,0,0,0,0,328,8000,0,8328,PROJECT DELAYED DUE TO CHANGES IN SCOPE/DESIGN,,BUSHWICK HEALTH CENTER EXTERIOR RENOVATION/INTERIOR UPGRADES,cpd11-20bk.pdf
HL82CROWH,CROWN HEIGHTS EXPRESS CLINIC,816,DEPARTMENT OF HEALTH AND MENTAL HYGIENE,CLINIC RENOVATION AND REHABILITATION,,BROOKLYN,HL-0082,700,0,0,0,696,0,0,0,696,0,0,0,696,0,0,0,696,0,0,0,1392,0,0,0,1392,,,EXPRESS CLINIC ON PARTIAL FIRST FLOOR,cpd11-20bk.pdf
HL82WLSHC,Williamsburg Health Center Interior Renovation,816,DEPARTMENT OF HEALTH AND MENTAL HYGIENE,CLINIC RENOVATION AND REHABILITATION,,BROOKLYN,HL-0082,4400,0,0,0,1314,6392,3687,0,11393,0,0,0,1314,6392,3687,0,11393,0,0,0,2628,12784,7374,0,22786,,,WILLIAMSBURG HEALTH CENTER INTERIOR RENOVATION,cpd11-20bk.pdf
22200601,ENY,819,HEALTH AND HOSPITALS CORP,ROUTINE RECONSTRUCTION,305,BROOKLYN,HO-D003,1250,1192,0,47,0,0,0,0,1239,1192,0,47,0,0,0,0,1239,2384,0,94,0,0,0,0,2478,PROJECT DELAYED DUE TO CHANGES IN SCOPE/DESIGN,"2094 PITKIN AVENUE, BROOKLYN, N.Y. 11207","CAPITAL IMPROVEMENTS (SIDEWALK REPAIR, LOBBY UPGRADE, PEDIATRIC CLINIC UPGRADE) AT EAST",cpd11-20bk.pdf
22200801,EAST NEW YORK,819,HEALTH AND HOSPITALS CORP,ROUTINE RECONSTRUCTION,305,BROOKLYN,HO-D003,2100,2023,0,64,0,0,0,0,2087,2023,0,64,0,0,0,0,2087,4046,0,128,0,0,0,0,4174,PROJECT DELAYED DUE TO CHANGES IN SCOPE/DESIGN,"2094 PITKIN AVENUE, BROOKLYN, N. Y. 11207",CONSTRUCT WOMEN'S OPTIONS CENTER,cpd11-20bk.pdf
22201610,RENOVATE BROWNSVILLE CHILD HEALTH CLINIC,819,HEALTH AND HOSPITALS CORP,ROUTINE RECONSTRUCTION,316,BROOKLYN,HO-0214,3870,3162,0,679,0,0,0,0,3841,3162,0,679,0,0,0,0,3841,6324,0,1358,0,0,0,0,7682,PROJECT DELAYED DUE TO CHANGES IN SCOPE/DESIGN,"259 BRISTOL STREET, BROOKLYN, NY 11212",RENOVATE THE BROWNSVILLE CHILD HEALTH CLINIC IN ORDER TO EXPAND PRIMARY CARE HEALTH,cpd11-20bk.pdf
22201611,RENOVATE CROWN HEIGHTS CHILD HEALTH CLINIC,819,HEALTH AND HOSPITALS CORP,ROUTINE RECONSTRUCTION,308,BROOKLYN,HO-0214,464,716,0,115,0,0,0,0,831,716,0,115,0,0,0,0,831,1432,0,230,0,0,0,0,1662,PROJECT DELAYED DUE TO CHANGES IN SCOPE/DESIGN,"1218 PROSPECT PLACE, BROOKLYN, NY 11213",RENOVATE THE CROWN HEAIGHTS CHILD HEALTH CLINIC IN ORDER TO EXPAND PRIMARY CARE HEALTH,cpd11-20bk.pdf
22201901,ENY,819,HEALTH AND HOSPITALS CORP,ROUTINE RECONSTRUCTION,,BROOKLYN,HO-0214,634,780,250,0,0,0,0,0,1030,780,250,0,0,0,0,0,1030,1560,500,0,0,0,0,0,2060,PROJECT DELAYED DUE TO CHANGES IN SCOPE/DESIGN,"2094 PITKIN AVENUE, BROOKLYN, NY 11207","MODERNIZE 2 PASSENGER ELEVATORS AT NYC HEALTH + HOSPITALS / GOTHAM HEALTH, EAST NEW",cpd11-20bk.pdf
22202001,ENY WATER SYSTEM STRUCTURAL RESTORATION,819,HEALTH AND HOSPITALS CORP,ROUTINE RECONSTRUCTION,,BROOKLYN,HO-0214,154,0,154,0,0,0,0,0,154,0,154,0,0,0,0,0,154,0,308,0,0,0,0,0,308,,EAST NEW YORK,,cpd11-20bk.pdf
23201601,DSSM,819,HEALTH AND HOSPITALS CORP,ROUTINE RECONSTRUCTION,,BROOKLYN,HO-0214,1606,1462,0,0,0,144,0,0,1606,1462,0,0,0,144,0,0,1606,2924,0,0,0,288,0,0,3212,,,REPLACE ROOF AT THE DR. SUSAN SMITH MCKINNEY NURSING & REHABILITATIONCENTER.,cpd11-20bk.pdf
23201901,DSSM,819,HEALTH AND HOSPITALS CORP,ROUTINE RECONSTRUCTION,,BROOKLYN,HO-0214,909,868,41,0,0,0,0,0,909,868,41,0,0,0,0,0,909,1736,82,0,0,0,0,0,1818,,"594 ALBANY AVENUE, BROOKLYN, NY 11203","NYC HEALTH + HOSPITALS / MCKINNEY, BRKLYN",cpd11-20bk.pdf
23202001,DSSM,819,HEALTH AND HOSPITALS CORP,ROUTINE RECONSTRUCTION,,BROOKLYN,HO-D003,100,0,50,50,0,0,0,0,100,0,50,50,0,0,0,0,100,0,100,100,0,0,0,0,200,,"594 ALBANY AVENUE, BROOKLYN, NY 11203",FRONT LOBBY RENOVATIONS AT NYC HEALTH + HOSPITALS/MCKINNEY,cpd11-20bk.pdf
23202101,MC KINNEY,819,HEALTH AND HOSPITALS CORP,ROUTINE RECONSTRUCTION,,BROOKLYN,HO-0214,165,0,165,0,0,0,0,0,165,0,165,0,0,0,0,0,165,0,330,0,0,0,0,0,330,,"594 ALBANY, AVENUE BROOKLYN NY 11203",FIRE ALARM UPGRADES,cpd11-20bk.pdf
26201101,GOTHAM,819,HEALTH AND HOSPITALS CORP,ROUTINE RECONSTRUCTION,313,BROOKLYN,HO-D003 HO-0214,23685,21218,332,0,0,6552,0,0,28102,21218,332,0,0,6552,0,0,28102,42436,664,0,0,13104,0,0,56204,PROJECT DELAYED DUE TO CHANGES IN SCOPE/DESIGN,"2601 OCEAN PARKWAY, BROOKLYN, N. Y. 11235",THE PURPOSE OF THIS PROJECT IS TO CONSTRCUT A HEALTH CENTER AT VANDERBILT AVENUE.,cpd11-20bk.pdf
26201402,CIH,819,HEALTH AND HOSPITALS CORP,ROUTINE RECONSTRUCTION,313,BROOKLYN,HO-D003,966,929,0,0,0,36,0,0,965,929,0,0,0,36,0,0,965,1858,0,0,0,72,0,0,1930,PROJECT DELAYED DUE TO CHANGES IN SCOPE/DESIGN,"2601 OCEAN PARKWAY, BROOKLYN, NY 11235","ADD DEHUMIDICATION AND ADDITIONAL COOLING CAPACITY TO THE ORS AT CONEY ISLAND HOSPITAL,",cpd11-20bk.pdf
26201902,CIH,819,HEALTH AND HOSPITALS CORP,ROUTINE RECONSTRUCTION,,BROOKLYN,HO-0214,268,0,0,0,0,268,0,0,268,0,0,0,0,268,0,0,268,0,0,0,0,536,0,0,536,,"2601 OCEAN PARKWAY, BROOKLYN, NY 11235","CONEY ISLAND HOSPITAL (2601 OCEAN PARKWAY, BK), UPGRADE THE FIRE ALARM SYSTEM",cpd11-20bk.pdf
26202001,CIH,819,HEALTH AND HOSPITALS CORP,ROUTINE RECONSTRUCTION,,BROOKLYN,HO-0214,4541,0,4541,0,0,0,0,0,4541,0,4541,0,0,0,0,0,4541,0,9082,0,0,0,0,0,9082,,"2601 OCEAN PKWY, BK NY 11235",MODERNIZE 9 ELEVATORS IN MAIN BUILDING AT CONEY ISLAND HOSPITAL.,cpd11-20bk.pdf
26202101,ROOF REPLACEMENT MAIN BUILDING,819,HEALTH AND HOSPITALS CORP,ROUTINE RECONSTRUCTION,,BROOKLYN,HO-0214,1250,0,0,1250,0,0,0,0,1250,0,0,1250,0,0,0,0,1250,0,0,2500,0,0,0,0,2500,,"2601 OCEAN PARKWAY, BROOKLYN NY 11235",ROOF REPLACEMENT MAIN BUILDING,cpd11-20bk.pdf
27201201,CUMBERLAND,819,HEALTH AND HOSPITALS CORP,ROUTINE RECONSTRUCTION,302,BROOKLYN,HO-D003,273,0,0,273,0,0,0,0,273,0,0,273,0,0,0,0,273,0,0,546,0,0,0,0,546,,"100 NORTH PORTLAND AVENUE, BROOKLYN, NY 11205",THE PURPOSE OF THIS PROJECT IS TO RENOVATE CHEMICAL DEPENDENCY DEPARTMENT AT CONEY,cpd11-20bk.pdf
27201301,CUMBERLAND,819,HEALTH AND HOSPITALS CORP,ROUTINE RECONSTRUCTION,302,BROOKLYN,HO-K001,490,0,0,490,0,0,0,0,490,0,0,490,0,0,0,0,490,0,0,980,0,0,0,0,980,,"100 NORTH PORTLAND AVENUE, BROOKLYN, NY 111205",RENOVATE/UPGRADE PEDIATRIC PRACTICE AT CUMBERLAND D&TC TO PROVIDE FORMORE EXAM,cpd11-20bk.pdf
27201515,CUMBERLAND,819,HEALTH AND HOSPITALS CORP,ROUTINE RECONSTRUCTION,302,BROOKLYN,HO-D003,524,67,0,133,0,0,0,0,200,67,0,133,0,0,0,0,200,134,0,266,0,0,0,0,400,PROJECT DELAYED DUE TO BUDGETARY CONSTRAINTS,"100 NORTH PORTLAND AVENUE, BROOKLYN, NY 11206",RECONIGURE EXISTING WOMEN'S HEALTH SERVICES DEPARTMENT TO MAKE SERVICES ACCESSIBLE,cpd11-20bk.pdf
27201610,RENOVATE BEDFORD HEALTH CLINIC,819,HEALTH AND HOSPITALS CORP,ROUTINE RECONSTRUCTION,303,BROOKLYN,HO-0214,3136,2977,0,132,0,0,0,0,3109,2977,0,132,0,0,0,0,3109,5954,0,264,0,0,0,0,6218,PROJECT DELAYED DUE TO CHANGES IN SCOPE/DESIGN,"485 THROOP AVENUE, BROOKLYN, NY 11221",RENOVATE THE BEDFORD HEALTH CLINIC IN ORDER TO EXPAND PRIMARY CARE HEALTH SERVICES.,cpd11-20bk.pdf
27201702,CUMBERLAND,819,HEALTH AND HOSPITALS CORP,ROUTINE RECONSTRUCTION,302,BROOKLYN,HO-D003,825,89,0,736,0,0,0,0,825,89,0,736,0,0,0,0,825,178,0,1472,0,0,0,0,1650,,"100 NORTH PORTLAND AVENUE, BROOKLYN, NY 11205",CONSTRUCT NEW DENTAL FACILITY AT NYC HEALTH + HOSPITALS ¦ CUMBERLAND,cpd11-20bk.pdf
27201803,CUMBERLAND,819,HEALTH AND HOSPITALS CORP,ROUTINE RECONSTRUCTION,,BROOKLYN,HO-0214,1658,158,1500,0,0,0,0,0,1658,158,1500,0,0,0,0,0,1658,316,3000,0,0,0,0,0,3316,,100 NORTH PORTLAND AVENUE,"FACADE REHABILITATION, INCLUDING DESIGN, CONSTRUCTION, AND ASBESTOS ABATEMENT",cpd11-20bk.pdf
29201301,KCHC,819,HEALTH AND HOSPITALS CORP,ROUTINE RECONSTRUCTION,309,BROOKLYN,HO-0214,5395,4806,123,433,0,0,0,0,5362,4806,123,433,0,0,0,0,5362,9612,246,866,0,0,0,0,10724,PROJECT DELAYED DUE TO CHANGES IN SCOPE/DESIGN,"451 CLARKSON AVENUE, BROOKLYN, NY 11203",INSTALL UPDATED FIRE ALARM SYSTEM AT KINGS COUNTY HOSPITAL CENTER. MANY PORTIONS OF,cpd11-20bk.pdf
29201501,BED-STUY REHAB CTR,819,HEALTH AND HOSPITALS CORP,ROUTINE RECONSTRUCTION,303,BROOKLYN,HO-0214,200,41,0,356,0,0,0,0,397,41,0,356,0,0,0,0,397,82,0,712,0,0,0,0,794,PROJECT DELAYED DUE TO CHANGES IN SCOPE/DESIGN,"722 MYRTLE AVENUE, BROOKLYN, NY 11205",CURRENT FIRE ALARM SYSTEM AT THE BEDFORD-STUYVESANT ALCOHOLISM TREATMENT CENTER IS,cpd11-20bk.pdf
29201610,KCHC,819,HEALTH AND HOSPITALS CORP,ROUTINE RECONSTRUCTION,309,BROOKLYN,HO-0214,618,558,15594,0,0,0,0,0,16152,558,15594,0,0,0,0,0,16152,1116,31188,0,0,0,0,0,32304,PROJECT DELAYED DUE TO CHANGES IN SCOPE/DESIGN,"451 CLARKSON AVENUE, BROOKLYN, N. Y. 11203","THE PURPOSE OF THIS PROJECT IS TO RENOVATE BUILDING ""T"" AT KINGS COUNTY HOSPITAL CENTER",cpd11-20bk.pdf
29201611,KCHC,819,HEALTH AND HOSPITALS CORP,ROUTINE RECONSTRUCTION,309,BROOKLYN,HO-0214,1100,851,248,0,0,0,0,0,1099,851,248,0,0,0,0,0,1099,1702,496,0,0,0,0,0,2198,PROJECT DELAYED DUE TO CHANGES IN SCOPE/DESIGN,"451 CLARKSON AVENUE, BROOKLYN, N. Y. 11203","THE PURPOSE OF THIS PROJECT IS TO RENOVATE BUILDINGS A, B, AND C AT KINGS COUNTY",cpd11-20bk.pdf
29201612,KCHC,819,HEALTH AND HOSPITALS CORP,ROUTINE RECONSTRUCTION,309,BROOKLYN,HO-0214,17606,14216,84,3307,0,0,0,0,17607,14216,84,3307,0,0,0,0,17607,28432,168,6614,0,0,0,0,35214,,"451 CLARKSON AVENUE, BROOKLYN, N. Y. 11203","THE PURPOSE OF THIS PROJECT IS TO RENOVATE BLDNG ""P"" FACADE AT KINGS COUNTY HOSPITAL",cpd11-20bk.pdf
29201614,KCHC,819,HEALTH AND HOSPITALS CORP,ROUTINE RECONSTRUCTION,309,BROOKLYN,HO-0214,5000,4619,0,0,381,0,0,0,5000,4619,0,0,381,0,0,0,5000,9238,0,0,762,0,0,0,10000,PROJECT DELAYED DUE TO CHANGES IN SCOPE/DESIGN,"451 CLARKSON AVENUE, BROOKLYN, NY 11203","REPLACE BOILER AT KINGS COUNTY HOSPITAL CENTER, BROOKLYN, NY.",cpd11-20bk.pdf
29201802,KCHC,819,HEALTH AND HOSPITALS CORP,ROUTINE RECONSTRUCTION,,BROOKLYN,HO-0214,2697,2100,350,0,0,247,0,0,2697,2100,350,0,0,247,0,0,2697,4200,700,0,0,494,0,0,5394,,"451 CLARKSON AVENUE, BROOKLYN, NY 11203",REPLACEMENT OF C6 HEMODIALYSIS WATER TREATMENT & DISTRIBUTION SYSTEM AT KINGS COUNTY,cpd11-20bk.pdf
29201803,"KINGS, ABC BUILDING ELECTRICAL FEEDER REPLACEMENT",819,HEALTH AND HOSPITALS CORP,ROUTINE RECONSTRUCTION,,BROOKLYN,HO-0214,460,417,0,0,43,0,0,0,460,417,0,0,43,0,0,0,460,834,0,0,86,0,0,0,920,PROJECT DELAYED DUE TO CHANGES IN SCOPE/DESIGN,"451 CLARKSON AVENUE, BROOKLYN, NY 11203",ABC BUILDING ELECTRICAL FEEDER REPLACEMENT AT KINGS COUNTY HOSPITAL,cpd11-20bk.pdf
29202001,KIN,819,HEALTH AND HOSPITALS CORP,ROUTINE RECONSTRUCTION,,BROOKLYN,HO-0214,26146,476,2500,23170,0,0,0,0,26146,476,2500,23170,0,0,0,0,26146,952,5000,46340,0,0,0,0,52292,,"451 CLARKSON AVENUE, BROOKLYN, NY 11203",KINGS COUNTY HOSPITAL CENTER,cpd11-20bk.pdf
29202002,KINGS BUILDING D ELEVATOR MODERNIZATION,819,HEALTH AND HOSPITALS CORP,ROUTINE RECONSTRUCTION,,BROOKLYN,HO-0214,2090,1900,190,0,0,0,0,0,2090,1900,190,0,0,0,0,0,2090,3800,380,0,0,0,0,0,4180,,"451 CLARKSON AVE, BK, NY, 11203",,cpd11-20bk.pdf
29202101,RESTORATION OF WEST SMOKE STACK,819,HEALTH AND HOSPITALS CORP,ROUTINE RECONSTRUCTION,,BROOKLYN,HO-0214 HO-D003,600,0,59,541,0,0,0,0,600,0,59,541,0,0,0,0,600,0,118,1082,0,0,0,0,1200,,"451 CLARKSON ST, BROOKLYN, NY 11203",NA,cpd11-20bk.pdf
29202102,KINGS,819,HEALTH AND HOSPITALS CORP,NEW FACILITIES,,BROOKLYN,HO-D003,70,0,70,0,0,0,0,0,70,0,70,0,0,0,0,0,70,0,140,0,0,0,0,0,140,,"451 CLARKSON AVENUE, BROOKLYN, NY 11203",CONSTRUCT NEW WELLNESS CENTER FOR PHYSICIANS,cpd11-20bk.pdf
29202103,KIN,819,HEALTH AND HOSPITALS CORP,ROUTINE RECONSTRUCTION,,BROOKLYN,HO-0214,575,0,575,0,0,0,0,0,575,0,575,0,0,0,0,0,575,0,1150,0,0,0,0,0,1150,,,RENOVATION OF MORGUE,cpd11-20bk.pdf
29202104,KIN,819,HEALTH AND HOSPITALS CORP,ROUTINE RECONSTRUCTION,,BROOKLYN,HO-0214,2268,0,0,2268,0,0,0,0,2268,0,0,2268,0,0,0,0,2268,0,0,4536,0,0,0,0,4536,,"451 CLARKSON ST, BROOKLYN, NY 11203",KINGS BLDG D ELECTRICAL UPGRADES,cpd11-20bk.pdf
29202105,KIN,819,HEALTH AND HOSPITALS CORP,ROUTINE RECONSTRUCTION,,BROOKLYN,HO-0214,1000,0,0,1000,0,0,0,0,1000,0,0,1000,0,0,0,0,1000,0,0,2000,0,0,0,0,2000,,"451 CLARKSON ST, BROOKLYN, NY 11203",DOMESTIC WTER BALANCING AT BUILDING S KINGS COUNTY HOSPITAL,cpd11-20bk.pdf
48200803,WOODHULL,819,HEALTH AND HOSPITALS CORP,ROUTINE RECONSTRUCTION,303,BROOKLYN,HO-0214,3578,2931,0,0,107,0,0,0,3038,2931,0,0,107,0,0,0,3038,5862,0,0,214,0,0,0,6076,PROJECT DELAYED DUE TO CHANGES IN SCOPE/DESIGN,"760 BROADWAY, BROOKLYN, NY 11206","CREATE 14 PATIENT ROOMS (2 LABOR & DELIVERY ROOMS, 1 BREASTFEEDING RM, 1",cpd11-20bk.pdf
48201402,WOODHULL,819,HEALTH AND HOSPITALS CORP,ROUTINE RECONSTRUCTION,,BROOKLYN,HO-0214,1817,1666,0,0,0,127,0,0,1793,1666,0,0,0,127,0,0,1793,3332,0,0,0,254,0,0,3586,PROJECT DELAYED DUE TO CHANGES IN SCOPE/DESIGN,"760 BROADWAY, BROOKLYN, NY 11206",RENOVATE THE CPEP DEPARTMENT AT WOODHULL MEDICAL & MENTAL HEALTH CENTER.,cpd11-20bk.pdf
48201506,WOODHULL,819,HEALTH AND HOSPITALS CORP,ROUTINE RECONSTRUCTION,303,BROOKLYN,HO-K001,4150,0,0,0,0,4150,0,0,4150,0,0,0,0,4150,0,0,4150,0,0,0,0,8300,0,0,8300,,760 BROADWAY BROOKLYN 11206,WOODHULL,cpd11-20bk.pdf
48201516,WOODHULL,819,HEALTH AND HOSPITALS CORP,ROUTINE RECONSTRUCTION,303,BROOKLYN,HO-D003,256,49,0,133,0,0,0,0,182,49,0,133,0,0,0,0,182,98,0,266,0,0,0,0,364,PROJECT DELAYED DUE TO BUDGETARY CONSTRAINTS,"760 BROADWAY, BROOKLYN, NY 11206",RECONIGURE EXISTING WOMEN'S HEALTH PAVILION TO MAKE SERVICES ACCESSIBLE FOR WOMEN,cpd11-20bk.pdf
48201602,WOODHULL,819,HEALTH AND HOSPITALS CORP,ROUTINE RECONSTRUCTION,,BROOKLYN,HO-0214,8036,364,7672,0,0,0,0,0,8036,364,7672,0,0,0,0,0,8036,728,15344,0,0,0,0,0,16072,,THE PURPOSE OF THIS PROJECT IS TO RENOVATE BUILDINGS AT WOODHULL HOSPITAL CENTER USING,THE PURPOSE OF THIS PROJECT IS TO RENOVATE BUILDINGS AT WOODHULL HOSPITAL CENTER USING,cpd11-20bk.pdf
48201610,RENOVATE BUSHWICK COMMUNICARE,819,HEALTH AND HOSPITALS CORP,ROUTINE RECONSTRUCTION,304,BROOKLYN,HO-0214,3319,4228,182,0,0,0,0,0,4410,4228,182,0,0,0,0,0,4410,8456,364,0,0,0,0,0,8820,PROJECT DELAYED DUE TO CHANGES IN SCOPE/DESIGN,"335 CENTRAL AVENUE, BROOKLYN, NY 11221",RENOVATE THE BUSHWICK COMMUNICARE HEALTH CLINIC IN ORDER TO EXPAND PRIMARY CARE,cpd11-20bk.pdf
48201901,WOODHULL,819,HEALTH AND HOSPITALS CORP,ROUTINE RECONSTRUCTION,,BROOKLYN,HO-D003,150,0,0,0,0,150,0,0,150,0,0,0,0,150,0,0,150,0,0,0,0,300,0,0,300,PROJECT DELAYED DUE TO CHANGES IN SCOPE/DESIGN,"760 BROADWAY, BROOKLYN, NY 11203",CPEP RENOVATION,cpd11-20bk.pdf
48201902,WOODHULL,819,HEALTH AND HOSPITALS CORP,ROUTINE RECONSTRUCTION,,BROOKLYN,HO-D003,5000,253,3000,0,0,1747,0,0,5000,253,3000,0,0,1747,0,0,5000,506,6000,0,0,3494,0,0,10000,,"760 BROADWAY, BROOKLYN, NY 11203",EMERGENCY DEPARTMENT RENOVATION,cpd11-20bk.pdf
48201903,WOODHULL,819,HEALTH AND HOSPITALS CORP,ROUTINE RECONSTRUCTION,,BROOKLYN,HO-0214,37,0,0,1857,0,0,0,0,1857,0,0,1857,0,0,0,0,1857,0,0,3714,0,0,0,0,3714,,"760 BROADWAY, BROOKLYN, NY 11206",RENOVATE RETAIL PHARMACY AT WOODHULL MEDICAL & MENTAL HEALTH CENTER,cpd11-20bk.pdf
48202001,WOODHULL,819,HEALTH AND HOSPITALS CORP,ROUTINE RECONSTRUCTION,,BROOKLYN,HO-D003,842,0,0,842,0,0,0,0,842,0,0,842,0,0,0,0,842,0,0,1684,0,0,0,0,1684,,"760 BROADWAY, BROOKLYN, NY 11206",CREATE 14 EXAM ROOMS FOR THE ADULT MEDICINE CLINIC AT NYC HEALTH + HOSPITALS / WOODHULL,cpd11-20bk.pdf
48202002,WOODHULL,819,HEALTH AND HOSPITALS CORP,ROUTINE RECONSTRUCTION,,BROOKLYN,HO-0214,2232,0,0,2232,0,0,0,0,2232,0,0,2232,0,0,0,0,2232,0,0,4464,0,0,0,0,4464,,"760 BROADWAY, BROOKLYN, NY 11206",MODERNIZATION OF ELEVATORS,cpd11-20bk.pdf
48202003,WOODHULL,819,HEALTH AND HOSPITALS CORP,ROUTINE RECONSTRUCTION,,BROOKLYN,HO-0214,950,0,950,0,0,0,0,0,950,0,950,0,0,0,0,0,950,0,1900,0,0,0,0,0,1900,,"760 BROADWAY, BROOKLYN, NY 11206",DINEX BUILDOUT AND INSTALLATION AT WOODHULL,cpd11-20bk.pdf
48202101,WOODHULL,819,HEALTH AND HOSPITALS CORP,ROUTINE RECONSTRUCTION,,BROOKLYN,HO-D003,258,0,258,0,0,0,0,0,258,0,258,0,0,0,0,0,258,0,516,0,0,0,0,0,516,,"760 BORADWAY, BROOKLYN, NY 11206",SURVEILLANCE MODERNIZATION,cpd11-20bk.pdf
48202102,WOO,819,HEALTH AND HOSPITALS CORP,ROUTINE RECONSTRUCTION,,BROOKLYN,HO-0214,1540,0,1540,0,0,0,0,0,1540,0,1540,0,0,0,0,0,1540,0,3080,0,0,0,0,0,3080,,"760 BROADWAY, BROOKLYN, NY 11206",ELECTRICAL UPGRADES AT WOODHULL,cpd11-20bk.pdf
ACEHHC407,Cumberland,819,HEALTH AND HOSPITALS CORP,"BUILDING CONSTRUCTION, RECONSTRUCTION OR RETROFIT",305,BROOKLYN,HO-0214,8542,7937,605,0,0,0,0,0,8542,7937,605,0,0,0,0,0,8542,15874,1210,0,0,0,0,0,17084,,,REPLACE EXISTING HPS BOILERS & ANCILLARY EQUIPMENT WITH NEW HIGH EFFICIENCY LOW,cpd11-20bk.pdf
ACEHHC607,KCHC,819,HEALTH AND HOSPITALS CORP,ROUTINE RECONSTRUCTION,,BROOKLYN,HO-0214 PU-0025,1229,712,78,0,345,0,0,0,1135,712,78,0,345,0,0,0,1135,1424,156,0,690,0,0,0,2270,PROJECT DELAYED DUE TO CHANGES IN SCOPE/DESIGN,"451 CLARKSON AVENUE, BROOKLYN, NY 11203",LIGHTING UPGRADES - PHASE 2 AT KINGS COUNTY HOSPITAL CENTER,cpd11-20bk.pdf
CIH1,CIH,819,HEALTH AND HOSPITALS CORP,MAJOR OR PARTIAL HOSPITAL RECONSTRUCTION,300,BROOKLYN,HO-0377,92012,37913,0,1645,0,0,0,0,39558,37913,0,1645,0,0,0,0,39558,75826,0,3290,0,0,0,0,79116,PROJECT DELAYED DUE TO CHANGES IN SCOPE/DESIGN,"2601 OCEAN PARKWAY, BROOKLYN, NY 11235",CONEY ISLAND HOSPITAL - MAJOR MODERNIZATION PROJECT TO CONSOLIDATE AND MODERNIZE THE,cpd11-20bk.pdf
GABIHHC,GROUP ATTACHMENT BASED INTERVENTION,819,HEALTH AND HOSPITALS CORP,CHILD WELFARE FACILITIES,300,BROOKLYN,CS-0003,759,303,83,0,0,0,0,0,386,303,83,0,0,0,0,0,386,606,166,0,0,0,0,0,772,,,TBD,cpd11-20bk.pdf
SAND2607,CIH,819,HEALTH AND HOSPITALS CORP,ROUTINE RECONSTRUCTION,,BROOKLYN,HO-0214,702,0,1,0,0,0,0,0,1,0,1,0,0,0,0,0,1,0,2,0,0,0,0,0,2,,"2601 OCEAN PARKWAY, BROOKLYN, NY 11235",NYC HEALTH + HOSPITALS ¦ CONEY ISLAND,cpd11-20bk.pdf
26-STAB13,26th Ward - Emergency Generators,826,DEPT ENVIRONMENTAL PROTECTION,PLANT COMPONENT STABILIZATION,318 305 316,BROOKLYN,WP-0206,72340,13210,4966,0,0,0,0,0,18176,13210,4966,0,0,0,0,0,18176,26420,9932,0,0,0,0,0,36352,PROJECT DELAYED DUE TO BUDGETARY CONSTRAINTS,,26TH WARD - EMERGENCY GENERATORS. STABILIZATION OF THE 26TH WARD WPCP. INCREASE THE,cpd11-20bk.pdf
26-STAB20,26th Ward Primary Settling Tank & Solid Handling,826,DEPT ENVIRONMENTAL PROTECTION,PLANT COMPONENT STABILIZATION,318 305 316,BROOKLYN,WP-0206,232200,180435,13228,0,0,0,0,0,193663,180435,13228,0,0,0,0,0,193663,360870,26456,0,0,0,0,0,387326,PROJECT DELAYED DUE TO CHANGES IN SCOPE/DESIGN,,EMERGENCY INSTALLATION OF (3) LOW LEVEL MAIN SEWAGE PUMPS AND MOTOR CONTROLS AT 26TH,cpd11-20bk.pdf
26W-144-L,INSTALLATION OF (13) NEW CENTRIFUGES @ 26TH WARD WPCP,826,DEPT ENVIRONMENTAL PROTECTION,PLANT UPGRADING AND RECONSTRUCTION,300,BROOKLYN,WP-0112,50850,15001,0,11000,0,0,0,34686,60687,15001,0,11000,0,0,0,34686,60687,30002,0,22000,0,0,0,69372,121374,,"12266 FLATLANDS AVENUE, BROOKLYN NEW YORK 11270",INSTALLATION OF (13) NEW CENTRIFUGES ATH THE 26TH WARD WPCP,cpd11-20bk.pdf
26W-147-L,LIGHTING UPGRADE AT THE 26TH WARD WPCP,826,DEPT ENVIRONMENTAL PROTECTION,PLANT UPGRADING AND RECONSTRUCTION,300,BROOKLYN,WP-0112,100,0,13892,0,0,0,0,0,13892,0,13892,0,0,0,0,0,13892,0,27784,0,0,0,0,0,27784,PROJECT DELAYED DUE TO CHANGES IN SCOPE/DESIGN,,LIGHTING UPGRADE AT THE 26TH WARD WPCP,cpd11-20bk.pdf
26W-148-L,TRC - CONS OF DISINFECTION FACILITIES AT 26TH WARD WPCP,826,DEPT ENVIRONMENTAL PROTECTION,CONSENT DECREE UPGRADING AND CONSTRUCTION,300,BROOKLYN,WP-0282,33000,0,0,0,5217,0,26316,0,31533,0,0,0,5217,0,26316,0,31533,0,0,0,10434,0,52632,0,63066,PROJECT DELAYED DUE TO BUDGETARY CONSTRAINTS,,CONSTRUCTION OF DISINFECTION FACILITIES AT 26TH WARD WPCP,cpd11-20bk.pdf
26W-149,RECONSTRUCT TIDE GATES/EFFLUENT CHAMBERS @ SPRING CREEK,826,DEPT ENVIRONMENTAL PROTECTION,PLANT UPGRADING AND RECONSTRUCTION,300,BROOKLYN,WP-0112,7150,300,11358,0,0,0,0,0,11658,300,11358,0,0,0,0,0,11658,600,22716,0,0,0,0,0,23316,PROJECT DELAYED DUE TO CHANGES IN SCOPE/DESIGN,"122-66 FLATLANDS AVENUE, BROOKLYN, NEW YORK 11207",RECONSTRUCTION OF EFFLUENT CHAMBERS AND RETROFITTING OF 48 TIDE GATESIN THE EXISTING,cpd11-20bk.pdf
26W-156-L,REPLACE WASTE ACTIVATED SLUDGE PIPING AT 26TH WARD WPCP,826,DEPT ENVIRONMENTAL PROTECTION,PLANT UPGRADING AND RECONSTRUCTION,300,BROOKLYN,WP-0112,6600,0,0,600,0,0,0,6000,6600,0,0,600,0,0,0,6000,6600,0,0,1200,0,0,0,12000,13200,,,REPLACE WASTE ACTIVATED SLUDGE PIPING AT 26TH WARD WPCP,cpd11-20bk.pdf
26W-21,HIGH LEVEL MAIN SEWAGE PUMP IMPROVEMENTS AT 26TH WARD WPCP,826,DEPT ENVIRONMENTAL PROTECTION,PLANT COMPONENT STABILIZATION,300,BROOKLYN,WP-0206,18156,16720,265,0,0,0,0,0,16985,16720,265,0,0,0,0,0,16985,33440,530,0,0,0,0,0,33970,PROJECT DELAYED DUE TO BUDGETARY CONSTRAINTS,,HIGH LEVEL MAIN SEWAGE PUMP IMPROVEMENTS AT 26TH WARD WPCP,cpd11-20bk.pdf
BED-828,"Dist WM work in 86th St between Bay 20th & 28th St, BKLYN",826,DEPT ENVIRONMENTAL PROTECTION,AUGMENTATION OF WATER SUPPLY SYSTEMS,311,BROOKLYN,SE-0002K WM-0001,6878,0,0,0,6113,0,0,0,6113,0,0,0,6113,0,0,0,6113,0,0,0,12226,0,0,0,12226,,,DISTRIBUTION WATER MAIN WORK IN 86TH STREET BETWEEN BAY 20TH STREET AND BAY 28TH,cpd11-20bk.pdf
BED-833,Rel.& Inst. WMs on Flatland Ave btwn Ralph Ave & E 76 St BKL,826,DEPT ENVIRONMENTAL PROTECTION,AUGMENTATION OF WATER SUPPLY SYSTEMS,318,BROOKLYN,WM-0001,389,0,362,0,0,0,0,0,362,0,362,0,0,0,0,0,362,0,724,0,0,0,0,0,724,,,RELOCATION & INSTALLATION OF NEW WATER MAINS ON FLATLAND AVENUE BETWEEN RALPH AVE AND,cpd11-20bk.pdf
CI-113-L,RECONSTRUCT (4) ENGINE GENERATOR CONTROL SYSTEM,826,DEPT ENVIRONMENTAL PROTECTION,PLANT UPGRADING AND RECONSTRUCTION,300,BROOKLYN,WP-0112,70450,303,0,18000,0,0,0,33100,51403,303,0,18000,0,0,0,33100,51403,606,0,36000,0,0,0,66200,102806,,"AVENUE ""Z"" AND KNAPP STREET, BROOKLYN, NEW YORK 11235",RECONSTRUCTION OF (4) FOUR ENGINE GENERATOR CONTROL SYSTEM AT THE CONEY ISLAND WPCP,cpd11-20bk.pdf
CI-119-L,RECONSTRUCTION OF GATES & MSP MOTORS & CONTROLS @ C.I.,826,DEPT ENVIRONMENTAL PROTECTION,PLANT UPGRADING AND RECONSTRUCTION,300,BROOKLYN,WP-0112,23294,32381,109788,0,0,0,0,0,142169,32381,109788,0,0,0,0,0,142169,64762,219576,0,0,0,0,0,284338,,"AVENUE Z AND KNAPP STREET, BROOKLYN, N.Y. 11208",RECONSTRUCTION OF GATES AND MSP MOTORS AND CONTROL AT CONEY ISLAND WWTP,cpd11-20bk.pdf
CI-140-L,INSTALL ODOR CONTROL PANELS FOR AERATION SCRUBBER SYSTEM,826,DEPT ENVIRONMENTAL PROTECTION,PLANT UPGRADING AND RECONSTRUCTION,300,BROOKLYN,WP-0112,2475,0,0,0,0,0,0,2100,2100,0,0,0,0,0,0,2100,2100,0,0,0,0,0,0,4200,4200,,"AVENUE Z AND KNAPP STREET, BROOKLYN, N.Y. 11208",INSTALLATION OF ODOR CONTROL PANELS FOR THE AERATION SCRUBBER SYSTEM AT THE CONEY,cpd11-20bk.pdf
CS-GC-SFS,CONSTRUCTION OF GOWANUS CSO RETENTION FAC SUPERFUND SITE,826,DEPT ENVIRONMENTAL PROTECTION,WATER QUALITY MANDATES,399,BROOKLYN,WP-0169,348000,162638,4844,0,81287,0,42436,642932,934137,162638,4844,0,81287,0,42436,642932,934137,325276,9688,0,162574,0,84872,1285864,1868274,,,CONSTRUCTION OF OF TWO IN-LINE SEWAGE/STORMWATER RETENTIONS TANKS TO RETAIN,cpd11-20bk.pdf
CSO-GC,FLUSHING TUNNEL REACTIVATION & GOWANUS CANAL FORCE MAIN,826,DEPT ENVIRONMENTAL PROTECTION,WATER QUALITY MANDATES,399,BROOKLYN,WP-0169,126428,197146,407,0,0,0,0,0,197553,197146,407,0,0,0,0,0,197553,394292,814,0,0,0,0,0,395106,PROJECT DELAYED DUE TO BUDGETARY CONSTRAINTS,"GOWANUS CANAL & FLUSHING TUNNEL, BROOKLYN,NY","FLUSHING TUNNEL REACTIVATION AND GOWANUS CANAL FORCE MAIN, (FORMERLY IN WP-152) CONTS.",cpd11-20bk.pdf
CSO-GC-SP,CONSTRUCTION OF GOWANUS CANAL PILOT SPONGE PARK,826,DEPT ENVIRONMENTAL PROTECTION,WATER QUALITY MANDATES,300,BROOKLYN,P-D017,1273,594,116,0,0,0,0,0,710,594,116,0,0,0,0,0,710,1188,232,0,0,0,0,0,1420,PROJECT DELAYED DUE TO CHANGES IN SCOPE/DESIGN,,DESIGN AND CONSTRUCTION OF GOWANUS CANAL PILOT SPONGE PARK,cpd11-20bk.pdf
CS-PA-ECR,ECOLOGICAL RESTORATION,826,DEPT ENVIRONMENTAL PROTECTION,WATER QUALITY MANDATES,318,BROOKLYN,WP-0169,12050,21238,349,0,0,0,0,0,21587,21238,349,0,0,0,0,0,21587,42476,698,0,0,0,0,0,43174,PROJECT DELAYED DUE TO BUDGETARY CONSTRAINTS,,ECOLOGICAL RESTORATION . PAERDEGAT BASIN WATER QUALITY.,cpd11-20bk.pdf
EC-SEKS22,"Reconstruction of Existing Sewers, South Brooklyn",826,DEPT ENVIRONMENTAL PROTECTION,REPLACEMENT OR AUGMENTATION OF EXISTING SYSTEMS,300,BROOKLYN,EP-0007 SE-0002K,8800,0,0,8000,0,0,0,0,8000,0,0,8000,0,0,0,0,8000,0,0,16000,0,0,0,0,16000,,,"RECONSTRUCTION OF EXISTING SEWERS, SOUTH BROOKLYN",cpd11-20bk.pdf
GI-RH-GR,GI - GREEN ROOF INSTALLATION AT RED HOOK HOUSES IN BKLYN,826,DEPT ENVIRONMENTAL PROTECTION,GREEN INFRASTRUCTURE PROGRAM,300,BROOKLYN,WP-0169,100,0,100,0,0,0,0,0,100,0,100,0,0,0,0,0,100,0,200,0,0,0,0,0,200,,,GREEN ROOF INSTALLATION AT THE RED HOOK HOUSES IN BROOKLYN AS PART OFHURRICAN SANDY,cpd11-20bk.pdf
GK-PD-A,"GI - INSTALL GI AT NYPD PCTS 75, 77 & 115 PARKING LOTS",826,DEPT ENVIRONMENTAL PROTECTION,GREEN INFRASTRUCTURE PROGRAM,300,BROOKLYN,WP-0169,1296,0,0,118,1178,0,0,0,1296,0,0,118,1178,0,0,0,1296,0,0,236,2356,0,0,0,2592,,,"GI - INSTALL GREEN INFRASTRUCTURE AT NEW YORK POLICE DEPARTMENT PRECINCTS 75, 77 & 115",cpd11-20bk.pdf
GK-PD-B,"GI - INSTALL GI AT NYPD PCTS 73, 79 & 81 PARKING LOTS",826,DEPT ENVIRONMENTAL PROTECTION,GREEN INFRASTRUCTURE PROGRAM,300,BROOKLYN,WP-0169,1804,0,0,0,0,0,1804,0,1804,0,0,0,0,0,1804,0,1804,0,0,0,0,0,3608,0,3608,PROJECT DELAYED DUE TO BUDGETARY CONSTRAINTS,,"INSTALL GREEN INFRASTRUCTURE AT NEW YORK POLICE DEPARTMENT PRECINCTS 73, 79 & 81",cpd11-20bk.pdf
GK-PD-C,GI - INSTALL GI AT NYPD 83 PRECINCT PARKING LOTS,826,DEPT ENVIRONMENTAL PROTECTION,GREEN INFRASTRUCTURE PROGRAM,300,BROOKLYN,WP-0169,1016,0,0,0,0,0,1016,0,1016,0,0,0,0,0,1016,0,1016,0,0,0,0,0,2032,0,2032,PROJECT DELAYED DUE TO BUDGETARY CONSTRAINTS,,GI - INSTALL GREEN INFRASTRUCTURE AT NEW YORK POLICE DEPARTMENT PRECINCT 83 PARKING,cpd11-20bk.pdf
GK-PD-D,"GI - INSTALL GI AT NYPD PCTS 43, 71,107 & FLUSHING ARMORY",826,DEPT ENVIRONMENTAL PROTECTION,GREEN INFRASTRUCTURE PROGRAM,300,BROOKLYN,WP-0169,2379,0,0,0,0,0,2379,0,2379,0,0,0,0,0,2379,0,2379,0,0,0,0,0,4758,0,4758,PROJECT DELAYED DUE TO BUDGETARY CONSTRAINTS,,"GI - INSTALL GREEN INFRASTRUCTURE AT NEW YORK POLICE DEPARTMENT PRECINCTS 43, 71, 107",cpd11-20bk.pdf
NC-159,TRC - NEWTOWN CREEK DECLORINATION FACILITY,826,DEPT ENVIRONMENTAL PROTECTION,CONSENT DECREE UPGRADING AND CONSTRUCTION,300,BROOKLYN,WP-0282,8974,12952,566,0,0,0,0,0,13518,12952,566,0,0,0,0,0,13518,25904,1132,0,0,0,0,0,27036,,"301 GREEN POINT AVENUE BROOKLYN, N.Y. 11222",NEWTOWN CREEK DECLORINATION,cpd11-20bk.pdf
NC-163,CONSTRUCTION OF PERIMETER FENCE AT NEWTOWN CREEK WPCP,826,DEPT ENVIRONMENTAL PROTECTION,PLANT UPGRADING AND RECONSTRUCTION,300,BROOKLYN,WP-0112,4200,5912,323,0,0,0,0,0,6235,5912,323,0,0,0,0,0,6235,11824,646,0,0,0,0,0,12470,,,CONSTRUCTION OF PERIMETER FENCE AT NEWTOWN CREEK WPCP,cpd11-20bk.pdf
NC-176-L,RECONSTRUCTION OF CCTV SYSTEM @ THE NEWTOWN CREEK WWTP,826,DEPT ENVIRONMENTAL PROTECTION,PLANT UPGRADING AND RECONSTRUCTION,300,BROOKLYN,WP-0112,5850,4291,470,0,0,0,0,0,4761,4291,470,0,0,0,0,0,4761,8582,940,0,0,0,0,0,9522,,"329 GREENPOINT AVENUE BROOKLYN, N.Y. 11222",RECONSTRUCTION OF THE CCTV SYSTEM AT THE NEWTOWN CREEK WASTEWATER TREATMENT,cpd11-20bk.pdf
NC-50,NEWTOWN CREEK WPCP SLUDGE LOADING DOCKS,826,DEPT ENVIRONMENTAL PROTECTION,CONSENT DECREE UPGRADING AND CONSTRUCTION,300,BROOKLYN,WP-0283,112624,65086,983,0,0,0,0,0,66069,65086,983,0,0,0,0,0,66069,130172,1966,0,0,0,0,0,132138,PROJECT DELAYED DUE TO BUDGETARY CONSTRAINTS,,CONSTRUCTION OF NEWTOWN CREEK WPCP SLUDGE LOADING DOCK AND VESSELS,cpd11-20bk.pdf
NC-52,CONSTRUCTION OF WHALE CREEK FLOATING DOCK AT NEWTOWN CREEK,826,DEPT ENVIRONMENTAL PROTECTION,PLANT UPGRADING AND RECONSTRUCTION,300,BROOKLYN,WP-0112,2208,2707,49,0,0,0,0,0,2756,2707,49,0,0,0,0,0,2756,5414,98,0,0,0,0,0,5512,,,CONSTRUCTION OF WHALE CREEK FLOATING DOCK AT NEWTOWN CREEK WASTEWATERTREATMENT,cpd11-20bk.pdf
NC-ASB-TB,NEWTOWN CREEK GRAVITY THICKENER BLDG ASBESTOS ABATEMENT,826,DEPT ENVIRONMENTAL PROTECTION,PLANT UPGRADING AND RECONSTRUCTION,300,BROOKLYN,WP-0112,2500,0,2500,0,0,0,0,0,2500,0,2500,0,0,0,0,0,2500,0,5000,0,0,0,0,0,5000,,,ASBESTOS CLEANING/CONTAINMENT/ABATEMENT AT THE NEWTOWN CREEK GRAVITY THICKENER,cpd11-20bk.pdf
NC-GATEGP,CONSTRUCTION OF NEWTOWN CREEK GATEWAY TO GREENPOINT PROJECT,826,DEPT ENVIRONMENTAL PROTECTION,WATER QUALITY MANDATES,300,BROOKLYN,WP-D169,0,0,150,0,0,0,0,0,150,0,150,0,0,0,0,0,150,0,300,0,0,0,0,0,300,,,"CONSTRUCTION OF GREEN SPACE FOR A 12,000 SF PARCEL AT THE CORNER OF GREENPOINT AND",cpd11-20bk.pdf
OH-112-L,REPLACE MAIN SEWAGE PUMPS & PIPING AT OWLS HEAD WPCP,826,DEPT ENVIRONMENTAL PROTECTION,PLANT UPGRADING AND RECONSTRUCTION,300,BROOKLYN,WP-0112,209700,0,23000,0,0,17000,169000,0,209000,0,23000,0,0,17000,169000,0,209000,0,46000,0,0,34000,338000,0,418000,,"6700 SHORE ROAD FOOT OF 69TH STREET & THE NARROWS BROOKLYN, N.Y. 11220",REPLACE MAIN SEWAGE PUMPS & PIPING AT OWLS HEAD WPCP,cpd11-20bk.pdf
OH-88-L,RECONSTRUCTION OF FINAL TANKS AT OWLS HEAD WPCP,826,DEPT ENVIRONMENTAL PROTECTION,PLANT UPGRADING AND RECONSTRUCTION,300,BROOKLYN,WP-0112,29521,0,0,0,0,0,0,34500,34500,0,0,0,0,0,0,34500,34500,0,0,0,0,0,0,69000,69000,PROJECT DELAYED DUE TO BUDGETARY CONSTRAINTS,"6700 SHORE ROAD, FOOT OF 69TH STREET & NARROWS, BROOKLYN, N.Y. 11220",RECONSTRUCTION OF FINAL TANKS AT THE OWLS HEAD WPCP,cpd11-20bk.pdf
OH-91-L,RECONSTRUCTION OF SEA WALL AND DOCK @ OWLS HEAD WWTP,826,DEPT ENVIRONMENTAL PROTECTION,PLANT UPGRADING AND RECONSTRUCTION,300,BROOKLYN,WP-0112,4250,55518,373,0,0,0,0,0,55891,55518,373,0,0,0,0,0,55891,111036,746,0,0,0,0,0,111782,,"6700 SHORE ROAD, FOOT OF 69TH STREET & NARROWS, BROOKLYN, N.Y. 11220",RECONSTRUCTION OF SEA WALL AND DOCK @ OWLS HEAD WWTP,cpd11-20bk.pdf
PS-281,PROSPECT EXPRESSWAY,826,DEPT ENVIRONMENTAL PROTECTION,PLANT UPGRADING AND RECONSTRUCTION,300,BROOKLYN,WP-0269,19670,12048,159,0,0,0,0,0,12207,12048,159,0,0,0,0,0,12207,24096,318,0,0,0,0,0,24414,PROJECT DELAYED DUE TO BUDGETARY CONSTRAINTS,PROSPECT EXPRESSWAY,PROSPECT EXPRESSWAY,cpd11-20bk.pdf
PS-316,RECONSTRUCTION OF AVENUE U PUMPING STATION BROOKLYN,826,DEPT ENVIRONMENTAL PROTECTION,PLANT UPGRADING AND RECONSTRUCTION,300,BROOKLYN,WP-0269,5300,0,0,0,17000,0,0,0,17000,0,0,0,17000,0,0,0,17000,0,0,0,34000,0,0,0,34000,,"NORTHEAST CORNER OF AVENUE V AND OCEAN PARKWAY BROOKLYN, NEW YORK","RECONSTRUCTION OF AVENUE U PUMPING STATION BROOKLYN, NEW YORK",cpd11-20bk.pdf
PS-318,"RECONSTRUCTION OF PAERDEGAT PUMPING STATION, BROOKLYN, N.Y.",826,DEPT ENVIRONMENTAL PROTECTION,PLANT UPGRADING AND RECONSTRUCTION,300,BROOKLYN,WP-0269,6000,0,0,0,0,0,44000,0,44000,0,0,0,0,0,44000,0,44000,0,0,0,0,0,88000,0,88000,,"6016 FLATLANDS AVENUE (CORNER OF RALPH AVENUE) BROOKLYN, NEW YORK","RECONSTRUCTION OF PAERDEGATE PUMPING STATION, BROOKLYN, N.Y.",cpd11-20bk.pdf
PS-79,"RECONSTRUCT AVE ""V"" PUMPING STATION",826,DEPT ENVIRONMENTAL PROTECTION,PLANT UPGRADING AND RECONSTRUCTION,300,BROOKLYN,WP-0269,178280,217838,79,0,0,0,0,0,217917,217838,79,0,0,0,0,0,217917,435676,158,0,0,0,0,0,435834,PROJECT DELAYED DUE TO BUDGETARY CONSTRAINTS,,,cpd11-20bk.pdf
RH-80-L,TRC - DISINFECTION SYSTEM REHABILITATION AT RED HOOK WPCP,826,DEPT ENVIRONMENTAL PROTECTION,CONSENT DECREE UPGRADING AND CONSTRUCTION,300,BROOKLYN,WP-0282,1076,0,0,0,0,0,1076,0,1076,0,0,0,0,0,1076,0,1076,0,0,0,0,0,2152,0,2152,,"63 FLUSHING AVENUE, BROOKLYN, NY, 11205-1069",DISINFECTION SYSTEM REHABILITATION AT RED HOOK WPCP,cpd11-20bk.pdf
RH-83,REPLACE MAIN SEWAGE PUMPS AT RED HOOK WPCP,826,DEPT ENVIRONMENTAL PROTECTION,PLANT UPGRADING AND RECONSTRUCTION,300,BROOKLYN,WP-0112,25000,0,0,8200,0,0,0,105600,113800,0,0,8200,0,0,0,105600,113800,0,0,16400,0,0,0,211200,227600,PROJECT DELAYED DUE TO BUDGETARY CONSTRAINTS,,REPLACE MAIN SEWAGE PUMPS AT RED HOOK WPCP,cpd11-20bk.pdf
RH-91-L,INSTALL ACCESS CONTROL & DIGITAL VIDEO SURVEILLANCE SYS @ RH,826,DEPT ENVIRONMENTAL PROTECTION,PLANT UPGRADING AND RECONSTRUCTION,300,BROOKLYN,WP-0112,1875,1704,297,0,0,0,0,0,2001,1704,297,0,0,0,0,0,2001,3408,594,0,0,0,0,0,4002,,,DISCONNECT & REMOVE EXISTING VIDEO SURVEILLANCE SYS. THEN INSTALLATION OF FOUR (4) NEW,cpd11-20bk.pdf
SAND26W,STORM MITIGATION WORK ATTHE 26TH WARD WPCP,826,DEPT ENVIRONMENTAL PROTECTION,PLANT UPGRADING AND RECONSTRUCTION,300,BROOKLYN,WP-0112,20181,0,280,0,0,350,0,1088,1718,0,280,0,0,350,0,1088,1718,0,560,0,0,700,0,2176,3436,,,INSTALLATION OR CONSTRUCTION OF STORM MITIGATION WORK AT 26TH WARD WPCP,cpd11-20bk.pdf
SANDCI,STORM MITIGATION WORK ATTHE CONEY ISLAND WPCP,826,DEPT ENVIRONMENTAL PROTECTION,PLANT UPGRADING AND RECONSTRUCTION,300,BROOKLYN,WP-0112,38419,0,280,0,0,700,0,2772,3752,0,280,0,0,700,0,2772,3752,0,560,0,0,1400,0,5544,7504,,,CONSTRUCTION OF STORM MITIGATION ATTHE CONEY ISLAND WATER POLLUTION CONTROL PLANT,cpd11-20bk.pdf
SANDOH,STORM MITIGATION WORK ATTHE OWLS HEAD WPCP (HMP),826,DEPT ENVIRONMENTAL PROTECTION,PLANT UPGRADING AND RECONSTRUCTION,300,BROOKLYN,WP-0112,71645,0,280,0,0,700,0,6185,7165,0,280,0,0,700,0,6185,7165,0,560,0,0,1400,0,12370,14330,PROJECT DELAYED PENDING NON-CITY GRANT APPROVAL,,CONSTRUCTION OF STORM MITIGATION ATTHE OWLS HEAD WATER POLLUTION CONTROL PLANT,cpd11-20bk.pdf
SEK002385,"Rehab of Combined brick sewer via guniting 92st & 4 Ave, BK",826,DEPT ENVIRONMENTAL PROTECTION,REPLACEMENT OR AUGMENTATION OF EXISTING SYSTEMS,310,BROOKLYN,SE-0002K,5645,0,0,0,5645,0,0,0,5645,0,0,0,5645,0,0,0,5645,0,0,0,11290,0,0,0,11290,,,"REHABILITATION OF 132"" COMBINED BRICK SEWER BY GUNITING ALONG 92 ST. B/T RIDGE BLVD. & 4",cpd11-20bk.pdf
SEK002390,Guniting of Outfall Sewers on Wolcott St BKLYN,826,DEPT ENVIRONMENTAL PROTECTION,REPLACEMENT OR AUGMENTATION OF EXISTING SYSTEMS,306,BROOKLYN,SE-0002K,1469,0,0,1304,0,0,0,0,1304,0,0,1304,0,0,0,0,1304,0,0,2608,0,0,0,0,2608,,,"REHABILITATION OF 72"" CIRCULAR BRICK OUTFALL SEWER BY GUNITING ALONG WOLCOTT STREET",cpd11-20bk.pdf
SEK20075,NEW STORM SEWER IN INDIA ST.,826,DEPT ENVIRONMENTAL PROTECTION,REPLACEMENT OR AUGMENTATION OF EXISTING SYSTEMS,300,BROOKLYN,SE-0200K,1128,0,0,0,0,0,1128,0,1128,0,0,0,0,0,1128,0,1128,0,0,0,0,0,2256,0,2256,,,NEW STORM SEWER IN INDIA ST.,cpd11-20bk.pdf
SF-BNR-CI,STEP FEED BNR AT CONEY ISLAND & ROCKAWAY WPCPs,826,DEPT ENVIRONMENTAL PROTECTION,BIOLOGICAL NUTRIENT REMOVAL,300,BROOKLYN,WP-0285,27250,65447,148,0,0,0,0,0,65595,65447,148,0,0,0,0,0,65595,130894,296,0,0,0,0,0,131190,PROJECT DELAYED PENDING RESOLUTION OF LEGAL ISSUES,,THIS PROJECT IS TO RETROFIT THE EXISTING CI AND ROCK WWTPS FOR THE STEP FEED BNR,cpd11-20bk.pdf
WFF-DPR,"WATER EFICIENCY UPGRADES AT PROSPECT PARK, BROOKLYN",826,DEPT ENVIRONMENTAL PROTECTION,WATER FOR THE FUTURE,300,BROOKLYN,EP-0009,1407,0,0,571,0,0,0,0,571,0,0,571,0,0,0,0,571,0,0,1142,0,0,0,0,1142,,,CAPITAL WATER EFICIENCY UPGRADES IN DEPT OF PARKS & RECREATION (DPR),cpd11-20bk.pdf
S136-264Y,Brooklyn Cioffe Borough Shop Roof Replacement,827,DEPARTMENT OF SANITATION,GARAGES AND FACILITIES,300,BROOKLYN,S-0136,2300,563,0,101,7732,0,0,0,8396,563,0,101,7732,0,0,0,8396,1126,0,202,15464,0,0,0,16792,,,ROOF REPLACEMENT,cpd11-20bk.pdf
S136-332K,Brooklyn Knapp St Facility Improvements,827,DEPARTMENT OF SANITATION,GARAGES AND FACILITIES,315,BROOKLYN,S-0136,0,6159,65,0,0,0,0,0,6224,6159,65,0,0,0,0,0,6224,12318,130,0,0,0,0,0,12448,PROJECT DELAYED DUE TO CHANGES IN SCOPE/DESIGN,,SANITATION SERVICES TO BK 15,cpd11-20bk.pdf
S136-374W,Brooklyn 11 Boiler Replacement,827,DEPARTMENT OF SANITATION,GARAGES AND FACILITIES,311,BROOKLYN,S-0136,0,0,382,5147,0,0,0,0,5529,0,382,5147,0,0,0,0,5529,0,764,10294,0,0,0,0,11058,,,BROOKLYN 11 BOILER REPLACEMENT,cpd11-20bk.pdf
S136-380D,Brooklyn 14 Garage HVAC System Rehabilitation,827,DEPARTMENT OF SANITATION,GARAGES AND FACILITIES,314 318,BROOKLYN,S-0136,890,796,103,0,0,0,0,0,899,796,103,0,0,0,0,0,899,1592,206,0,0,0,0,0,1798,,,HVAC REHAB,cpd11-20bk.pdf
S136-383G,BROOKLYN CIOFFE SHOP HVAC REPLACEMENT,827,DEPARTMENT OF SANITATION,GARAGES AND FACILITIES,300,BROOKLYN,S-0136,4250,5484,421,0,0,0,0,0,5905,5484,421,0,0,0,0,0,5905,10968,842,0,0,0,0,0,11810,PROJECT DELAYED DUE TO CHANGES IN SCOPE/DESIGN,,HVAC REPLACEMENT,cpd11-20bk.pdf
S136-427,Brooklyn 16 922 Georgia Ave Garage Rehabilitation,827,DEPARTMENT OF SANITATION,GARAGES AND FACILITIES,305 316,BROOKLYN,S-0136,19316,0,175,999,1665,16652,0,0,19491,0,175,999,1665,16652,0,0,19491,0,350,1998,3330,33304,0,0,38982,,,REHAB,cpd11-20bk.pdf
S136-433,Brooklyn 10 Pier /53rd St Rehab,827,DEPARTMENT OF SANITATION,GARAGES AND FACILITIES,300,BROOKLYN,PU-0200,3450,0,256,2640,17746,0,0,0,20642,0,256,2640,17746,0,0,0,20642,0,512,5280,35492,0,0,0,41284,,,REHAB OF PIER NEEDED FOR SALT STORAGE AND VEHICLE PARKING,cpd11-20bk.pdf
S136-451,Brooklyn Greenpoint Warehouse Pump Replacement,827,DEPARTMENT OF SANITATION,GARAGES AND FACILITIES,301,BROOKLYN,S-0136,50,0,0,50,0,0,0,0,50,0,0,50,0,0,0,0,50,0,0,100,0,0,0,0,100,,,PUMP REPLACEMENT,cpd11-20bk.pdf
S136-464B,Brooklyn 8 Garage Roof and HVAC Replacement,827,DEPARTMENT OF SANITATION,GARAGES AND FACILITIES,308,BROOKLYN,S-0136,2400,606,44,6399,0,0,0,0,7049,606,44,6399,0,0,0,0,7049,1212,88,12798,0,0,0,0,14098,,,ROOF REPLACEMENT,cpd11-20bk.pdf
S136-464F,Brooklyn 16 923 Georgia Ave Roof Replacement,827,DEPARTMENT OF SANITATION,GARAGES AND FACILITIES,305 316,BROOKLYN,S-0136,4255,4150,598,0,0,0,0,0,4748,4150,598,0,0,0,0,0,4748,8300,1196,0,0,0,0,0,9496,,,ROOF REPLACEMENT,cpd11-20bk.pdf
S186-224,Brooklyn 3 Garage New Construction,827,DEPARTMENT OF SANITATION,GARAGES AND FACILITIES,303,BROOKLYN,S-0186,93710,187273,1407,6917,0,0,0,0,195597,187273,1407,6917,0,0,0,0,195597,374546,2814,13834,0,0,0,0,391194,PROJECT DELAYED DUE TO BUDGETARY CONSTRAINTS,"BEGINNING AT THE INTERSECTION OF NOSTRAND AVE AND MYRTLE AVE, MOVING SOUTH 200' THEN",NEW DOS GARAGE TO SERVE THE BROOKLYN DISTRICT 3 .,cpd11-20bk.pdf
S195-227K,BROOKLYN 7/10 SALT SHED REPLACEMENT,827,DEPARTMENT OF SANITATION,GARAGES AND FACILITIES,307 310,BROOKLYN,S-0195,3226,228,256,656,2281,0,0,0,3421,228,256,656,2281,0,0,0,3421,456,512,1312,4562,0,0,0,6842,,,SALT SHED ROOF REPLACEMENT,cpd11-20bk.pdf
S195-228J,Brooklyn Navy Yard Salt Storage Facility Rehabilitation,827,DEPARTMENT OF SANITATION,GARAGES AND FACILITIES,311,BROOKLYN,S-0195,346,244,62,0,0,0,0,0,306,244,62,0,0,0,0,0,306,488,124,0,0,0,0,0,612,,,REHABILITATION OF ROOF AND FRAME,cpd11-20bk.pdf
S216-403A,Hamilton Avenue MTS Bulkhead,827,DEPARTMENT OF SANITATION,MISCELLANEOUS ENERGY EFFICIENCY AND SUSTAINABILITY,300,BROOKLYN,PU-0200,6159,1485,0,4674,0,0,0,0,6159,1485,0,4674,0,0,0,0,6159,2970,0,9348,0,0,0,0,12318,,,REPLACEMENT OF BULKHEAD WALL BY HAMILTON AVE MTS,cpd11-20bk.pdf
S216-403C,Hamilton Avenue MTS Rehab,827,DEPARTMENT OF SANITATION,SOLID WASTE MANAGEMENT,300,BROOKLYN,S-0216,5312,0,1574,5134,0,0,0,0,6708,0,1574,5134,0,0,0,0,6708,0,3148,10268,0,0,0,0,13416,,,MTS SLAB REHAB,cpd11-20bk.pdf
SANDBK11C,Hurricane Sandy Brooklyn 11 Conduit Replacement,827,DEPARTMENT OF SANITATION,GARAGES AND FACILITIES,300,BROOKLYN,S-0136,96,0,22,0,0,0,0,0,22,0,22,0,0,0,0,0,22,0,44,0,0,0,0,0,44,,,CONDUIT,cpd11-20bk.pdf
SANDBK4FA,Hurricane Sandy Brooklyn 1/4 Fire Alarm Replacement,827,DEPARTMENT OF SANITATION,GARAGES AND FACILITIES,301,BROOKLYN,S-0136,200,121,299,0,0,0,0,0,420,121,299,0,0,0,0,0,420,242,598,0,0,0,0,0,840,,,REPLACEMENT OF FIRE ALARM DUE TO HURRICANE SANDY,cpd11-20bk.pdf
SANDGPTWH,Hurricane Sandy GRNPT Warehouse R/R & Haz Mitigation,827,DEPARTMENT OF SANITATION,GARAGES AND FACILITIES,300,BROOKLYN,S-0136,943,117,59,0,0,0,0,0,176,117,59,0,0,0,0,0,176,234,118,0,0,0,0,0,352,,,"REPLACE HOT WATER HEATERS, TRANSFORMER BOILER AND OTHER EQUIPMENT ANDRAISE CRITICAL",cpd11-20bk.pdf
SANDGPWHC,Hurricane Sandy GRNPT Warehouse Conduit Replacement,827,DEPARTMENT OF SANITATION,GARAGES AND FACILITIES,300,BROOKLYN,S-0136,295,2,75,0,0,0,0,0,77,2,75,0,0,0,0,0,77,4,150,0,0,0,0,0,154,,,REPLACE CONDUIT,cpd11-20bk.pdf
ACEDOT601,DOT - Hamilton Administrative Building,841,DEPARTMENT OF TRANSPORTATION,"BUILDING CONSTRUCTION, RECONSTRUCTION OR RETROFIT",301,BROOKLYN,PU-0025,226,17,0,0,84,0,0,0,101,17,0,0,84,0,0,0,101,34,0,0,168,0,0,0,202,PROJECT DELAYED DUE TO BUDGETARY CONSTRAINTS,,DOT - HAMILTON ADMINISTRATIVE BUILDING ENERGY EFFICIENT UPGRADES,cpd11-20bk.pdf
ACEDOT802,DOT - Parking Garage LED Lighting Upgrade,841,DEPARTMENT OF TRANSPORTATION,"BUILDING CONSTRUCTION, RECONSTRUCTION OR RETROFIT",301,BROOKLYN,PU-0025,685,637,0,53,0,0,0,0,690,637,0,53,0,0,0,0,690,1274,0,106,0,0,0,0,1380,PROJECT DELAYED DUE TO BUDGETARY CONSTRAINTS,,PARKING GARAGE LED LIGHTING UPGRADE,cpd11-20bk.pdf
BEDSTLIG,DOT BEDFORD HISTORIC LIGHT RESTORATION,841,DEPARTMENT OF TRANSPORTATION,INSTALLATION OF LAMPPOSTS AND LUMINAIRES,300,BROOKLYN,TF-K503,500,0,0,0,0,500,0,0,500,0,0,0,0,500,0,0,500,0,0,0,0,1000,0,0,1000,PROJECT DELAYED DUE TO BUDGETARY CONSTRAINTS,,DOT BEDFORD HISTORIC DISTRICT LIGHTING RESTORATION,cpd11-20bk.pdf
BKBRDGCAM,Brooklyn Bridge Surveillance Cameras,841,DEPARTMENT OF TRANSPORTATION,SIGNAL INSTALLATION AND COMPUTERIZATION,300,BROOKLYN,TF-0001,13447,8844,0,0,500,500,1209,2394,13447,8844,0,0,500,500,1209,2394,13447,17688,0,0,1000,1000,2418,4788,26894,PROJECT DELAYED DUE TO BUDGETARY CONSTRAINTS,,CAMERAS INSTALLATION FOR BROOKLYN BRIDGE,cpd11-20bk.pdf
BKBRDGITS,Brooklyn Bridge Approaches-DOT ITS,841,DEPARTMENT OF TRANSPORTATION,SIGNAL INSTALLATION AND COMPUTERIZATION,300,BROOKLYN,TF-0001,2276,802,150,200,0,0,0,1124,2276,802,150,200,0,0,0,1124,2276,1604,300,400,0,0,0,2248,4552,PROJECT DELAYED DUE TO BUDGETARY CONSTRAINTS,,ITS FOR BROOKLYN BRIDGE APPROACHES,cpd11-20bk.pdf
HBK1023,MILL BASIN BR / BELT PARKWAY #2-23147-9/TN,841,DEPARTMENT OF TRANSPORTATION,FAIR BRIDGES,318,BROOKLYN,HB-1023,228336,139736,250,257,0,0,0,0,140243,139736,250,257,0,0,0,0,140243,279472,500,514,0,0,0,0,280486,PROJECT DELAYED DUE TO BUDGETARY CONSTRAINTS,"MILL BASIN BR/BELT PARKWAY, BROOKLYN",RECONSTRUCTION AND REHABILITATION OF THE MILL BASIN BR/ BELT PARKWAY BREPLACEMENT OF,cpd11-20bk.pdf
HBK1201,ATLANTIC AVENUE/LIRR ATLANTIC AVENUE 2-243569,841,DEPARTMENT OF TRANSPORTATION,FAIR BRIDGES,302 303 308 316,BROOKLYN,HB-1201,138276,38275,3287,532,0,0,0,0,42094,38275,3287,532,0,0,0,0,42094,76550,6574,1064,0,0,0,0,84188,PROJECT DELAYED DUE TO BUDGETARY CONSTRAINTS,ATLANTIC AVENUE LIRR,ATLANTIC AVENUE/LIRR,cpd11-20bk.pdf
HBK1205,"RECON OF 5TH AVE BRIDGE OVER LIRR AND SEA BEACH, BR 2-243580",841,DEPARTMENT OF TRANSPORTATION,FAIR BRIDGES,307 310,BROOKLYN,HB-1205 HB-1012,12977,6918,6600,41961,361,0,0,0,55840,6918,6600,41961,361,0,0,0,55840,13836,13200,83922,722,0,0,0,111680,PROJECT DELAYED DUE TO CHANGES IN SCOPE/DESIGN,"RECONS OF 5TH AVE BR OVER LIRR/SEA BEACH, BROOKLYN","RECONS OF 5TH AVE BR OVER LIRR/SEA BEACH, BROOKLYN",cpd11-20bk.pdf
HBK1213,"RECON UNION ST BRIDGE OVER GOWANUS CANAL, BROOKLYN 2-24027-0",841,DEPARTMENT OF TRANSPORTATION,BRIDGE LIFE EXTENSION AND MISCELLANEOUS WORK,306,BROOKLYN,HB-1213,69010,3654,0,0,0,0,0,47871,51525,3654,0,0,0,0,0,47871,51525,7308,0,0,0,0,0,95742,103050,PROJECT DELAYED DUE TO CHANGES IN SCOPE/DESIGN,"RECONSTRUCT UNION STREET BRIDGE OVER GOWANUS CANAL, BROOKLYN","RECONSTRUCT UNION STREET BRIDGE OVER GOWANUS CANAL, BROOKLYN",cpd11-20bk.pdf
HBK244120,HILL DR (TERRACE BR) OVER PROSPECT PARK LAKE BIN,841,DEPARTMENT OF TRANSPORTATION,BRIDGE LIFE EXTENSION AND MISCELLANEOUS WORK,300,BROOKLYN,P-0508,27776,1260,0,1253,1068,0,24572,0,28153,1260,0,1253,1068,0,24572,0,28153,2520,0,2506,2136,0,49144,0,56306,,,HILL DR (TERRACE BR) OVER PROSPECT PARK LAKE BIN 2244120,cpd11-20bk.pdf
HBK4470,SEELY STREET OVER PROSPECT AVENUE BIN,841,DEPARTMENT OF TRANSPORTATION,BRIDGE LIFE EXTENSION AND MISCELLANEOUS WORK,300,BROOKLYN,HB-1070 HB-0215,15815,2158,0,1551,0,27512,0,0,31221,2158,0,1551,0,27512,0,0,31221,4316,0,3102,0,55024,0,0,62442,PROJECT DELAYED DUE TO BUDGETARY CONSTRAINTS,,SEELY STREET OVER PROSPECT AVENUE BIN,cpd11-20bk.pdf
HBK530,PARKSIDE AVE AND OCEAN AVE RR BR #2-24302-0,841,DEPARTMENT OF TRANSPORTATION,FAIR BRIDGES,309 314,BROOKLYN,HB-0530,18056,8771,0,0,0,50640,0,0,59411,8771,0,0,0,50640,0,0,59411,17542,0,0,0,101280,0,0,118822,PROJECT DELAYED DUE TO BUDGETARY CONSTRAINTS,,"REHABILITATION OF THE PARKSIDE AVE AND OCEAN AVE RR BR REPLACEMENT OF, INCLUSIVE OF ANY",cpd11-20bk.pdf
HBKA23036,UNION ST OVER 278I BQE BIN 2230360,841,DEPARTMENT OF TRANSPORTATION,FAIR BRIDGES,300,BROOKLYN,HB-1012 HB-0215,17111,0,0,1316,0,1974,0,13821,17111,0,0,1316,0,1974,0,13821,17111,0,0,2632,0,3948,0,27642,34222,,UNION ST OVER 278I BQE BIN 2230360,UNION ST OVER 278I BQE BIN 2230360,cpd11-20bk.pdf
HBKA23038,KANE ST/ 278I (BQE) BIN# 2230380,841,DEPARTMENT OF TRANSPORTATION,FAIR BRIDGES,300,BROOKLYN,HB-3038,17456,1029,0,806,0,16113,0,0,17948,1029,0,806,0,16113,0,0,17948,2058,0,1612,0,32226,0,0,35896,PROJECT DELAYED DUE TO BUDGETARY CONSTRAINTS,KANE ST/ 278I (BQE) BIN# 2230380,KANE ST/ 278I (BQE) BIN# 2230380,cpd11-20bk.pdf
HBKA23140,BSHP over Sheepshead Bay Road BIN 2231409,841,DEPARTMENT OF TRANSPORTATION,FAIR BRIDGES,300,BROOKLYN,HB-1012,21822,0,768,1047,20076,0,0,0,21891,0,768,1047,20076,0,0,0,21891,0,1536,2094,40152,0,0,0,43782,PROJECT DELAYED DUE TO BUDGETARY CONSTRAINTS,,BSHP OVER SHEEPSHEAD BAY ROAD BIN 22331409,cpd11-20bk.pdf
HBKA23141,BSHP over Ocean Ave BIN 2231419,841,DEPARTMENT OF TRANSPORTATION,FAIR BRIDGES,300,BROOKLYN,HB-1012,43739,0,1436,2755,43239,0,0,0,47430,0,1436,2755,43239,0,0,0,47430,0,2872,5510,86478,0,0,0,94860,PROJECT DELAYED DUE TO BUDGETARY CONSTRAINTS,,BSHP OVER OCEAN AVE BIN 2231419,cpd11-20bk.pdf
HBKA23142,BSHP OVER BEDFORD AVE BIN 2231429,841,DEPARTMENT OF TRANSPORTATION,FAIR BRIDGES,300,BROOKLYN,HB-1012 HB-0215,41069,0,1264,2395,36330,0,0,0,39989,0,1264,2395,36330,0,0,0,39989,0,2528,4790,72660,0,0,0,79978,,BSHP OVER BEDFORD AVE BIN 2231429,BSHP OVER BEDFORD AVE BIN 2231429,cpd11-20bk.pdf
HBKA23143,Belt Shore Pkwy over Nostrand Ave 2231439,841,DEPARTMENT OF TRANSPORTATION,FAIR BRIDGES,300,BROOKLYN,HB-1090,48468,0,1476,2714,42433,0,0,0,46623,0,1476,2714,42433,0,0,0,46623,0,2952,5428,84866,0,0,0,93246,,BELT SHORE PKWY OVER NOSTRAND AVE 2231439,BELT SHORE PKWAY OVER NOSTRAND AVE 2231439,cpd11-20bk.pdf
HBKA23308,E 14TH ST PED BRIDGE BIN,841,DEPARTMENT OF TRANSPORTATION,FAIR BRIDGES,300,BROOKLYN,HB-1012 HB-1028,22037,1505,0,1018,2543,17799,0,0,22865,1505,0,1018,2543,17799,0,0,22865,3010,0,2036,5086,35598,0,0,45730,,E 14TH ST PED BRIDGE BIN,E 14TH ST PED BRIDGE BIN,cpd11-20bk.pdf
HBKA24310,"Beverly Road over BMT Subway, Brighton BIN 2243100",841,DEPARTMENT OF TRANSPORTATION,FAIR BRIDGES,300,BROOKLYN,HB-4310,47202,1714,2786,0,0,43702,0,0,48202,1714,2786,0,0,43702,0,0,48202,3428,5572,0,0,87404,0,0,96404,PROJECT DELAYED DUE TO BUDGETARY CONSTRAINTS,"BEVERLY ROAD OVER BMT SUBWAY, BRIGHTON BIN 2243100","BEVERLY ROAD OVER BMT SUBWAY, BRIGHTON BIN 2243100",cpd11-20bk.pdf
HBKA24382,21st Ave RR BR & 64th St #2-24382-1/TN35190,841,DEPARTMENT OF TRANSPORTATION,FAIR BRIDGES,300,BROOKLYN,HB-0061 HB-0548,110900,0,0,16338,0,0,6000,89062,111400,0,0,16338,0,0,6000,89062,111400,0,0,32676,0,0,12000,178124,222800,PROJECT DELAYED DUE TO BUDGETARY CONSTRAINTS,21ST AVE RR BR & 64TH ST #2-24382-1/TN35190,21ST AVE RR BR & 64TH ST #2-24382-1/TN35190,cpd11-20bk.pdf
HBPK17K,17TH AVENUE PEDESTRIAN BRIDGE OVER BELT PARKWAY 2231300,841,DEPARTMENT OF TRANSPORTATION,FAIR BRIDGES,310,BROOKLYN,P-0956,8006,3471,18942,5927,0,0,0,0,28340,3471,18942,5927,0,0,0,0,28340,6942,37884,11854,0,0,0,0,56680,PROJECT DELAYED DUE TO BUDGETARY CONSTRAINTS,17TH STREET PEDESTRIAN BRIDGE,17TH STREET PEDESTRIAN BRIDGE,cpd11-20bk.pdf
HBPK27K,27TH AVENUE PEDESTRIAN BRIDGE OVER BELT PARKWAY,841,DEPARTMENT OF TRANSPORTATION,FAIR BRIDGES,313,BROOKLYN,P-0507,7473,2267,19444,5859,0,0,0,0,27570,2267,19444,5859,0,0,0,0,27570,4534,38888,11718,0,0,0,0,55140,PROJECT DELAYED DUE TO BUDGETARY CONSTRAINTS,27TH AVENUE PEDESTRIAN BRIDGE,27TH AVENUE PEDESTRIAN BRIDGE,cpd11-20bk.pdf
HW349LUM,IN-HOUSE RESURFACING LUMP SUM - ASPHALT,841,DEPARTMENT OF TRANSPORTATION,PRIMARY STREET RESURFACING,399,BROOKLYN,HW-D101 HW-D103 HW-D105 HW-0349 HW-D102,251043,732281,28917,40220,32253,34687,35832,155839,1060029,732281,28917,40220,32253,34687,35832,155839,1060029,1464562,57834,80440,64506,69374,71664,311678,2120058,PROJECT DELAYED DUE TO BUDGETARY CONSTRAINTS,,RESURFACING ROADWAYS,cpd11-20bk.pdf
HWCSCH98,East 98th Street School Safety Improvements,841,DEPARTMENT OF TRANSPORTATION,PRIMARY STREET RECONSTRUCTION,300,BROOKLYN,HW-0001K,6053,0,0,0,0,0,0,6053,6053,0,0,0,0,0,0,6053,6053,0,0,0,0,0,0,12106,12106,PROJECT DELAYED DUE TO BUDGETARY CONSTRAINTS,EAST 98TH STREET SCHOOL SAFETY IMPROVEMENTS,EAST 98TH STREET SCHOOL SAFETY IMPROVEMENTS,cpd11-20bk.pdf
HWD10109,JORALEMON STREET IMPROVEMENTS,841,DEPARTMENT OF TRANSPORTATION,PRIMARY STREET RECONSTRUCTION,300,BROOKLYN,HW-D101,150,0,0,0,0,0,150,0,150,0,0,0,0,0,150,0,150,0,0,0,0,0,300,0,300,PROJECT DELAYED DUE TO BUDGETARY CONSTRAINTS,JORALEMON STREET,JORALEMON STREET IMPROVEMENTS,cpd11-20bk.pdf
HWD10110,Strickland Avenue - Reconstruction,841,DEPARTMENT OF TRANSPORTATION,PRIMARY STREET RECONSTRUCTION,300,BROOKLYN,HW-D101,100,0,0,0,0,0,100,0,100,0,0,0,0,0,100,0,100,0,0,0,0,0,200,0,200,PROJECT DELAYED DUE TO BUDGETARY CONSTRAINTS,STRICKLAND AVENUE - RECONSTRUCTION,STRICKLAND AVENUE - RECONSTRUCTION,cpd11-20bk.pdf
HWD10111,Intersection Safety Improvements Ocean Parkway & Ave Z,841,DEPARTMENT OF TRANSPORTATION,PRIMARY STREET RECONSTRUCTION,300,BROOKLYN,HW-D101,500,0,0,0,0,0,500,0,500,0,0,0,0,0,500,0,500,0,0,0,0,0,1000,0,1000,PROJECT DELAYED DUE TO BUDGETARY CONSTRAINTS,INTERSECTION SAFETY IMPROVEMENTS OCEAN PARKWAY & AVE Z,INTERSECTION SAFETY IMPROVEMENTS OCEAN PARKWAY & AVE Z,cpd11-20bk.pdf
HWD10113,Street Reconstruction in Community Board 14,841,DEPARTMENT OF TRANSPORTATION,PRIMARY STREET RECONSTRUCTION,300,BROOKLYN,HW-D101,500,0,0,0,0,0,500,0,500,0,0,0,0,0,500,0,500,0,0,0,0,0,1000,0,1000,PROJECT DELAYED DUE TO BUDGETARY CONSTRAINTS,STREET RECONSTRUCTION IN COMMUNITY BOARD 14,STREET RECONSTRUCTION IN COMMUNITY BOARD 14,cpd11-20bk.pdf
HWD10115,Safety Improvements Broadway Corridor,841,DEPARTMENT OF TRANSPORTATION,PRIMARY STREET RECONSTRUCTION,300,BROOKLYN,HW-D101,235,0,0,0,0,0,235,0,235,0,0,0,0,0,235,0,235,0,0,0,0,0,470,0,470,PROJECT DELAYED DUE TO BUDGETARY CONSTRAINTS,SAFETY IMPROVEMENTS BROADWAY CORRIDOR,SAFETY IMPROVEMENTS BROADWAY CORRIDOR,cpd11-20bk.pdf
HWD10119,PS 92 SIDE WALK EXTENSION,841,DEPARTMENT OF TRANSPORTATION,SIDEWALK RECONSTRUCTION,300,BROOKLYN,HW-D101,200,0,0,0,0,0,200,0,200,0,0,0,0,0,200,0,200,0,0,0,0,0,400,0,400,PROJECT DELAYED DUE TO BUDGETARY CONSTRAINTS,,PS 92 SIDE WALK EXTENSION,cpd11-20bk.pdf
HWK00502,8th Avenue Sunset Park Chinatown Archway,841,DEPARTMENT OF TRANSPORTATION,PRIMARY STREET RECONSTRUCTION,300,BROOKLYN,TF-K005,1000,129,0,0,0,0,0,1871,2000,129,0,0,0,0,0,1871,2000,258,0,0,0,0,0,3742,4000,PROJECT DELAYED DUE TO BUDGETARY CONSTRAINTS,8TH AVENUE SUNSET PARK CHINATOWN ARCHWAY,8TH AVENUE SUNSET PARK CHINATOWN ARCHWAY,cpd11-20bk.pdf
HWK00503,BQ Green,841,DEPARTMENT OF TRANSPORTATION,PRIMARY STREET RECONSTRUCTION,300,BROOKLYN,HW-K005,1000,0,0,0,0,0,0,2000,2000,0,0,0,0,0,0,2000,2000,0,0,0,0,0,0,4000,4000,PROJECT DELAYED DUE TO BUDGETARY CONSTRAINTS,BQ GREEN,BQ GREEN,cpd11-20bk.pdf
HWK00504,Atlantic Avenue - Purchase of WalkNYC Signs,841,DEPARTMENT OF TRANSPORTATION,PRIMARY STREET RECONSTRUCTION,300 302,BROOKLYN,HW-K005,35,0,0,0,0,0,35,0,35,0,0,0,0,0,35,0,35,0,0,0,0,0,70,0,70,PROJECT DELAYED DUE TO BUDGETARY CONSTRAINTS,,"ATLANTIC AVENUE DISTRICT MANAGEMENT ASSOCIATION, INC.",cpd11-20bk.pdf
HWK00512,Little Red Riding Hood Pre-K Sidewalk Extension,841,DEPARTMENT OF TRANSPORTATION,PRIMARY STREET RECONSTRUCTION,300,BROOKLYN,HW-K005,100,0,0,0,0,0,100,0,100,0,0,0,0,0,100,0,100,0,0,0,0,0,200,0,200,PROJECT DELAYED DUE TO BUDGETARY CONSTRAINTS,LITTLE RED RIDING HOOD PRE-K SIDEWALK EXTENSION,LITTLE RED RIDING HOOD PRE-K SIDEWALK EXTENSION,cpd11-20bk.pdf
HWK00514,Brooklyn Greenway,841,DEPARTMENT OF TRANSPORTATION,PRIMARY STREET RECONSTRUCTION,,BROOKLYN,HW-K005 HW-0001K HW-D101,2300,0,0,0,0,0,0,2300,2300,0,0,0,0,0,0,2300,2300,0,0,0,0,0,0,4600,4600,PROJECT DELAYED DUE TO BUDGETARY CONSTRAINTS,,BIKE LANE CONSTRUCTION,cpd11-20bk.pdf
HWK1669B,4th Ave Safety Improvements - Phase B,841,DEPARTMENT OF TRANSPORTATION,PRIMARY STREET RECONSTRUCTION,300,BROOKLYN,HW-0001K,30000,203,0,0,0,0,143209,0,143412,203,0,0,0,0,143209,0,143412,406,0,0,0,0,286418,0,286824,PROJECT DELAYED DUE TO BUDGETARY CONSTRAINTS,4TH AVE SAFETY IMPROVEMENTS PHASE B - ATLANTIC AVENUE TO 8TH ST,4TH AVE SAFETY IMPROVEMENTS PHASE B - ATLANTIC AVENUE TO 8TH ST,cpd11-20bk.pdf
HWK1673,South Brooklyn Pedestrian and Bicycle Safety Improvements,841,DEPARTMENT OF TRANSPORTATION,PRIMARY STREET RECONSTRUCTION,300,BROOKLYN,HW-D101 HW-0001K HW-K005,15938,0,50,0,0,0,16038,0,16088,0,50,0,0,0,16038,0,16088,0,100,0,0,0,32076,0,32176,PROJECT DELAYED DUE TO BUDGETARY CONSTRAINTS,SOUTH BROOKLYN PEDESTRIAN AND BICYCLE SAFETY IMPROVEMENTS,SOUTH BROOKLYN PEDESTRIAN AND BICYCLE SAFETY IMPROVEMENTS,cpd11-20bk.pdf
HWK1674,Flatbush Avenue Downtown Brooklyn Safety Improvements,841,DEPARTMENT OF TRANSPORTATION,PRIMARY STREET RECONSTRUCTION,300,BROOKLYN,HW-D101 HW-0001K,22563,0,300,0,0,0,22563,0,22863,0,300,0,0,0,22563,0,22863,0,600,0,0,0,45126,0,45726,PROJECT DELAYED DUE TO BUDGETARY CONSTRAINTS,FLATBUSH AVENUE DOWNTOWN BROOKLYN SAFETY IMPROVEMENTS,FLATBUSH AVENUE DOWNTOWN BROOKLYN SAFETY IMPROVEMENTS,cpd11-20bk.pdf
HWKF029Z,FLATLANDS YARD AND STRUCTURES REHABILITATION,841,DEPARTMENT OF TRANSPORTATION,FACILITY RECONSTRUCTION,318,BROOKLYN,HW-0003,11545,0,0,0,0,0,0,11545,11545,0,0,0,0,0,0,11545,11545,0,0,0,0,0,0,23090,23090,PROJECT DELAYED DUE TO BUDGETARY CONSTRAINTS,FLATLANDS YARD AND STRUCTURES REHABILITATION,REBUILD EXISTING 23000 SQ OF GARAGE AND AUTO REPAIR SHOP SPACE,cpd11-20bk.pdf
HWKF2514,25 14th St Fleet Services Shop Rehabilitation,841,DEPARTMENT OF TRANSPORTATION,FACILITY RECONSTRUCTION,300,BROOKLYN,HW-0003,3300,0,300,3000,0,0,0,0,3300,0,300,3000,0,0,0,0,3300,0,600,6000,0,0,0,0,6600,PROJECT DELAYED DUE TO BUDGETARY CONSTRAINTS,,25 14TH ST FLEET SERVICES SHOP REHABILITATION,cpd11-20bk.pdf
HWP19KTA,Complex Pedestrian Ramps - Landmark Installation,841,DEPARTMENT OF TRANSPORTATION,PEDESTRIAN RAMP CONSTRUCTION,300,BROOKLYN,HW-0200,2734,0,0,0,0,2734,0,0,2734,0,0,0,0,2734,0,0,2734,0,0,0,0,5468,0,0,5468,PROJECT DELAYED DUE TO BUDGETARY CONSTRAINTS,COMPLEX PEDESTRIAN RAMPS - LANDMARK INSTALLATION,COMPLEX PEDESTRIAN RAMPS - LANDMARK INSTALLATION,cpd11-20bk.pdf
HWS2021K1,PRIOR NOTICE SIDEWALK - BROOKLYN,841,DEPARTMENT OF TRANSPORTATION,SIDEWALK RECONSTRUCTION,300,BROOKLYN,HW-0200 P-1331,9877,0,7963,0,0,0,0,0,7963,0,7963,0,0,0,0,0,7963,0,15926,0,0,0,0,0,15926,PROJECT DELAYED DUE TO BUDGETARY CONSTRAINTS,PRIOR NOTICE SIDEWALKS,PRIOR NOTICE SIDEWALKS,cpd11-20bk.pdf
HWS2021K2,PRIOR NOTICE SIDEWALK - BROOKLYN,841,DEPARTMENT OF TRANSPORTATION,SIDEWALK RECONSTRUCTION,300,BROOKLYN,P-1331,727,0,727,0,0,0,0,0,727,0,727,0,0,0,0,0,727,0,1454,0,0,0,0,0,1454,,PRIOR NOTICE SIDEWALK - BROOKLYN,PRIOR NOTICE SIDEWALK - BROOKLYN,cpd11-20bk.pdf
SANDBULK1,Reconstruction of Bay & Corbin Bulkheads - Hurricane Sandy,841,DEPARTMENT OF TRANSPORTATION,PRIMARY STREET RECONSTRUCTION,300,BROOKLYN,HW-0001K,801,0,0,0,0,81,0,0,81,0,0,0,0,81,0,0,81,0,0,0,0,162,0,0,162,PROJECT DELAYED DUE TO BUDGETARY CONSTRAINTS,BAY PARKWAY AND CORBIN PLACE IN BROOKLYN,RECONSTRUCTION OF BAY PARKWAY AND CORBIN PLACE BULKHEADS - HURRICANE SANDY,cpd11-20bk.pdf
TF18-2017,AVENUE M MUNICIPAL PARKING FIELD,841,DEPARTMENT OF TRANSPORTATION,"Parking Meters, Lots, and Garages",300 314,BROOKLYN,TF-0018,570,0,0,0,0,0,0,218,218,0,0,0,0,0,0,218,218,0,0,0,0,0,0,436,436,PROJECT DELAYED DUE TO BUDGETARY CONSTRAINTS,,RECON OF PARKING FIELD,cpd11-20bk.pdf
TF50311,Rpl St lg pl Bedford Ave fm Campus Rd to Foster Ave-XMA165.3,841,DEPARTMENT OF TRANSPORTATION,INSTALLATION OF LAMPPOSTS AND LUMINAIRES,300,BROOKLYN,TF-0503,254,0,0,0,0,0,0,0,0,0,0,0,0,0,0,0,0,0,0,0,0,0,0,0,0,PROJECT DELAYED DUE TO BUDGETARY CONSTRAINTS,,REPLACEMENT OF STANDARD STREET LIGHTING WITH BC TYPE LAMP POSTS ON BEDFORD AVENUE,cpd11-20bk.pdf
TF50313,Instl lg on Cortelyou Rd&Newkirk XMA193.30 & A835,841,DEPARTMENT OF TRANSPORTATION,INSTALLATION OF LAMPPOSTS AND LUMINAIRES,300,BROOKLYN,TF-0503,400,0,0,0,0,0,0,0,0,0,0,0,0,0,0,0,0,0,0,0,0,0,0,0,0,PROJECT DELAYED DUE TO BUDGETARY CONSTRAINTS,,FURNISH AND INSTALL LIGHT ON CORTELYOU RD & NEWKIRK AVENUE BETWEEN CONEY ISLAND AVE,cpd11-20bk.pdf
TF50315,"Historic St lg poles on Mermaid Avenue bet W21St &W29th St,",841,DEPARTMENT OF TRANSPORTATION,INSTALLATION OF LAMPPOSTS AND LUMINAIRES,300,BROOKLYN,TF-0503,400,0,0,0,0,400,0,0,400,0,0,0,0,400,0,0,400,0,0,0,0,800,0,0,800,,,,cpd11-20bk.pdf
TF50317,"Upgrade of poles & lg on McDonald Ave, bet Ave R&KingH",841,DEPARTMENT OF TRANSPORTATION,INSTALLATION OF LAMPPOSTS AND LUMINAIRES,300,BROOKLYN,TF-0503,888,0,388,0,0,0,0,0,388,0,388,0,0,0,0,0,388,0,776,0,0,0,0,0,776,PROJECT DELAYED DUE TO BUDGETARY CONSTRAINTS,,UPGRADE ST LG POLES,cpd11-20bk.pdf
TFD503K23,BROOKLYN HEIGHTS HISTORIC LIGHTING,841,DEPARTMENT OF TRANSPORTATION,INSTALLATION OF LAMPPOSTS AND LUMINAIRES,300 302,BROOKLYN,TF-D503,250,444,0,0,0,397,17,0,858,444,0,0,0,397,17,0,858,888,0,0,0,794,34,0,1716,PROJECT DELAYED DUE TO BUDGETARY CONSTRAINTS,BROOKLYN HEIGHT HISTORIC LIGHTING,BROOKLYN HEIGHT HISTORIC LIGHTING,cpd11-20bk.pdf
TFD503K26,FLATBUSH AVE. ST. PURCHASE AND INSTALLATION OF LAMP POST,841,DEPARTMENT OF TRANSPORTATION,INSTALLATION OF LAMPPOSTS AND LUMINAIRES,300,BROOKLYN,TF-D503,450,345,0,0,0,125,0,0,470,345,0,0,0,125,0,0,470,690,0,0,0,250,0,0,940,PROJECT DELAYED DUE TO BUDGETARY CONSTRAINTS,FLATBUSH AVE. ST. PURCHASE AND INSTALLATION OF LAMP POST,FLATBUSH AVE. ST. PURCHASE AND INSTALLATION OF LAMP POST,cpd11-20bk.pdf
TFK50313,Historic Lighting on Broadway btw Roebling and Bedford,841,DEPARTMENT OF TRANSPORTATION,INSTALLATION OF LAMPPOSTS AND LUMINAIRES,300 301,BROOKLYN,TF-K503,290,0,0,0,0,290,0,0,290,0,0,0,0,290,0,0,290,0,0,0,0,580,0,0,580,PROJECT DELAYED DUE TO BUDGETARY CONSTRAINTS,HISTORIC LIGHTING ON BROADWAY BTW ROEBLING AND BEDFORD,THE WILLIAMSBURG SAVINGS BANK - 175 BROADWAY HOSPITALITY LLC HAS AGREED TO A,cpd11-20bk.pdf
TFKVANDMD,VANDERBILT AVE MERCHANTS DISTRICT/PHNDC,841,DEPARTMENT OF TRANSPORTATION,INSTALLATION OF LAMPPOSTS AND LUMINAIRES,,BROOKLYN,TF-K503,615,549,0,0,0,70,0,0,619,549,0,0,0,70,0,0,619,1098,0,0,0,140,0,0,1238,PROJECT DELAYED DUE TO BUDGETARY CONSTRAINTS,,ELEGANT STREET LIGHTING FOR VANDERBILT AVE MERCHANTS DISTRICT,cpd11-20bk.pdf
TFLGAVEU,St Lg on Ave U from Ocean Pkwy to McDonald Ave XMA206.30A,841,DEPARTMENT OF TRANSPORTATION,INSTALLATION OF LAMPPOSTS AND LUMINAIRES,300,BROOKLYN,TF-0503,508,0,0,0,0,0,0,0,0,0,0,0,0,0,0,0,0,0,0,0,0,0,0,0,0,PROJECT DELAYED DUE TO BUDGETARY CONSTRAINTS,,FURNISH AND INSTALL ST LIGHT ON AVENUE U,cpd11-20bk.pdf
BKPARK,BROOKLYN BRIDGE PARK - PHASE I BG-38150-101M,846,DEPT OF PARKS AND RECREATION,WATERFRONT DEVELOPMENT,302,BROOKLYN,ED-0075,6840,6782,0,0,0,0,52,0,6834,6782,0,0,0,0,52,0,6834,13564,0,0,0,0,104,0,13668,,BROOKLYN BRIDGE PARK - PARKS PHASE I,BROOKLYN BRIDGE PARK - PARKS PROJECT PHASE I,cpd11-20bk.pdf
GKBKGI-01,GI - DSGN & CONS OF PARKLAND RETROFITS IN BROOKLYN,846,DEPT OF PARKS AND RECREATION,GREEN INFRASTRUCTURE PROGRAM,300,BROOKLYN,WP-0169,3155,523,0,2391,0,0,0,0,2914,523,0,2391,0,0,0,0,2914,1046,0,4782,0,0,0,0,5828,,,GI - DSGN & CONS OF PARKLAND RETROFITS IN BROOKLYN,cpd11-20bk.pdf
GKBKGI-02,GI - CONS OF BROOKLYN PARKLAND RETROFITS FY20RP,846,DEPT OF PARKS AND RECREATION,GREEN INFRASTRUCTURE PROGRAM,300,BROOKLYN,WP-0169 P-D017,1911,114,14,463,0,0,0,0,591,114,14,463,0,0,0,0,591,228,28,926,0,0,0,0,1182,PROJECT DELAYED DUE TO CHANGES IN SCOPE/DESIGN,BROOKLYN,GI - CONS OF BROOKLYN PARKLAND RETROFITS FY20,cpd11-20bk.pdf
NDF-CLNE,NDF- East New York - City Line Park,846,DEPT OF PARKS AND RECREATION,NEIGHBORHOOD PARKS AND PLAYGROUNDS,305,BROOKLYN,ED-0384,7092,4890,720,0,0,0,0,0,5610,4890,720,0,0,0,0,0,5610,9780,1440,0,0,0,0,0,11220,,"ATLANTIC AVENUE, BETWEEN FOUNTAIN AVENUE AND NORTH CONDUIT AVENUE",NEIGHBORHOOD DEVELOPMENT FUND - CITY LINE PARK,cpd11-20bk.pdf
NDF-CLNKY,NDF - Callahan-Kelly Park (B219-117M),846,DEPT OF PARKS AND RECREATION,NEIGHBORHOOD REVITALIZATION,300,BROOKLYN,ED-0384 P-0245K,18893,2908,17071,3597,0,0,0,0,23576,2908,17071,3597,0,0,0,0,23576,5816,34142,7194,0,0,0,0,47152,,,CALAHAN KELLY PARK,cpd11-20bk.pdf
NDF-HLDN3,NDF - Highland Park Eastern Playground R/C Q020-119M,846,DEPT OF PARKS AND RECREATION,"LARGE, MAJOR AND REGIONAL PARK RECONSTRUCTION",300,BROOKLYN,ED-0384,8707,50,7807,0,0,0,0,0,7857,50,7807,0,0,0,0,0,7857,100,15614,0,0,0,0,0,15714,,,"RECONSTRUCTION OF THE EASTERN PLAYGROUND AT HIGHLAND PARK, BOROUGH OFKINGS",cpd11-20bk.pdf
NDF-HLDN4,NDF - Highland Park Comfort Station R/C Q020-219M,846,DEPT OF PARKS AND RECREATION,"LARGE, MAJOR AND REGIONAL PARK RECONSTRUCTION",300,BROOKLYN,ED-0384,2600,75,1974,0,0,0,0,0,2049,75,1974,0,0,0,0,0,2049,150,3948,0,0,0,0,0,4098,,,"RECONSTRUCTION OF THE COMFORT STATION AT HIGHLAND PARK, BOROUGH OF KINGS",cpd11-20bk.pdf
NDF-HLDN5,NDF - Highland Park Pedestrian Improvements Q020-118M,846,DEPT OF PARKS AND RECREATION,"LARGE, MAJOR AND REGIONAL PARK RECONSTRUCTION",300,BROOKLYN,ED-0384,1170,942,94,0,0,0,0,0,1036,942,94,0,0,0,0,0,1036,1884,188,0,0,0,0,0,2072,PROJECT DELAYED DUE TO UNFORESEEN SITE/FIELD CONDITION,,"PEDESTRIAN IMPROVEMENTS ALONG HIGHLAND BOULEVARD, IN HIGHLAND PARK, BOROUGH OF",cpd11-20bk.pdf
NDF-HLND,Neighborhood Dev. Fund - East NY - Highland Park Q020-216M,846,DEPT OF PARKS AND RECREATION,NEIGHBORHOOD PARKS AND PLAYGROUNDS,305,BROOKLYN,ED-0384 P-D017 P-0896,3120,2788,1425,0,0,0,0,0,4213,2788,1425,0,0,0,0,0,4213,5576,2850,0,0,0,0,0,8426,,"JAMAICA AVENUE, CRESCENT STREET, CYPRESS HILLS - BOROUGH OF BROOKLYN",NEIGHBORHOOD DEVELOPMENT FUND - HIGHLAND PARK,cpd11-20bk.pdf
P-200CRSL,PPA- Recon. Carousel (B073-218M),846,DEPT OF PARKS AND RECREATION,"LARGE, MAJOR AND REGIONAL PARK RECONSTRUCTION",300 306 307 308 309 314,BROOKLYN,P-D017,500,168,422,0,0,0,0,0,590,168,422,0,0,0,0,0,590,336,844,0,0,0,0,0,1180,,"PROSPECT PARK WEST , PARKSIDE AVENUE, BETWEEN FLATBUSH AVENUE, OCEAN AVENUE AND",PROSPECT PARK - CAROUSEL RECONSTRUCTION,cpd11-20bk.pdf
P-200FITS,PPA- Prospect Park Fitness Playground/Equipment (B068-119M),846,DEPT OF PARKS AND RECREATION,"LARGE, MAJOR AND REGIONAL PARK RECONSTRUCTION",300,BROOKLYN,P-D017,1023,126,436,0,0,0,0,0,562,126,436,0,0,0,0,0,562,252,872,0,0,0,0,0,1124,,PROSPECT PARK PARADE GROUND,PROSPECT PARK PARADE GROUND - INSTALL ADULT FITNESS EQUIPMENT,cpd11-20bk.pdf
P-200HPPP,PPA - Harmony Playground Improvements B073-119M,846,DEPT OF PARKS AND RECREATION,"LARGE, MAJOR AND REGIONAL PARK RECONSTRUCTION",300,BROOKLYN,P-D017,532,132,748,0,0,0,0,0,880,132,748,0,0,0,0,0,880,264,1496,0,0,0,0,0,1760,,,INSTALL SHADE STRUCTURE OVER SANDBOX AND REPLACE NON WORKING PLAYGROUND STUCTURES,cpd11-20bk.pdf
P-200LFHH,PPA- Restor. Lefferts Historic House,846,DEPT OF PARKS AND RECREATION,"LARGE, MAJOR AND REGIONAL PARK RECONSTRUCTION",300 306 307 308 309 314,BROOKLYN,P-D017,2500,437,2463,0,0,0,0,0,2900,437,2463,0,0,0,0,0,2900,874,4926,0,0,0,0,0,5800,PROJECT DELAYED DUE TO CHANGES IN SCOPE/DESIGN,"PROSPECT PARK WEST, PARKSODE AVENUE, BETWEEN FLATBUSH AVENUE, OCEAN AVENUE AND",PROSPECT PARK - LEFFERTS HISTORIC HOUSE,cpd11-20bk.pdf
P-200LMBF,PPA Long Meadow Ballfields restoration 34 acre ballfield,846,DEPT OF PARKS AND RECREATION,NEIGHBORHOOD PARKS AND PLAYGROUNDS,300,BROOKLYN,P-D017 P-0412,1033,172,1418,0,0,0,0,0,1590,172,1418,0,0,0,0,0,1590,344,2836,0,0,0,0,0,3180,,,BALLFIELD,cpd11-20bk.pdf
P-200LONG,"PPA - LONG MEADOW BALLFIELDS RENOV, B073-214M",846,DEPT OF PARKS AND RECREATION,"LARGE, MAJOR AND REGIONAL PARK RECONSTRUCTION",306 307 308 309 314 300,BROOKLYN,P-D017,2836,2257,298,0,0,0,0,0,2555,2257,298,0,0,0,0,0,2555,4514,596,0,0,0,0,0,5110,PROJECT DELAYED DUE TO UNFORESEEN HAZARDOUS CONDITION,BROOKLYN,THE RENOVATION OF THE LONG MEADOW BALLFIELD IN PROSPECT PARK,cpd11-20bk.pdf
P-200PPBF,PROSP. PK. BASEBALL FIELDS-LONG MEADOWS (B073-211M),846,DEPT OF PARKS AND RECREATION,"LARGE, MAJOR AND REGIONAL PARK RECONSTRUCTION",300,BROOKLYN,P-D017,750,1330,21,0,32,0,0,0,1383,1330,21,0,32,0,0,0,1383,2660,42,0,64,0,0,0,2766,PROJECT DELAYED DUE TO UNFORESEEN SITE/FIELD CONDITION,BOROUGH OF BROOKLYN,RECONSTRUCT LONG MEADOWS BALLFIELDS AREA,cpd11-20bk.pdf
P-200PPBL,PPA- Long Meadow Ballfields 4-5 (B073-215M),846,DEPT OF PARKS AND RECREATION,"LARGE, MAJOR AND REGIONAL PARK RECONSTRUCTION",300 306 307 308 309 314,BROOKLYN,P-D017,750,1599,120,0,0,0,0,0,1719,1599,120,0,0,0,0,0,1719,3198,240,0,0,0,0,0,3438,,"PROSPECT PARK WEST, PARKSIDE AVENUE, BETWEEN FLATBUSH AVENUE, OCEAN AVENUE AND",PROSPECT PARK - LONG MEADOW,cpd11-20bk.pdf
P-200PPCS,Prospect Park,846,DEPT OF PARKS AND RECREATION,"LARGE, MAJOR AND REGIONAL PARK RECONSTRUCTION",306 307 308 309 314,BROOKLYN,P-D017,2250,0,0,2250,0,0,0,0,2250,0,0,2250,0,0,0,0,2250,0,0,4500,0,0,0,0,4500,,"PROSPECT PARK W, PARKSIDE AVE. BET. FLATBUSH AVE., OCEAN AVE. AND PROSPECT PARK SW,","RECONSTRUCTION OF COMFORT STATION IN PROSPECT PARK, BROOKLYN.",cpd11-20bk.pdf
P-200PPFB,PPA - Flatbush Avenue Park Perimeter B073-315M,846,DEPT OF PARKS AND RECREATION,"LARGE, MAJOR AND REGIONAL PARK RECONSTRUCTION",306 307 309 309 314,BROOKLYN,P-D017 P-K001 P-K011,400,2259,284,0,0,0,0,0,2543,2259,284,0,0,0,0,0,2543,4518,568,0,0,0,0,0,5086,PROJECT DELAYED DUE TO UNFORESEEN SITE/FIELD CONDITION,"PROSPECT PARK WEST, PARKSIDE AVENUE, BETWEEN FLATBUSH AVENUE, OCEAN AVENUE &",PROSPECT PARK ALLIANCE-FLATBUSH AVENUE PARK PERIMETER RESTORATION,cpd11-20bk.pdf
P-200PPMB,PPA-Building Reconstruction (B073-319M),846,DEPT OF PARKS AND RECREATION,"LARGE, MAJOR AND REGIONAL PARK RECONSTRUCTION",300,BROOKLYN,P-D017 P-0412,6093,498,1,349,2286,0,0,0,3134,498,1,349,2286,0,0,0,3134,996,2,698,4572,0,0,0,6268,,PROSPECT PARK- BOROUGH OF BROOKLYN,PROSPECT PARK BUILDING,cpd11-20bk.pdf
P-200PPMO,PPA- New M&O Facility & Compound in Prospect Park B073-415M,846,DEPT OF PARKS AND RECREATION,"LARGE, MAJOR AND REGIONAL PARK RECONSTRUCTION",306 307 308 309 314,BROOKLYN,P-D017 P-K001,2000,553,1437,3261,0,0,0,0,5251,553,1437,3261,0,0,0,0,5251,1106,2874,6522,0,0,0,0,10502,PROJECT DELAYED PENDING RESOLUTION OF LEGAL ISSUES,"PROSPECT PARK WEST, PARKSIDE AVENUE BETWEEN FLATBUSH AVENUE, OCEAN AVENUE, PROSPECT",PROSPECT PARK ALLIANCE - NEW MAINTENANCE AND OPERATIONS FACILITY AND COMPOUND IN,cpd11-20bk.pdf
P-200PPNM,Prospect Park Nethermead - Repave Walking Path,846,DEPT OF PARKS AND RECREATION,NEIGHBORHOOD PARKS AND PLAYGROUNDS,300 306 307 314 309 308,BROOKLYN,P-D017,535,0,100,400,0,0,0,0,500,0,100,400,0,0,0,0,500,0,200,800,0,0,0,0,1000,,"PROSPECT PARK W, PARKSIDE AVE. BET. FLATBUSH AVE., OCEAN AVE. AND PROSPECT PARK SW,",PROSPECT PARK NETHERMEAD - REPAVE WALKING PATH,cpd11-20bk.pdf
P-200PPOC,PROSPECT PARK ALLIANCE,846,DEPT OF PARKS AND RECREATION,"LARGE, MAJOR AND REGIONAL PARK RECONSTRUCTION",300,BROOKLYN,P-K011 HW-0001K P-K001 P-0412 HW-D101,1750,969,10455,0,0,0,0,0,11424,969,10455,0,0,0,0,0,11424,1938,20910,0,0,0,0,0,22848,,PPA-OCEAN AVENUE PERIMETER,PROSPECT PARK ALLIANCE,cpd11-20bk.pdf
P-200PPOP,PPA - Prospect Park Oriental Pavilion B073-416M,846,DEPT OF PARKS AND RECREATION,"LARGE, MAJOR AND REGIONAL PARK RECONSTRUCTION",300,BROOKLYN,P-D017 P-C412 P-K001 P-K011,2362,2250,226,0,0,0,0,0,2476,2250,226,0,0,0,0,0,2476,4500,452,0,0,0,0,0,4952,PROJECT DELAYED PENDING RESOLUTION OF LEGAL ISSUES,BOROUGH OF BROOKLYN,PROSPECT PARK,cpd11-20bk.pdf
P-200PPPH,PPA- PROSPECT PARK PICNIC HOUSE RENOVATION B073-419M,846,DEPT OF PARKS AND RECREATION,"LARGE, MAJOR AND REGIONAL PARK RECONSTRUCTION",306 307 308 309 314 300,BROOKLYN,P-K001 P-1018 P-C412,1000,173,566,0,0,0,0,0,739,173,566,0,0,0,0,0,739,346,1132,0,0,0,0,0,1478,PROJECT DELAYED DUE TO CHANGES IN SCOPE/DESIGN,BOROUGH OF BROOKLYN,INSTALLATION OF AIR CONDITIONING IN THE PICNIC HOUSE,cpd11-20bk.pdf
P-200SCMP,PPA- Parkside Ave. Streetscape Chisholm Monument,846,DEPT OF PARKS AND RECREATION,"LARGE, MAJOR AND REGIONAL PARK RECONSTRUCTION",300,BROOKLYN,PV-0467,0,0,1000,0,0,0,0,0,1000,0,1000,0,0,0,0,0,1000,0,2000,0,0,0,0,0,2000,,PROSPECT PARK - PARKSIDE AVENUE,PPA- SHIRLEY CHISHOLM MONUMENT PROJECT,cpd11-20bk.pdf
P-200STFP,PPA - Parade Ground replace turf field 9 (B068-118M),846,DEPT OF PARKS AND RECREATION,NEIGHBORHOOD PARKS AND PLAYGROUNDS,300,BROOKLYN,P-D017,1011,87,663,0,0,0,0,0,750,87,663,0,0,0,0,0,750,174,1326,0,0,0,0,0,1500,,,PARADE TURF,cpd11-20bk.pdf
P-200TNCR,PPA- Prospect Park Tennis Center,846,DEPT OF PARKS AND RECREATION,MAJOR RECREATIONAL FACILITIES AND FACILITY RECONSTRUCTION,300,BROOKLYN,P-D017,3150,0,3000,0,0,0,0,0,3000,0,3000,0,0,0,0,0,3000,0,6000,0,0,0,0,0,6000,,BOROUGH OF BROOKLYN,PROSPECT PARK TENNIS CENTER,cpd11-20bk.pdf
P-200WCST,PPA-WELLHOUSE COMFORT STATION RENOVATION - (B073-209M),846,DEPT OF PARKS AND RECREATION,"LARGE, MAJOR AND REGIONAL PARK RECONSTRUCTION",300 307,BROOKLYN,P-D017,900,2512,96,0,0,0,0,0,2608,2512,96,0,0,0,0,0,2608,5024,192,0,0,0,0,0,5216,PROJECT DELAYED PENDING RESOLUTION OF LEGAL ISSUES,"PROSPECT PARK, FLATBUSH, OCEAN",RENOVATION OF WELLHOUSE COMFORT STATION IN PROSPECT PARK,cpd11-20bk.pdf
P-200ZO10,Prospect Park Zoo - Renovation of Discovery Trail,846,DEPT OF PARKS AND RECREATION,ZOOS,309,BROOKLYN,P-D017 P-0884,337,0,908,0,0,0,0,0,908,0,908,0,0,0,0,0,908,0,1816,0,0,0,0,0,1816,PROJECT DELAYED DUE TO CHANGES IN SCOPE/DESIGN,"PROSPECT PARK, BOROUGH OF BROOKLYN",PROSPECT PARK ZOO - RECONSTRUCTION OF THE DISCOVERY TRAIL,cpd11-20bk.pdf
P-200ZO17,"PPZ- Building ""D"" Dome Restoration",846,DEPT OF PARKS AND RECREATION,ZOOS,300,BROOKLYN,P-0887 P-K011,164,0,1475,0,0,0,0,0,1475,0,1475,0,0,0,0,0,1475,0,2950,0,0,0,0,0,2950,,"PPZ- BUILDING""D"" DOME RESTORATION","PPZ- BUILDING""D"" DOME RESTORATION",cpd11-20bk.pdf
P-200ZO18,PPZ- Off exhibit primate holding expansion,846,DEPT OF PARKS AND RECREATION,ZOOS,300,BROOKLYN,P-0887,180,0,650,0,0,0,0,0,650,0,650,0,0,0,0,0,650,0,1300,0,0,0,0,0,1300,,PPZ- OFF EXHIBIT PRIMATE HOLDING EXPENSION,PPZ- OFF EXHIBIT PRIMATE HOLDING EXPENSION,cpd11-20bk.pdf
P-200ZO19,"PPZ- Central plaza stairs,benches reconstruction",846,DEPT OF PARKS AND RECREATION,ZOOS,300,BROOKLYN,P-0887,250,0,3450,4813,0,0,0,0,8263,0,3450,4813,0,0,0,0,8263,0,6900,9626,0,0,0,0,16526,,"PPZ- CENTRAL PLAZA STAIRS,BENCHES RECONSTRACTION","PPZ- CENTRAL PLAZA STAIRS,BENCHES RECONSTRACTION",cpd11-20bk.pdf
P-201D17B,"F.H. STERNBERG PARK BALLFIELDS RECONSTRUCTION, B055-104M",846,DEPT OF PARKS AND RECREATION,NEIGHBORHOOD PARKS AND PLAYGROUNDS,301,BROOKLYN,P-D017,1375,1195,140,0,0,0,0,0,1335,1195,140,0,0,0,0,0,1335,2390,280,0,0,0,0,0,2670,PROJECT DELAYED DUE TO UNFORESEEN SITE/FIELD CONDITION,"FRANCES HAMBURGER STERNBERG PARK, BROOKLYN, CB #1",F.H. STERNBERG PARK,cpd11-20bk.pdf
P-201EYCK,TEN EYCK PLAZA - RENOVATION OF THE PLAZA B386-119M,846,DEPT OF PARKS AND RECREATION,NEIGHBORHOOD PARKS AND PLAYGROUNDS,300,BROOKLYN,P-D017,591,211,0,0,1831,0,0,0,2042,211,0,0,1831,0,0,0,2042,422,0,0,3662,0,0,0,4084,PROJECT DELAYED PENDING RESOLUTION OF LEGAL ISSUES,,RENOVATION OF PLAZA,cpd11-20bk.pdf
P-201FROS,Frost Street Playground - Basketball Court Reconstruction,846,DEPT OF PARKS AND RECREATION,NEIGHBORHOOD PARKS AND PLAYGROUNDS,301,BROOKLYN,P-D017,1075,0,100,900,0,0,0,0,1000,0,100,900,0,0,0,0,1000,0,200,1800,0,0,0,0,2000,,"FROST ST. BET. DEBEVOISE AVE. AND KINGSLAND AVE., BROOKLYN",FROST STREET PLAYGROUND - BASKETBALL COURT RECONSTRUCTION,cpd11-20bk.pdf
P-201GROV,Grove St. Community Garden - Upgrade Play Equipment,846,DEPT OF PARKS AND RECREATION,NEIGHBORHOOD PARKS AND PLAYGROUNDS,301,BROOKLYN,P-D017,150,0,50,0,0,0,0,0,50,0,50,0,0,0,0,0,50,0,100,0,0,0,0,0,100,,"72 GROVE STREET, BROOKLYN NY 11221",GROVE ST. COMMUNITY GARDEN - UPGRADE PLAY EQUIPMENT,cpd11-20bk.pdf
P-201MCBH,McCarren -RC Bathhouse B058-117M,846,DEPT OF PARKS AND RECREATION,"LARGE, MAJOR AND REGIONAL PARK RECONSTRUCTION",300 301,BROOKLYN,P-1018,3090,1020,4,0,13278,0,0,0,14302,1020,4,0,13278,0,0,0,14302,2040,8,0,26556,0,0,0,28604,,"LOCATED N. 12 STREET, LORIMER STREET, MANHATTAN AVENUE, BETWEEN BAYARD STREET, AND",MCCARREN,cpd11-20bk.pdf
P-201MCC2,McCarren Park - Brooklyn,846,DEPT OF PARKS AND RECREATION,NEIGHBORHOOD PARKS AND PLAYGROUNDS,300,BROOKLYN,P-0819,6500,546,189,0,5590,0,0,0,6325,546,189,0,5590,0,0,0,6325,1092,378,0,11180,0,0,0,12650,,,MCCARREN PARK - BROOKLYN,cpd11-20bk.pdf
P-201MCGK,McGolrick Park - Sidewalk Replacement,846,DEPT OF PARKS AND RECREATION,NEIGHBORHOOD PARKS AND PLAYGROUNDS,300 301,BROOKLYN,P-D017 P-0245K,684,249,0,0,2165,0,0,0,2414,249,0,0,2165,0,0,0,2414,498,0,0,4330,0,0,0,4828,PROJECT DELAYED DUE TO UNFORESEEN SITE/FIELD CONDITION,"RUSSELL STREET, MONITOR STREET, BETWEEN NASSAU AVENUE AND DRIGGS AVENUE",MCGOLRICK PARK - SIDEWALK REPLACEMENT,cpd11-20bk.pdf
P-201MDLT,Middleton Playground - Phase 1 Renovations,846,DEPT OF PARKS AND RECREATION,NEIGHBORHOOD PARKS AND PLAYGROUNDS,301,BROOKLYN,P-D017,1075,0,100,900,0,0,0,0,1000,0,100,900,0,0,0,0,1000,0,200,1800,0,0,0,0,2000,,"LYNCH ST., MIDDLETON ST. BET. LEE AVE. AND BEDFORD AVE., BOROUGH OF BROOKLYN",MIDDLETON PLAYGROUND - PHASE 1 RENOVATIONS,cpd11-20bk.pdf
P-201MPFA,Metropolitan Rec. Center,846,DEPT OF PARKS AND RECREATION,NEIGHBORHOOD PARKS AND PLAYGROUNDS,301,BROOKLYN,P-0506,416,0,592,0,0,0,0,0,592,0,592,0,0,0,0,0,592,0,1184,0,0,0,0,0,1184,,"261 BEDFORD AVENUE,BROOKLYN.",RECONSTRUCTION OF FIRE ALARM AT METROPOLITAB REC CENTER.,cpd11-20bk.pdf
P-201MRCY,Marcy Green Park-Reconstruction of Rec. Facilities BG-120M,846,DEPT OF PARKS AND RECREATION,NEIGHBORHOOD PARKS AND PLAYGROUNDS,300,BROOKLYN,P-0245K,5673,350,485,0,4715,0,0,0,5550,350,485,0,4715,0,0,0,5550,700,970,0,9430,0,0,0,11100,,,MARCY GREEN PARK - BROOKLYN,cpd11-20bk.pdf
P-201REIN,RIDGEWOOD BUSHW.- BEAVER NOLL PARK BG38500-113M,846,DEPT OF PARKS AND RECREATION,NEIGHBORHOOD PARKS AND PLAYGROUNDS,301 300,BROOKLYN,P-1018,2000,3592,0,87,0,0,0,0,3679,3592,0,87,0,0,0,0,3679,7184,0,174,0,0,0,0,7358,PROJECT DELAYED PENDING RESOLUTION OF LEGAL ISSUES,BOROUGH OF BROOKLYN,RIDGEWOOD BUSHWICK SENIOR CITIZENS COUNCIL INC - RHEINGOLD PARK,cpd11-20bk.pdf
P-201STRN,Sternberg Park Upgrades B055-117M,846,DEPT OF PARKS AND RECREATION,NEIGHBORHOOD PARKS AND PLAYGROUNDS,300 301,BROOKLYN,P-D017,2600,2277,1059,0,0,0,0,0,3336,2277,1059,0,0,0,0,0,3336,4554,2118,0,0,0,0,0,6672,,"LORIMER STREET, BETWEEN MONTROSE AVENUE AND BOERUM STREET. BROOKLYN",STERNBERG PARK,cpd11-20bk.pdf
P-201TRNS,Transmitter Park - Shoreline Rehabilitation,846,DEPT OF PARKS AND RECREATION,NEIGHBORHOOD PARKS AND PLAYGROUNDS,301,BROOKLYN,P-D017,300,0,300,0,0,0,0,0,300,0,300,0,0,0,0,0,300,0,600,0,0,0,0,0,600,,"WEST ST. BET. KENT ST. AND GREENPOINT AVE., BROOKLYN",TRANSMITTER PARK - SHORELINE REHABILITATION,cpd11-20bk.pdf
P-201WILL,William Sheridan - Brooklyn- B124-119M,846,DEPT OF PARKS AND RECREATION,NEIGHBORHOOD PARKS AND PLAYGROUNDS,300,BROOKLYN,P-0245K,8500,583,0,0,7817,0,0,0,8400,583,0,0,7817,0,0,0,8400,1166,0,0,15634,0,0,0,16800,,,WILLIAM SHERIDAN - BROOKLYN,cpd11-20bk.pdf
P-202018A,Brooklyn Bridge Park,846,DEPT OF PARKS AND RECREATION,"LARGE, MAJOR AND REGIONAL PARK RECONSTRUCTION",302,BROOKLYN,P-1200 P-D017 P-K011,61561,274621,5500,0,0,0,0,0,280121,274621,5500,0,0,0,0,0,280121,549242,11000,0,0,0,0,0,560242,PROJECT DELAYED DUE TO CHANGES IN SCOPE/DESIGN,BROOKLYN BRIDGE PARK PHASE 3,BROOKLYN BRIDGE PARK PHASE 3 - FY'16 SECTION 254 ADDS $70K ( P D017)...FY18 ADOPTION ADDS,cpd11-20bk.pdf
P-202BRDG,"Bridge Park- Adult Fitness, Multi Purpose Play (B223J-118M)",846,DEPT OF PARKS AND RECREATION,NEIGHBORHOOD PARKS AND PLAYGROUNDS,300,BROOKLYN,P-1018,8908,636,0,0,0,0,0,0,636,636,0,0,0,0,0,0,636,1272,0,0,0,0,0,0,1272,,"JAY AND BQE, JAY STREET, PROSPECT STREET, BRIDGE STREET",BRIDGE PARK,cpd11-20bk.pdf
P-202C974,"FORT GREENE PK PRISONSH MARTYRS MONU&BR EAGL B32-103MA,203MA",846,DEPT OF PARKS AND RECREATION,"LARGE, MAJOR AND REGIONAL PARK RECONSTRUCTION",302,BROOKLYN,P-0245K,4655,3969,0,0,0,0,0,0,3969,3969,0,0,0,0,0,0,3969,7938,0,0,0,0,0,0,7938,PROJECT DELAYED DUE TO UNFORESEEN SITE/FIELD CONDITION,MYRTLE AND DEKALB AVENUES; CUMBERLAND ST              CD#35,FY'15 TRF $27K (P C974) TRF TO P-205LIND...$13K (P C974) TRF TO P-213ASRL...$41K (C974) TRF TO,cpd11-20bk.pdf
P-202CAD2,Cadman Plaza Park - Brooklyn (B113A-119M),846,DEPT OF PARKS AND RECREATION,NEIGHBORHOOD PARKS AND PLAYGROUNDS,300,BROOKLYN,P-0245K,6900,389,0,525,5765,0,0,0,6679,389,0,525,5765,0,0,0,6679,778,0,1050,11530,0,0,0,13358,,,CADMAN PLAZA PARK - BROOKLYN,cpd11-20bk.pdf
P-202CADM,CADMAN PLAZA (RC L/S SURROND BKLN WAR MEM. BLDG ACCESS),846,DEPT OF PARKS AND RECREATION,"LARGE, MAJOR AND REGIONAL PARK RECONSTRUCTION",300,BROOKLYN,P-0245K,265,2998,557,0,0,0,0,0,3555,2998,557,0,0,0,0,0,3555,5996,1114,0,0,0,0,0,7110,PROJECT DELAYED DUE TO UNFORESEEN SITE/FIELD CONDITION,"TILLARY, C PLAZA WEST, C PLAZA EAST, PROSPECT STREETS",CADMAN PLAZA - RECONSTRUCT LANDSCAPE SURROUNDING BROOKLYN WAR MEMORIAL INCLUDE,cpd11-20bk.pdf
P-202CBP1,Commodore Barry Park - Continue Park Phase Renovations,846,DEPT OF PARKS AND RECREATION,NEIGHBORHOOD PARKS AND PLAYGROUNDS,302,BROOKLYN,P-D017,2000,50,0,0,2000,0,0,0,2050,50,0,0,2000,0,0,0,2050,100,0,0,4000,0,0,0,4100,,"NASSAU ST., PARK AVE., BET. NAVY ST. AND N. ELLIOT PL., BROOKLYN",COMMODORE BARRY PARK - CONTINUE PARK PHASE RENOVATIONS,cpd11-20bk.pdf
P-202CHAP,CHAPIN PLAYGROUND -RECON. SPRINKLER BG-311M,846,DEPT OF PARKS AND RECREATION,NEIGHBORHOOD PARKS AND PLAYGROUNDS,302 300,BROOKLYN,P-1018 P-D017,50,88,30,0,0,290,0,0,408,88,30,0,0,290,0,0,408,176,60,0,0,580,0,0,816,PROJECT DELAYED DUE TO UNFORESEEN SITE/FIELD CONDITION,"COLUMBIA HTS AT MIDDAGH STREET, BOROUGH OF BROOKLYN",RECONSTRUCTION OF THE SPRINKLER,cpd11-20bk.pdf
P-202CUGP,Cuyler Gore Park Renovations,846,DEPT OF PARKS AND RECREATION,NEIGHBORHOOD PARKS AND PLAYGROUNDS,302,BROOKLYN,P-D017,5700,0,100,0,5500,0,0,0,5600,0,100,0,5500,0,0,0,5600,0,200,0,11000,0,0,0,11200,,"CARLTON AVE., FULTON ST., GREEN AVE., BROOKLYN",CUYLER GORE PARK RENOVATIONS,cpd11-20bk.pdf
P-202D17B,"MCLAUGHLIN PARK BALLFIELD,WDG POOL AREA,BSKTBL&HNDB,B61-105M",846,DEPT OF PARKS AND RECREATION,NEIGHBORHOOD PARKS AND PLAYGROUNDS,302,BROOKLYN,ED-0075,3005,2400,0,0,0,0,183,0,2583,2400,0,0,0,0,183,0,2583,4800,0,0,0,0,366,0,5166,,"MCLAUGHLIN PARK, BROOKLYN",MCLAUGHLIN PARK BASEBALL FIELD,cpd11-20bk.pdf
P-202FTGN,Fort Grene Park - entrance & pass (B032-110M),846,DEPT OF PARKS AND RECREATION,"LARGE, MAJOR AND REGIONAL PARK RECONSTRUCTION",302 300,BROOKLYN,P-K011,500,1982,206,0,0,0,0,0,2188,1982,206,0,0,0,0,0,2188,3964,412,0,0,0,0,0,4376,PROJECT DELAYED DUE TO CHANGES IN SCOPE/DESIGN,"MYRTLE AVE, CUMBERLAND ST & DEKALB AVE",500K FROM CC FOR RENOVATION OF WASHINGTON PARK/MYRTLE AVENUE ENTRANCEAT FORT GREENE,cpd11-20bk.pdf
P-202FTGP,"PWOB-FT. GREENE PK- PATHS,ENTRANCE RC & DRAINAGE B032-116M)",846,DEPT OF PARKS AND RECREATION,MAJOR RECREATIONAL FACILITIES AND FACILITY RECONSTRUCTION,300 302,BROOKLYN,P-1018 P-D017 P-0935 P-K011,500,773,164,7000,0,0,0,0,7937,773,164,7000,0,0,0,0,7937,1546,328,14000,0,0,0,0,15874,PROJECT DELAYED DUE TO CHANGES IN SCOPE/DESIGN,"MYRTLE AVENUE, DE KALB AVENUE, WASHINGTON PARK & ST. EDWARDS STREET IN THE BOROUGH OF",THE RECON. OF ENTRANCE TO FT. GREENE PK & DRAINAGE IMPROVE.,cpd11-20bk.pdf
P-202GRPL,Greene Playground - Reconstruction of Playground,846,DEPT OF PARKS AND RECREATION,NEIGHBORHOOD PARKS AND PLAYGROUNDS,302,BROOKLYN,P-D017,3150,0,100,0,2900,0,0,0,3000,0,100,0,2900,0,0,0,3000,0,200,0,5800,0,0,0,6000,,"GREENE AVE. BET. WAVERLY AVE. AND WASHINGTON AVE., BROOKLYN","GREENE PLAYGROUND - RECONSTRUCTION OF PLAYGROUND, BOROUGH OF BROOKLYN",cpd11-20bk.pdf
P-202WASH,"Washington Hall Playground basketball courts, Brooklyn",846,DEPT OF PARKS AND RECREATION,NEIGHBORHOOD PARKS AND PLAYGROUNDS,300,BROOKLYN,P-0245K,1655,231,140,0,1260,0,0,0,1631,231,140,0,1260,0,0,0,1631,462,280,0,2520,0,0,0,3262,,,"WASHINGTON HALL PLAYGROUND BASKETBALL COURTS, BROOKLYN",cpd11-20bk.pdf
P-202WPDR,Washington Park Dog Run B111-118M,846,DEPT OF PARKS AND RECREATION,NEIGHBORHOOD PARKS AND PLAYGROUNDS,300,BROOKLYN,P-D017 P-0245K P-K011,473,138,654,0,0,0,0,0,792,138,654,0,0,0,0,0,792,276,1308,0,0,0,0,0,1584,,,DOG RUN,cpd11-20bk.pdf
P-203CHRL,Charlie's Place Reconstruction,846,DEPT OF PARKS AND RECREATION,NEIGHBORHOOD PARKS AND PLAYGROUNDS,300,BROOKLYN,P-D017 P-0245K,1182,137,179,897,0,0,0,0,1213,137,179,897,0,0,0,0,1213,274,358,1794,0,0,0,0,2426,,,PARKS - CHARLIE'S PLACE,cpd11-20bk.pdf
P-203D17E,Von King cultural arts center - phase 3 B088-111MA,846,DEPT OF PARKS AND RECREATION,"LARGE, MAJOR AND REGIONAL PARK RECONSTRUCTION",303,BROOKLYN,P-1018 P-1250 P-D017,1000,5589,2232,0,0,0,0,0,7821,5589,2232,0,0,0,0,0,7821,11178,4464,0,0,0,0,0,15642,PROJECT DELAYED DUE TO UNFORESEEN SITE/FIELD CONDITION,HERBERT VON KING PARK CULTURAL ARTS CENTER,VON KING PARK CULTURAL ARTS CENTER PHASE 3,cpd11-20bk.pdf
P-203FULT,FULTON PARK - RESTORATION OF COMFORT STATION B038-116M,846,DEPT OF PARKS AND RECREATION,NEIGHBORHOOD PARKS AND PLAYGROUNDS,303 300,BROOKLYN,P-D017 P-1018,2820,1884,206,1160,0,0,0,0,3250,1884,206,1160,0,0,0,0,3250,3768,412,2320,0,0,0,0,6500,PROJECT DELAYED DUE TO UNFORESEEN SITE/FIELD CONDITION,"BROOKLYN - FULTON STREET, CHAUNCEY STREETS STUYVESANT AND LEWIS AVENUES",FULTON PARK - RESTORATION OF COMFORT STATION,cpd11-20bk.pdf
P-203HPUP,Harmony Park - Upgrades and Beautification,846,DEPT OF PARKS AND RECREATION,NEIGHBORHOOD PARKS AND PLAYGROUNDS,,BROOKLYN,P-D017 P-K011,450,0,950,0,0,0,0,0,950,0,950,0,0,0,0,0,950,0,1900,0,0,0,0,0,1900,,,UPGRADES AND BEAUTIFICATION TO HARMONY PARK,cpd11-20bk.pdf
P-203LFGP,Lafayette Gardens Playground Reconstruction,846,DEPT OF PARKS AND RECREATION,NEIGHBORHOOD PARKS AND PLAYGROUNDS,303,BROOKLYN,P-D017,1625,0,0,0,1500,0,0,0,1500,0,0,0,1500,0,0,0,1500,0,0,0,3000,0,0,0,3000,,"LAFAYETTE AVE. AND FRANKLIN AVE., BROOKLYN","LAFAYETTE GARDENS PLAYGROUND RECONSTRUCTION, BROOKLYN",cpd11-20bk.pdf
P-203SRTG,Saratoga Park - Playground Reconstruction (B079-119M),846,DEPT OF PARKS AND RECREATION,NEIGHBORHOOD PARKS AND PLAYGROUNDS,300 303,BROOKLYN,P-D017,2528,297,166,0,1970,0,0,0,2433,297,166,0,1970,0,0,0,2433,594,332,0,3940,0,0,0,4866,,HALSEY STREET BETWEEN HOWARD AVENUE AND SARATOGA AVENUE IN THE BOROUGH OF,"SARATOGA PARK- REPAVE ALL PATHS AND PLAZA AREAS, NEW BENCHES, SITTINGAREAS, PICNIC",cpd11-20bk.pdf
P-204GRCK,Green Central Knoll - Comfort Station B395-115M,846,DEPT OF PARKS AND RECREATION,NEIGHBORHOOD PARKS AND PLAYGROUNDS,300,BROOKLYN,P-1018,750,3657,146,268,0,0,0,0,4071,3657,146,268,0,0,0,0,4071,7314,292,536,0,0,0,0,8142,PROJECT DELAYED DUE TO UNFORESEEN SITE/FIELD CONDITION,"FLUSHING AVENUE, CENTRAL AVENUE, NOLL STREET, EVERGREEN STREET. BOROUGH OF BROOKLYN",GREEN CENTRAL KNOLL - COMFORT STATION,cpd11-20bk.pdf
P-204HECK,Heckscher Playground (B139-115M),846,DEPT OF PARKS AND RECREATION,NEIGHBORHOOD PARKS AND PLAYGROUNDS,300,BROOKLYN,P-D017,2610,2072,0,0,446,0,0,0,2518,2072,0,0,446,0,0,0,2518,4144,0,0,892,0,0,0,5036,PROJECT DELAYED DUE TO UNFORESEEN SITE/FIELD CONDITION,LINDEN STREET BET. CENTRAL AVE AND WILSON AVE. BOROUGH OF BROOKLYN..,HECKSCHER PLAYGROUND - SYNTHETIC TURF FIELD ATHLETIC TRAN AND AN ADULT FITNESS AREA,cpd11-20bk.pdf
P-204HOPE,Hope Ballfields (B429-116M),846,DEPT OF PARKS AND RECREATION,NEIGHBORHOOD PARKS AND PLAYGROUNDS,300 304,BROOKLYN,P-1018,4331,3447,13,1,122,0,0,0,3583,3447,13,1,122,0,0,0,3583,6894,26,2,244,0,0,0,7166,PROJECT DELAYED DUE TO UNFORESEEN SITE/FIELD CONDITION,"KNICKEBOCKER AVENUE, BETWEEN GROVE STREET AND MENAHAN STREET IN THE BOROUGH OF",HOPE BALLFIELDS.,cpd11-20bk.pdf
P-204RUDD,Rudd Play. - Con. Skate Park & Bask. ball cts (B131-117M),846,DEPT OF PARKS AND RECREATION,NEIGHBORHOOD PARKS AND PLAYGROUNDS,300 304,BROOKLYN,P-1018,1448,3442,269,0,0,0,0,0,3711,3442,269,0,0,0,0,0,3711,6884,538,0,0,0,0,0,7422,,"ABERDEEN STREET, FURMAN AVENUE, NORTH OF BUSHWICK IN THE BOROUGH OF BROOKLYN",RUDD PLAY,cpd11-20bk.pdf
P-205CYPS,Cypress Park - Renovation of Cypress Park B103-116M,846,DEPT OF PARKS AND RECREATION,NEIGHBORHOOD PARKS AND PLAYGROUNDS,300,BROOKLYN,P-K011 P-D017 P-1018,4000,5888,111,535,0,0,0,0,6534,5888,111,535,0,0,0,0,6534,11776,222,1070,0,0,0,0,13068,PROJECT DELAYED DUE TO UNFORESEEN SITE/FIELD CONDITION,"EUCLID AVENUE BETWEEN DUMONT AVENUE & BLAKE AVENUE, BOROUGH OF BROOKLYN",RENOVATION OF CYPRESS PARK,cpd11-20bk.pdf
P-205GRPG,Grace Playground Park Renovation Phase I B078-119M,846,DEPT OF PARKS AND RECREATION,NEIGHBORHOOD PARKS AND PLAYGROUNDS,300,BROOKLYN,P-D017,1973,328,143,0,1629,0,0,0,2100,328,143,0,1629,0,0,0,2100,656,286,0,3258,0,0,0,4200,,,GRACE PLAYGROUND PARK RENOVATION PHASE I,cpd11-20bk.pdf
P-205HLND,Highland Park Basketball Courts R/C Q020-116MA,846,DEPT OF PARKS AND RECREATION,"LARGE, MAJOR AND REGIONAL PARK RECONSTRUCTION",305,BROOKLYN,P-1018,600,1166,0,91,0,0,0,0,1257,1166,0,91,0,0,0,0,1257,2332,0,182,0,0,0,0,2514,PROJECT DELAYED DUE TO CHANGES IN SCOPE/DESIGN,"JAMAICA AVENUE, CRESCENT STREET, CYPRESS HILLS - BOROUGH OF BROOKLYN",HIGHLAND PARK - BASKETBALL COURTS RENOVATION,cpd11-20bk.pdf
P-205HPSB,Highland Park Stone Bridge Q020-418M,846,DEPT OF PARKS AND RECREATION,"LARGE, MAJOR AND REGIONAL PARK RECONSTRUCTION",300,BROOKLYN,P-D019,5068,266,0,3722,338,0,0,0,4326,266,0,3722,338,0,0,0,4326,532,0,7444,676,0,0,0,8652,,,HIGHLAND PARK STONE BRIDGE,cpd11-20bk.pdf
P-205LIN1,Linden Park,846,DEPT OF PARKS AND RECREATION,NEIGHBORHOOD PARKS AND PLAYGROUNDS,300,BROOKLYN,P-D017,4100,50,0,0,4100,0,0,0,4150,50,0,0,4100,0,0,0,4150,100,0,0,8200,0,0,0,8300,,VERMONT ST. BET. LINDEN BLVD. AND STANLEY AVE.BROOKLYN,LINDEN PARK,cpd11-20bk.pdf
P-205LIN2,Linden Park,846,DEPT OF PARKS AND RECREATION,NEIGHBORHOOD PARKS AND PLAYGROUNDS,305,BROOKLYN,P-D017,3596,75,100,0,1127,3336,0,0,4638,75,100,0,1127,3336,0,0,4638,150,200,0,2254,6672,0,0,9276,,VERMONT ST. BET. LINDEN BLVD. AND STANLEY AVE.,LINDEN PARK PHASE 5 AREA RENOVATION,cpd11-20bk.pdf
P-205LION,Lion's Pride Playground - B107-119M,846,DEPT OF PARKS AND RECREATION,NEIGHBORHOOD PARKS AND PLAYGROUNDS,300,BROOKLYN,P-D017 P-0245K,4727,468,147,0,3914,0,0,0,4529,468,147,0,3914,0,0,0,4529,936,294,0,7828,0,0,0,9058,,,LION'S PRIDE PLAYGROUND - BROOKLYN,cpd11-20bk.pdf
P-205PPMT,Public Place - Monument Reconstruction,846,DEPT OF PARKS AND RECREATION,NEIGHBORHOOD PARKS AND PLAYGROUNDS,305,BROOKLYN,P-D017,250,17,0,250,1000,0,0,0,1267,17,0,250,1000,0,0,0,1267,34,0,500,2000,0,0,0,2534,,ELDERT LA. BETWEEN LIBERTY AVE. AND GLENMORE AVE.,PUBLIC PLACE - MONUMENT RECONSTRUCTION,cpd11-20bk.pdf
P-205SBRO,Sperandeo Brothers playground B163-110M,846,DEPT OF PARKS AND RECREATION,NEIGHBORHOOD PARKS AND PLAYGROUNDS,305 300,BROOKLYN,P-D017,2200,2369,0,0,105,0,0,0,2474,2369,0,0,105,0,0,0,2474,4738,0,0,210,0,0,0,4948,PROJECT DELAYED DUE TO UNFORESEEN SITE/FIELD CONDITION,BOROUGH OF BROOKLYN,NEW PLAY EQUIPMENT AND RECONSTRUCT COMFORT STATION,cpd11-20bk.pdf
P-205SHNK,Schenk Playground - B261,846,DEPT OF PARKS AND RECREATION,NEIGHBORHOOD PARKS AND PLAYGROUNDS,305 300,BROOKLYN,P-D017 P-K011,2527,404,0,94,1445,500,937,0,3380,404,0,94,1445,500,937,0,3380,808,0,188,2890,1000,1874,0,6760,PROJECT DELAYED DUE TO UNFORESEEN SITE/FIELD CONDITION,LIVONIA AVENUE BETWEEN BARBEY STREET & SCHENK AVENUE,SCHENK PARK,cpd11-20bk.pdf
P-206ENIS,Ennis Playground - B095-116M,846,DEPT OF PARKS AND RECREATION,NEIGHBORHOOD PARKS AND PLAYGROUNDS,300,BROOKLYN,P-1018,2836,3123,1,333,0,0,0,0,3457,3123,1,333,0,0,0,0,3457,6246,2,666,0,0,0,0,6914,PROJECT DELAYED DUE TO UNFORESEEN SITE/FIELD CONDITION,"BROOKLYN - 11 STREET, 12 STREET, BETWEEN 2 AVNUE & 3RD AVENUE",ENNIS PLAYGROUND,cpd11-20bk.pdf
P-206GDAM,"Restoration of Grand Army Plaza Arch, Bailey Ftn, &SRND AREA",846,DEPT OF PARKS AND RECREATION,NEIGHBORHOOD PARKS AND PLAYGROUNDS,300,BROOKLYN,P-1141,9495,955,4836,459,0,0,0,0,6250,955,4836,459,0,0,0,0,6250,1910,9672,918,0,0,0,0,12500,,"RESTORATION OF GRAND ARMY PLAZA ARCH, BAILEY FTN, &SRND AREA","RESTORATION OF GRAND ARMY PLAZA ARCH, BAILEY FTN, &SRND AREA",cpd11-20bk.pdf
P-206GDAS,Grand Army Plaza - Site Restoration B040-120M,846,DEPT OF PARKS AND RECREATION,NEIGHBORHOOD PARKS AND PLAYGROUNDS,300,BROOKLYN,P-1141,3403,75,0,0,2995,0,0,0,3070,75,0,0,2995,0,0,0,3070,150,0,0,5990,0,0,0,6140,,PROSPECT PARK - GRAND ARMY PLAZA,GRAND ARMY PLAZA - SITE RESTORATION,cpd11-20bk.pdf
P-206ICKE,HAROLD ICKES PLGRD PH 1,846,DEPT OF PARKS AND RECREATION,NEIGHBORHOOD PARKS AND PLAYGROUNDS,300,BROOKLYN,P-K011 P-D017,3726,644,406,2745,0,0,0,0,3795,644,406,2745,0,0,0,0,3795,1288,812,5490,0,0,0,0,7590,,,"BIKE, SKATE PARK",cpd11-20bk.pdf
P-206MARY,St. Mary's Plgd. Play Equip. Recon. Safety Surf. B118-115M,846,DEPT OF PARKS AND RECREATION,NEIGHBORHOOD PARKS AND PLAYGROUNDS,300 306,BROOKLYN,P-D017 P-1018,850,1102,0,202,0,0,0,0,1304,1102,0,202,0,0,0,0,1304,2204,0,404,0,0,0,0,2608,PROJECT DELAYED DUE TO UNFORESEEN SITE/FIELD CONDITION,"SMITH STREET, BETWEEN NELSON AND HUNTINGTON STREET, BOROUGH OF BROOKLYN",RECONSTRUCTION OF ST MARY'S PLAYGROUND.,cpd11-20bk.pdf
P-206PENN,William Penn Playground - Renovate P.S. 321,846,DEPT OF PARKS AND RECREATION,NEIGHBORHOOD PARKS AND PLAYGROUNDS,306,BROOKLYN,P-D017,800,0,0,800,0,0,0,0,800,0,0,800,0,0,0,0,800,0,0,1600,0,0,0,0,1600,,"WILLIAM PENN PLAYGROUND - P.S. 231, BOROUGH OF BROOKLYN",WILLIAM PENN PLAYGROUND - RENOVATE P.S. 321,cpd11-20bk.pdf
P-206REDH,RC - PATHS AND BBQ AREA IN COFFEY PARK B077-112M,846,DEPT OF PARKS AND RECREATION,"LARGE, MAJOR AND REGIONAL PARK RECONSTRUCTION",306 300,BROOKLYN,P-D017,1750,1865,239,0,0,0,0,0,2104,1865,239,0,0,0,0,0,2104,3730,478,0,0,0,0,0,4208,,"OTSEGO, BAY HICKS, LORRAINE, COURT, HALLECK STREETS, BOROUGH OF BROOKLYN",RED HOOK PARK-CONSTRUCTION OF BICYCLE AND PEDESTRIAN PATH WITH FITNESS STATIONS AND,cpd11-20bk.pdf
P-206RH02,Red Hook - Oversight 9,846,DEPT OF PARKS AND RECREATION,MAJOR RECREATIONAL FACILITIES AND FACILITY RECONSTRUCTION,300,BROOKLYN,P-0245K,3300,43,1000,0,2256,0,0,0,3299,43,1000,0,2256,0,0,0,3299,86,2000,0,4512,0,0,0,6598,PROJECT DELAYED DUE TO CHANGES IN SCOPE/DESIGN,BROOKLYN,RED HOOK - OVERSIGHT 9,cpd11-20bk.pdf
P-206RHBF,Red Hook - Ball field 9/Soccer 2 (B126-117M),846,DEPT OF PARKS AND RECREATION,MAJOR RECREATIONAL FACILITIES AND FACILITY RECONSTRUCTION,300,BROOKLYN,P-0245K,18836,17461,3197,0,0,0,0,0,20658,17461,3197,0,0,0,0,0,20658,34922,6394,0,0,0,0,0,41316,,BROOKLYN,RED HOOK - BALL FIELD 9/SOCCER 2,cpd11-20bk.pdf
P-206RHBS,Red Hook Track 1/Soccer 3 & Ballfields 1-4 (B126-118M),846,DEPT OF PARKS AND RECREATION,MAJOR RECREATIONAL FACILITIES AND FACILITY RECONSTRUCTION,300,BROOKLYN,P-0245K,50380,4315,0,0,58889,0,0,0,63204,4315,0,0,58889,0,0,0,63204,8630,0,0,117778,0,0,0,126408,PROJECT DELAYED DUE TO UNFORESEEN SITE/FIELD CONDITION,,"REMEDIATION AND RECONSTRUCTION OF TRACK 1, SOCCER 3 AND BALLFIELDS 1-4 AT RED HOOK PARK.",cpd11-20bk.pdf
P-206RHCF,Red Hook - Community Farm Upgrades,846,DEPT OF PARKS AND RECREATION,MAJOR RECREATIONAL FACILITIES AND FACILITY RECONSTRUCTION,306,BROOKLYN,P-D017 P-K011,500,68,500,0,0,0,0,0,568,68,500,0,0,0,0,0,568,136,1000,0,0,0,0,0,1136,,"HALLECK ST., BUSH ST. BET. OTSEGO ST. AND COURT ST. , BROOKLYN",RED HOOK - COMMUNITY FARM UPGRADES,cpd11-20bk.pdf
P-206RHO1,Red Hook- EPA Oversight 5-8,846,DEPT OF PARKS AND RECREATION,MAJOR RECREATIONAL FACILITIES AND FACILITY RECONSTRUCTION,300,BROOKLYN,P-0245K,3300,130,1162,0,2009,0,0,0,3301,130,1162,0,2009,0,0,0,3301,260,2324,0,4018,0,0,0,6602,PROJECT DELAYED DUE TO UNFORESEEN SITE/FIELD CONDITION,RED HOOK BROOKLYN,RED HOOK,cpd11-20bk.pdf
P-206RHRC,Red Hook Recreation Center Reconstruction,846,DEPT OF PARKS AND RECREATION,MAJOR RECREATIONAL FACILITIES AND FACILITY RECONSTRUCTION,300,BROOKLYN,P-0506,0,0,1800,6200,2755,4302,19488,0,34545,0,1800,6200,2755,4302,19488,0,34545,0,3600,12400,5510,8604,38976,0,69090,,,RED HOOK RECREATION CENTER & FIRE ALARMS,cpd11-20bk.pdf
P-206RHSF,Red Hook - Soccer 1 & 6,846,DEPT OF PARKS AND RECREATION,MAJOR RECREATIONAL FACILITIES AND FACILITY RECONSTRUCTION,300,BROOKLYN,P-0245K,21196,1647,100,0,0,0,22999,0,24746,1647,100,0,0,0,22999,0,24746,3294,200,0,0,0,45998,0,49492,PROJECT DELAYED DUE TO UNFORESEEN SITE/FIELD CONDITION,"LOCATED AT HALLECK STREET, BUSH STREET, BETWEEN OTSEGO STREET AND COURT STREET IN THE",RED HOOK RECREATION AREA,cpd11-20bk.pdf
P-206SMRY,St. Mary's Playground (B118-116M),846,DEPT OF PARKS AND RECREATION,NEIGHBORHOOD PARKS AND PLAYGROUNDS,300 306,BROOKLYN,P-1018,927,1358,1,313,0,0,0,0,1672,1358,1,313,0,0,0,0,1672,2716,2,626,0,0,0,0,3344,PROJECT DELAYED DUE TO UNFORESEEN SITE/FIELD CONDITION,SMITH STREET BETWEEN NELSON STREET AND HUNTINGTON STREET - BROOKLYN,ST MARY'S PLAYGROUND,cpd11-20bk.pdf
P-207BTFY,Butterfly Garden - B255G,846,DEPT OF PARKS AND RECREATION,NEIGHBORHOOD PARKS AND PLAYGROUNDS,300 307,BROOKLYN,P-1018,650,942,0,62,0,0,0,0,1004,942,0,62,0,0,0,0,1004,1884,0,124,0,0,0,0,2008,PROJECT DELAYED DUE TO UNFORESEEN SITE/FIELD CONDITION,"BROOKLYN - 7TH AVENUE, BETWEEN 17 STREET AND 18 STREET",BUTTERFLY GARDEN,cpd11-20bk.pdf
P-207OPML,Ocean Parkway Malls - RC B065-119M,846,DEPT OF PARKS AND RECREATION,"LARGE, MAJOR AND REGIONAL PARK RECONSTRUCTION",300,BROOKLYN,P-D017 P-K011,2129,188,694,0,1917,0,0,0,2799,188,694,0,1917,0,0,0,2799,376,1388,0,3834,0,0,0,5598,,,OCEAN PARKWAY MALLS - RC,cpd11-20bk.pdf
P-207RAIN,Rainbow Playground - Playground Update B265,846,DEPT OF PARKS AND RECREATION,NEIGHBORHOOD PARKS AND PLAYGROUNDS,300 307,BROOKLYN,P-D017,591,210,0,0,1100,0,500,0,1810,210,0,0,1100,0,500,0,1810,420,0,0,2200,0,1000,0,3620,,"6 AVENUE, BETWEEN 55 STREET AND 56 STREET.. BOROUGH OF BROOKLYN",RAINBOW PLAYGROUND UPGRADE,cpd11-20bk.pdf
P-207SNST,Sunset Park - Benches -B087-116M,846,DEPT OF PARKS AND RECREATION,"LARGE, MAJOR AND REGIONAL PARK RECONSTRUCTION",307 300,BROOKLYN,P-K011 P-D017,1090,1636,2,206,0,0,0,0,1844,1636,2,206,0,0,0,0,1844,3272,4,412,0,0,0,0,3688,PROJECT DELAYED DUE TO UNFORESEEN SITE/FIELD CONDITION,"BROOKLYN - 41 STREET, 44 STREET BETWEEN 5 AVENUE & 7 AVENUE",SUNSET PARK,cpd11-20bk.pdf
P-207SPHD,HANDBALL COURT RENOVATIONS AT SUNSET PARK (B087-119M),846,DEPT OF PARKS AND RECREATION,NEIGHBORHOOD PARKS AND PLAYGROUNDS,300,BROOKLYN,P-D017,682,148,477,0,0,0,0,0,625,148,477,0,0,0,0,0,625,296,954,0,0,0,0,0,1250,,,HANDBALL COURT RENOVATION,cpd11-20bk.pdf
P-207SPOS,Sunset Park - Open Stage Creation,846,DEPT OF PARKS AND RECREATION,MAJOR RECREATIONAL FACILITIES AND FACILITY RECONSTRUCTION,307,BROOKLYN,P-D017,1000,0,0,0,1000,0,0,0,1000,0,0,0,1000,0,0,0,1000,0,0,0,2000,0,0,0,2000,,"41 ST., 44 ST., BET. 5 AVE. AND 7 AVE., BROOKLYN",SUNSET PARK - OPEN STAGE CREATION,cpd11-20bk.pdf
P-207SSAF,Sunset Park - Adult Fitness,846,DEPT OF PARKS AND RECREATION,"LARGE, MAJOR AND REGIONAL PARK RECONSTRUCTION",307 300,BROOKLYN,P-D017,590,518,165,0,0,0,0,0,683,518,165,0,0,0,0,0,683,1036,330,0,0,0,0,0,1366,PROJECT DELAYED DUE TO UNFORESEEN SITE/FIELD CONDITION,"BROOKLYN - 41 STREET, 44 STREET BETWEEN 5TH AND 7TH AVENUE",SUNSET PARK ADULT FITNESS,cpd11-20bk.pdf
P-207SSPK,Sunset Park - Renovation - B087-117MA,846,DEPT OF PARKS AND RECREATION,"LARGE, MAJOR AND REGIONAL PARK RECONSTRUCTION",300 307,BROOKLYN,P-D017,500,907,79,0,0,0,0,0,986,907,79,0,0,0,0,0,986,1814,158,0,0,0,0,0,1972,,"41STREET 44 STREET, BETWEEN 5 AVENUE AND 7 AVENUE. BROOKLYN",SUNSET PARK RENOVATIONS,cpd11-20bk.pdf
P-208BROW,Brower Park - Reconstruction of basketball courts -B012-117M,846,DEPT OF PARKS AND RECREATION,NEIGHBORHOOD PARKS AND PLAYGROUNDS,300,BROOKLYN,P-K011 P-D017,952,975,153,0,0,0,0,0,1128,975,153,0,0,0,0,0,1128,1950,306,0,0,0,0,0,2256,,"ST. MARK'S AVENUE, PARK PLACE BETWEEN BROOKLYN AVENUE AND KINGSTON AVENUE. BROOKLYN",BROWER PARK,cpd11-20bk.pdf
P-208HVAC,ST. JOHNS HVAC UPGRADE-B245-114M,846,DEPT OF PARKS AND RECREATION,NEIGHBORHOOD PARKS AND PLAYGROUNDS,308,BROOKLYN,P-1250,2568,4095,61,204,0,0,0,0,4360,4095,61,204,0,0,0,0,4360,8190,122,408,0,0,0,0,8720,PROJECT DELAYED DUE TO CHANGES IN SCOPE/DESIGN,"1251 PROSPECT PLACE, BOROUGH OF BROOKLYN",THE UPGRADE OF THE HVAC IN ST JOHNS RECREATION CENTER,cpd11-20bk.pdf
P-208K11A,ST. MARK'S AVE. STREETBED PARK RECONSTR; BG-38050-199,846,DEPT OF PARKS AND RECREATION,"LARGE, MAJOR AND REGIONAL PARK RECONSTRUCTION",308,BROOKLYN,P-K011,1058,964,48,0,0,0,0,0,1012,964,48,0,0,0,0,0,1012,1928,96,0,0,0,0,0,2024,PROJECT DELAYED DUE TO UNFORESEEN SITE/FIELD CONDITION,,,cpd11-20bk.pdf
P-208K11E,St. John's Recreation Center - comfort station (B245-111M),846,DEPT OF PARKS AND RECREATION,"LARGE, MAJOR AND REGIONAL PARK RECONSTRUCTION",308 300,BROOKLYN,P-D017,750,2201,18,153,0,0,0,0,2372,2201,18,153,0,0,0,0,2372,4402,36,306,0,0,0,0,4744,PROJECT DELAYED DUE TO UNFORESEEN SITE/FIELD CONDITION,"TROY AVENUE, BERGEN, PROSPECT PL, SCHENECTADY AVENUE",IMPROVEMENTS AND RENOVATION OF THE COMFORT STATION IN THE PARK,cpd11-20bk.pdf
P-208LIN2,Lincoln Terrace Park - Brooklyn (B054-119M),846,DEPT OF PARKS AND RECREATION,NEIGHBORHOOD PARKS AND PLAYGROUNDS,300,BROOKLYN,P-0245K,4737,370,0,0,4000,0,0,0,4370,370,0,0,4000,0,0,0,4370,740,0,0,8000,0,0,0,8740,,,LINCOLN TERRACE PARK - BROOKLYN,cpd11-20bk.pdf
P-208LTCS,Lincoln Terrace- Comfort Station B054-115M,846,DEPT OF PARKS AND RECREATION,NEIGHBORHOOD PARKS AND PLAYGROUNDS,308,BROOKLYN,P-D017 P-1018,2000,555,4,0,3855,0,0,0,4414,555,4,0,3855,0,0,0,4414,1110,8,0,7710,0,0,0,8828,PROJECT DELAYED PENDING RESOLUTION OF LEGAL ISSUES,"EASTERN PARKWAY, EAST NEW YORK AVENUE BETWEEN ROCHESTER AVENUE AND PORTAL STREET.",LINCOLN TERRACE COMFORT STATION,cpd11-20bk.pdf
P-208SJFA,ST. John's Rec. Center,846,DEPT OF PARKS AND RECREATION,NEIGHBORHOOD PARKS AND PLAYGROUNDS,308,BROOKLYN,P-0506,628,0,717,0,0,0,0,0,717,0,717,0,0,0,0,0,717,0,1434,0,0,0,0,0,1434,,"1251 PROSPECT PLACE, BROOKLYN.",FIRE ALARM RECONSTRUCTION AT ST. JOHN'S REC. CENTER.,cpd11-20bk.pdf
P-208STFE,ST. JOHNS REC CENTER - OUTDOOR FITNESS EQUIPMENT (B245-118M),846,DEPT OF PARKS AND RECREATION,NEIGHBORHOOD PARKS AND PLAYGROUNDS,300,BROOKLYN,P-D017,682,68,500,0,0,0,0,0,568,68,500,0,0,0,0,0,568,136,1000,0,0,0,0,0,1136,,,OUTDOOR FITNESS EQUIPMENT,cpd11-20bk.pdf
P-208STUD,CPI PH 1- Stroud Playground (B350-115M),846,DEPT OF PARKS AND RECREATION,NEIGHBORHOOD PARKS AND PLAYGROUNDS,308 300,BROOKLYN,P-1018,100,5539,0,101,0,0,0,0,5640,5539,0,101,0,0,0,0,5640,11078,0,202,0,0,0,0,11280,PROJECT DELAYED DUE TO UNFORESEEN SITE/FIELD CONDITION,BOROUGH OF BROOKLYN,PARK UPGRADES AND RENOVATIONS,cpd11-20bk.pdf
P-209D017,PARKSIDE (P.S. 92) PLAYGROUND (B267-109M),846,DEPT OF PARKS AND RECREATION,NEIGHBORHOOD PARKS AND PLAYGROUNDS,309,BROOKLYN,P-D017,0,1744,0,0,45,0,0,0,1789,1744,0,0,45,0,0,0,1789,3488,0,0,90,0,0,0,3578,PROJECT DELAYED DUE TO BUDGETARY CONSTRAINTS,"PARKSIDE (PS 92) PLAYGOUND, BROOKLYN, CB 9",PARKSIDE (PS 92) PLAYGROUND RECONSTRUCTION,cpd11-20bk.pdf
P-209WNGE,Wingate Park - Basketball Courts,846,DEPT OF PARKS AND RECREATION,"LARGE, MAJOR AND REGIONAL PARK RECONSTRUCTION",300 309,BROOKLYN,P-1018,250,2553,251,0,0,0,0,0,2804,2553,251,0,0,0,0,0,2804,5106,502,0,0,0,0,0,5608,,"WINTHROP STREET, BROOKLYN AVENUE, RUTLAND ROAD",WINGATE PARK - BASKETBALL COURTS,cpd11-20bk.pdf
P-210245A,OWL'S HEAD PK - GREENWAY CONNECTOR B066-108M,846,DEPT OF PARKS AND RECREATION,"LARGE, MAJOR AND REGIONAL PARK RECONSTRUCTION",310,BROOKLYN,P-0245K,1100,347,0,0,0,0,0,0,347,347,0,0,0,0,0,0,347,694,0,0,0,0,0,0,694,PROJECT DELAYED DUE TO UNFORESEEN HAZARDOUS CONDITION,BROOKLYN CB 10 AT FORT HAMILTON PARKWAY AND 94TH STREET,JJ CARTY PARK OFFICE,cpd11-20bk.pdf
P-210C040,MCKINLEY PARK PATHS&LDSCPE B060-101M (FORMER B060-196),846,DEPT OF PARKS AND RECREATION,NEIGHBORHOOD PARKS AND PLAYGROUNDS,310,BROOKLYN,P-C017,1536,1289,89,0,0,0,0,0,1378,1289,89,0,0,0,0,0,1378,2578,178,0,0,0,0,0,2756,,"MCKINLEY PARK, BROOKLYN                FT HAMILTON PKWY, 73 TO 78 STS, 7 AVE","RECONSTRUCTION OF PAVEMENTS, CONCRETE CURBS, FENCES, BENCHES, GAME TABTING, DRINKING",cpd11-20bk.pdf
P-210D17T,SHORE ROAD PATHWAY BICYCLE PATH,846,DEPT OF PARKS AND RECREATION,"LARGE, MAJOR AND REGIONAL PARK RECONSTRUCTION",310 300,BROOKLYN,P-D017 P-0501 PU-0200 P-K011 P-1130,250,166,428,0,6900,0,0,0,7494,166,428,0,6900,0,0,0,7494,332,856,0,13800,0,0,0,14988,PROJECT DELAYED DUE TO CHANGES IN SCOPE/DESIGN,BOROUGH OF BROOKLYN,SHORE ROAD PATHWAY,cpd11-20bk.pdf
P-210DBSF,Dyker Beach Park- Soccer Field B028-116M,846,DEPT OF PARKS AND RECREATION,"LARGE, MAJOR AND REGIONAL PARK RECONSTRUCTION",310 300,BROOKLYN,P-D017,2954,2118,445,227,0,0,0,0,2790,2118,445,227,0,0,0,0,2790,4236,890,454,0,0,0,0,5580,,"86 STREET, BELT PARKWAY, BETWEEN BAY 8 STREET 14 AVEUE AND 7TH AVENUE, BROOKLYN",DYKER BEACH SOCCER FIELD,cpd11-20bk.pdf
P-210DOG,Shore Park - Shore Park Dog Run,846,DEPT OF PARKS AND RECREATION,MAJOR RECREATIONAL FACILITIES AND FACILITY RECONSTRUCTION,310,BROOKLYN,P-D017,1000,136,0,0,1000,0,0,0,1136,136,0,0,1000,0,0,0,1136,272,0,0,2000,0,0,0,2272,,"4 AVE., SHORE RD., BELT PKWY., VERRAZANO BRIDGE, BROOKLYN",SHORE PARK - SHORE ROAD DOG RUN,cpd11-20bk.pdf
P-210FTHM,Ft. Hamilton Courts - RC of Bsktball & Tennis Cts -B192A,846,DEPT OF PARKS AND RECREATION,NEIGHBORHOOD PARKS AND PLAYGROUNDS,300 310,BROOKLYN,P-0245K,2600,200,0,2200,0,0,0,0,2400,200,0,2200,0,0,0,0,2400,400,0,4400,0,0,0,0,4800,,"83 STREET TO 85 STREET, BETWEEN COLONIAL ROAD AND NARROWS AVENUE, IN THE BOROUGH OF",THE RECONSTRUCTION OF 2 BASKETBALL COURTS; PHASE 3 RECONSTRUCTION OF 3 TENNIS COURTS,cpd11-20bk.pdf
P-210JCAR,John J. Carty Tennis Courts B210-116M,846,DEPT OF PARKS AND RECREATION,NEIGHBORHOOD PARKS AND PLAYGROUNDS,310,BROOKLYN,P-1018,1000,3169,79,0,0,0,0,0,3248,3169,79,0,0,0,0,0,3248,6338,158,0,0,0,0,0,6496,PROJECT DELAYED PENDING RESOLUTION OF LEGAL ISSUES,"FORT HAMILTON PARKWAY, BETWEEN 94 STREET AND 101STREET, BOROUGH OF BROOKLYN",JOHN J. CARTY TENNIS COURTS,cpd11-20bk.pdf
P-210JJCP,JJ Carty Park - Renovation of Playground,846,DEPT OF PARKS AND RECREATION,NEIGHBORHOOD PARKS AND PLAYGROUNDS,310,BROOKLYN,P-D017,5400,0,0,0,5400,0,0,0,5400,0,0,0,5400,0,0,0,5400,0,0,0,10800,0,0,0,10800,,"FT. HAMILTON PKWY. BET. 94 ST. AND 101 ST., BROOKLYN",JJ CARTY PARK - RENOVATION OF PLAYGROUND,cpd11-20bk.pdf
P-210OWLH,Owl's Head Park - Reconstruction of Basketball Courts,846,DEPT OF PARKS AND RECREATION,NEIGHBORHOOD PARKS AND PLAYGROUNDS,310,BROOKLYN,P-D017,4200,0,100,0,3900,0,0,0,4000,0,100,0,3900,0,0,0,4000,0,200,0,7800,0,0,0,8000,,,OWL'S HEAD PARK - RECONSTRUCTION OF BASKETBALL COURTS,cpd11-20bk.pdf
P-210RUPP,Russell Pedersen Playground Reconstruction,846,DEPT OF PARKS AND RECREATION,NEIGHBORHOOD PARKS AND PLAYGROUNDS,310,BROOKLYN,P-D017,5600,0,100,0,5300,0,0,0,5400,0,100,0,5300,0,0,0,5400,0,200,0,10600,0,0,0,10800,,"COLONIAL RD. FROM 83 ST. TO 85 ST., BROOKLYN",RUSSELL PEDERSEN PLAYGROUND RECONSTRUCTION,cpd11-20bk.pdf
P-210SHCP,Shore Road Park - Path Reconstruction (B082-220M),846,DEPT OF PARKS AND RECREATION,NEIGHBORHOOD PARKS AND PLAYGROUNDS,300,BROOKLYN,P-0973,1308,65,0,0,1270,0,0,0,1335,65,0,0,1270,0,0,0,1335,130,0,0,2540,0,0,0,2670,,,SHORE ROAD PARK,cpd11-20bk.pdf
P-210SHOR,SHORE ROAD PK - PERIMETER SIDEWALKS (B082A-110M),846,DEPT OF PARKS AND RECREATION,NEIGHBORHOOD PARKS AND PLAYGROUNDS,300 310,BROOKLYN,P-0245K,1800,127,0,0,0,0,0,0,127,127,0,0,0,0,0,0,127,254,0,0,0,0,0,0,254,PROJECT DELAYED DUE TO CHANGES IN SCOPE/DESIGN,BOROUGH OF BROOKLYN,PARK IMPROVEMENTS AND RENOVATIONS TO THE SIDEWALKS,cpd11-20bk.pdf
P-210SHRD,Shore Road Pk- Rehab C/S -Field House B082-116M,846,DEPT OF PARKS AND RECREATION,"LARGE, MAJOR AND REGIONAL PARK RECONSTRUCTION",310,BROOKLYN,P-D017,5250,4608,174,0,0,0,0,0,4782,4608,174,0,0,0,0,0,4782,9216,348,0,0,0,0,0,9564,PROJECT DELAYED PENDING RESOLUTION OF LEGAL ISSUES,"4TH AVENUE, SHORE ROAD, BELT PARKWAY,. BOROUGH OF BROOKLYN.",SHORE ROAD PARK- REHABILITATE COMFORT STATION/FIELD HOUSE,cpd11-20bk.pdf
P-210SHRE,Shore Road park- Install. fence erosion contrl. B082,846,DEPT OF PARKS AND RECREATION,MAJOR RECREATIONAL FACILITIES AND FACILITY RECONSTRUCTION,300 310,BROOKLYN,P-1018,1364,892,173,0,0,0,0,0,1065,892,173,0,0,0,0,0,1065,1784,346,0,0,0,0,0,2130,PROJECT DELAYED PENDING RESOLUTION OF LEGAL ISSUES,"4 AVENUE. SHORE RD, BELT PKWY, VERRAZANO BRIDGE","FY'15 INSTALLATION OF STEEL FENCE GATES, VEGETATION REMOVAL, PLANTINGS AND EROSION",cpd11-20bk.pdf
P-210SHRS,Shore Park & Parkway - Bike Path Surface Repair BG-715MA,846,DEPT OF PARKS AND RECREATION,NEIGHBORHOOD PARKS AND PLAYGROUNDS,300,BROOKLYN,P-D017,6146,545,55,0,0,0,0,0,600,545,55,0,0,0,0,0,600,1090,110,0,0,0,0,0,1200,,SHORE PARKWAY- BOROUGH OF BROOKLYN,SHORE PARKWAY - SOUTH,cpd11-20bk.pdf
P-210VINP,Shore Park & Parkway Vinland Playground Recon. B082-320M,846,DEPT OF PARKS AND RECREATION,NEIGHBORHOOD PARKS AND PLAYGROUNDS,310,BROOKLYN,P-D017,6800,50,38,0,3362,0,0,0,3450,50,38,0,3362,0,0,0,3450,100,76,0,6724,0,0,0,6900,,95 ST & SHORE ROAD,COMPLETE RENOVATION OF PLAYGROUND IN VINLAND PARK,cpd11-20bk.pdf
P-211245E,SETH LOW PLAYGROUND B100-106M,846,DEPT OF PARKS AND RECREATION,NEIGHBORHOOD PARKS AND PLAYGROUNDS,311,BROOKLYN,P-0245K,1725,1361,39,0,0,0,0,0,1400,1361,39,0,0,0,0,0,1400,2722,78,0,0,0,0,0,2800,PROJECT DELAYED DUE TO UNFORESEEN SITE/FIELD CONDITION,SETH LOW PLAYGROUND,SETH LOW PLAYGROUND RECONSTRUCTION,cpd11-20bk.pdf
P-211BBCH,BATH BEACH PARK - PH2 and PH3 (B164-119M),846,DEPT OF PARKS AND RECREATION,NEIGHBORHOOD PARKS AND PLAYGROUNDS,300,BROOKLYN,P-D017,5592,343,0,0,5339,0,0,0,5682,343,0,0,5339,0,0,0,5682,686,0,0,10678,0,0,0,11364,PROJECT DELAYED DUE TO CHANGES IN SCOPE/DESIGN,,RECONSTRUCTION,cpd11-20bk.pdf
P-211BNHT,Bensonhurst Park - B007-118M,846,DEPT OF PARKS AND RECREATION,"LARGE, MAJOR AND REGIONAL PARK RECONSTRUCTION",311 300,BROOKLYN,P-0245K,800,7622,660,0,0,0,0,0,8282,7622,660,0,0,0,0,0,8282,15244,1320,0,0,0,0,0,16564,PROJECT DELAYED DUE TO CHANGES IN SCOPE/DESIGN,BROOKLYN - CROPSEY AVENUE BETWEEN 21 AVENUE AND BAY PARKWAY,BENSONHURST PARK,cpd11-20bk.pdf
P-212ALBE,Albemarle Playground - Resurface Soccer Field (B297-119M),846,DEPT OF PARKS AND RECREATION,NEIGHBORHOOD PARKS AND PLAYGROUNDS,300 312,BROOKLYN,P-D017 P-K011,591,91,500,0,0,0,0,0,591,91,500,0,0,0,0,0,591,182,1000,0,0,0,0,0,1182,,"ALBEMARLE ROAD, DAHILL ROAD, MCDONALD AVENUE IN THE BOROUGH OF BROOKLYN","ALBEMARLE PLAYGROUND - RESURFACE SOCCER FIELD - REPLACE DAMAGED, HAZARDOUS TURF IN",cpd11-20bk.pdf
P-212C17F,Gravesend Park (B042-109M),846,DEPT OF PARKS AND RECREATION,NEIGHBORHOOD PARKS AND PLAYGROUNDS,312,BROOKLYN,P-D017,2000,6659,145,0,0,0,0,0,6804,6659,145,0,0,0,0,0,6804,13318,290,0,0,0,0,0,13608,PROJECT DELAYED DUE TO CHANGES IN SCOPE/DESIGN,"ALBEMARLE (PS 230 PLGD) , BROOKLYN, CB 12",ALBEMARLE (PS 230) PLGD EXPANSION,cpd11-20bk.pdf
P-212CLDM,Colonel David Marcus playground - CS B128-115M,846,DEPT OF PARKS AND RECREATION,NEIGHBORHOOD PARKS AND PLAYGROUNDS,300,BROOKLYN,P-D017,1000,917,407,0,0,0,0,0,1324,917,407,0,0,0,0,0,1324,1834,814,0,0,0,0,0,2648,PROJECT DELAYED DUE TO UNFORESEEN SITE/FIELD CONDITION,BOROUGH OF BROOKLYN,COMFORT STATION IN COLONEL DAVID MARCUS PLAYGROUND,cpd11-20bk.pdf
P-212D017,FRIENDS FIELD PARK RECONSTR PRTN INCL PLGD B372-104M,846,DEPT OF PARKS AND RECREATION,"LARGE, MAJOR AND REGIONAL PARK RECONSTRUCTION",313,BROOKLYN,P-D017,1339,1032,68,0,0,0,0,0,1100,1032,68,0,0,0,0,0,1100,2064,136,0,0,0,0,0,2200,,"FRIENDS FIELD BALLFIELD, BROOKLYN CB 12",FRIENDS FIELD BALLFIELD RECONSTRUCTION,cpd11-20bk.pdf
P-212D17N,OCEAN PARKWAY MALLS -MALL RENOVATIONS B065-112M,846,DEPT OF PARKS AND RECREATION,"LARGE, MAJOR AND REGIONAL PARK RECONSTRUCTION",312 300,BROOKLYN,P-D017,1800,1627,189,0,0,0,0,0,1816,1627,189,0,0,0,0,0,1816,3254,378,0,0,0,0,0,3632,PROJECT DELAYED DUE TO UNFORESEEN SITE/FIELD CONDITION,PARK CIRCLE TO CONEY ISLAND CONCOURSE,OCEAN PARKWAY MALLS REONSTRUCTION,cpd11-20bk.pdf
P-212DOME,Dome Playground - phase I (B151-112M),846,DEPT OF PARKS AND RECREATION,NEIGHBORHOOD PARKS AND PLAYGROUNDS,312 300,BROOKLYN,P-D017,900,2709,61,576,0,0,0,0,3346,2709,61,576,0,0,0,0,3346,5418,122,1152,0,0,0,0,6692,PROJECT DELAYED DUE TO CHANGES IN SCOPE/DESIGN,N E CORNER 38 STREET AND DAHILL ROAD,"RECONSTRUCT PLAYGROUND WITH NEW PLAY EQUIPMENT, SWINGS, SAFETY SURFACE, PAVEMENT,",cpd11-20bk.pdf
P-212FRFD,Friends Field - B372-116M,846,DEPT OF PARKS AND RECREATION,"LARGE, MAJOR AND REGIONAL PARK RECONSTRUCTION",300 312,BROOKLYN,P-1018,1680,2962,252,0,0,0,0,0,3214,2962,252,0,0,0,0,0,3214,5924,504,0,0,0,0,0,6428,PROJECT DELAYED DUE TO UNFORESEEN SITE/FIELD CONDITION,"BROOKLYN - AVENUE L, EAST 4 STREET, MCDONALD AVENUE, AVENUE M",FRIENDS FIELD,cpd11-20bk.pdf
P-212GRVD,Gravesend Pk - RC parkhouse B042-112M,846,DEPT OF PARKS AND RECREATION,"LARGE, MAJOR AND REGIONAL PARK RECONSTRUCTION",312 300,BROOKLYN,P-1018,1800,2464,1,154,0,0,0,0,2619,2464,1,154,0,0,0,0,2619,4928,2,308,0,0,0,0,5238,PROJECT DELAYED DUE TO CHANGES IN SCOPE/DESIGN,18TH AVENUE TO 19TH AVENUE AND 56 STREET TO 58 STREET IN THE BOROUGH OF BROOKLYN,GRAVESEND PARK RECONSTRUCTION,cpd11-20bk.pdf
P-213ALAE,Asser Levy Park - Adult Exercise Equipment (B080-118M),846,DEPT OF PARKS AND RECREATION,NEIGHBORHOOD PARKS AND PLAYGROUNDS,300,BROOKLYN,P-D017 P-1018,914,136,880,0,0,0,0,0,1016,136,880,0,0,0,0,0,1016,272,1760,0,0,0,0,0,2032,,,ADULT EXERCISE EQUIPMENT,cpd11-20bk.pdf
P-213ALVY,Asser Levy Park - B080,846,DEPT OF PARKS AND RECREATION,"LARGE, MAJOR AND REGIONAL PARK RECONSTRUCTION",300 313,BROOKLYN,P-1018,3780,4171,0,50,0,0,0,0,4221,4171,0,50,0,0,0,0,4221,8342,0,100,0,0,0,0,8442,PROJECT DELAYED PENDING RESOLUTION OF LEGAL ISSUES,"BOARDWALK, SURF AVENUE, SEA BREEZE AVENUE, OCEAN PARKWAY BROOKLYN",ASSER LEVY PARK,cpd11-20bk.pdf
P-213BABI,BABI YAR Triangle - Reconstruction,846,DEPT OF PARKS AND RECREATION,NEIGHBORHOOD PARKS AND PLAYGROUNDS,300,BROOKLYN,P-D017 P-1018,1636,243,0,1482,0,0,0,0,1725,243,0,1482,0,0,0,0,1725,486,0,2964,0,0,0,0,3450,,,RECONSTRUCTION,cpd11-20bk.pdf
P-213BOIL,ABE STARK BOILERS AND CHILLERS (B169-111M),846,DEPT OF PARKS AND RECREATION,MAJOR RECREATIONAL FACILITIES AND FACILITY RECONSTRUCTION,313 300,BROOKLYN,P-D017,1000,2684,0,47,1537,0,0,0,4268,2684,0,47,1537,0,0,0,4268,5368,0,94,3074,0,0,0,8536,PROJECT DELAYED DUE TO UNFORESEEN SITE/FIELD CONDITION,BOROUGH OF BROOKLYN,ABE STARK BOILERS AND CHILLERS,cpd11-20bk.pdf
P-213K11B,CONEY ISLAMD BWA;LK MISC RC W37-CORBIN B169-100MA,846,DEPT OF PARKS AND RECREATION,BEACHES AND BOARDWALKS,313,BROOKLYN,P-K011,1453,1141,92,0,0,0,0,0,1233,1141,92,0,0,0,0,0,1233,2282,184,0,0,0,0,0,2466,PROJECT DELAYED DUE TO BUDGETARY CONSTRAINTS,BROOKLYN CB 13,CONEY ISLAND BOARDWALK REPAIRS AND RENOVATIONS,cpd11-20bk.pdf
P-213SCRN,Scarangella Park C/S CONS B106-117M,846,DEPT OF PARKS AND RECREATION,NEIGHBORHOOD PARKS AND PLAYGROUNDS,313 300,BROOKLYN,P-0245K,2400,502,35,0,2359,0,0,0,2896,502,35,0,2359,0,0,0,2896,1004,70,0,4718,0,0,0,5792,PROJECT DELAYED PENDING RESOLUTION OF LEGAL ISSUES,"WEST 13 STREET, STILLWELL AVENUE, BETWEEN AVENUE U & AVENUE V",RECONSTRUCTION OF SCARANGELLA PARK,cpd11-20bk.pdf
P-213SNPK,Scarangella Park - Reconstruction of Playground B106A-120M,846,DEPT OF PARKS AND RECREATION,NEIGHBORHOOD PARKS AND PLAYGROUNDS,300,BROOKLYN,P-D017 P-K011,1182,474,139,0,6069,0,0,0,6682,474,139,0,6069,0,0,0,6682,948,278,0,12138,0,0,0,13364,PROJECT DELAYED DUE TO CHANGES IN SCOPE/DESIGN,,RECONSTRUCTION,cpd11-20bk.pdf
P-213SURF,SURF PLAYGROUND - PLAYGROUND RENOVATION (B315-118M),846,DEPT OF PARKS AND RECREATION,NEIGHBORHOOD PARKS AND PLAYGROUNDS,300,BROOKLYN,P-D017,4092,3369,0,112,0,0,0,0,3481,3369,0,112,0,0,0,0,3481,6738,0,224,0,0,0,0,6962,,,PLGD RENOVATION,cpd11-20bk.pdf
P-213WEST,West Playground CS B252-115M,846,DEPT OF PARKS AND RECREATION,NEIGHBORHOOD PARKS AND PLAYGROUNDS,313,BROOKLYN,P-D017,1800,556,233,0,1286,0,0,0,2075,556,233,0,1286,0,0,0,2075,1112,466,0,2572,0,0,0,4150,PROJECT DELAYED PENDING RESOLUTION OF LEGAL ISSUES,"AVENUE Z, BETWEEN WEST 1 STREET AND WEST STREET, BOROUGH OF BROOKLYN",WEST PLAYGROUND,cpd11-20bk.pdf
P-214ANDP,Andries Playground - Phase 1 & 2 Reconstruction,846,DEPT OF PARKS AND RECREATION,NEIGHBORHOOD PARKS AND PLAYGROUNDS,314,BROOKLYN,P-D017,1200,0,0,0,1200,0,0,0,1200,0,0,0,1200,0,0,0,1200,0,0,0,2400,0,0,0,2400,,"NOSTRAND AVE. BETWEEN AVE. L AND AVE. K, BROOKLYN",ANDRIES PLAYGROUND - PHASE 1 & 2 RECONSTRUCTION,cpd11-20bk.pdf
P-214KOLB,KOLBERT PLAYGROUND - RC (B150-115M),846,DEPT OF PARKS AND RECREATION,NEIGHBORHOOD PARKS AND PLAYGROUNDS,314 300,BROOKLYN,P-D017,600,3332,0,634,0,0,0,0,3966,3332,0,634,0,0,0,0,3966,6664,0,1268,0,0,0,0,7932,PROJECT DELAYED DUE TO UNFORESEEN SITE/FIELD CONDITION,"BOROUGH OF BROOKLYN - AVENUE L, EAST 17 STREET TO E. 18 STREET.",AVENUE L KOLBERT PLAYGROUND - PARK RENOVATION,cpd11-20bk.pdf
P-214KPKP,Kolbert Park RC Perimeter B150,846,DEPT OF PARKS AND RECREATION,NEIGHBORHOOD PARKS AND PLAYGROUNDS,300,BROOKLYN,P-D017,473,419,36,0,0,0,0,0,455,419,36,0,0,0,0,0,455,838,72,0,0,0,0,0,910,,RC PERIMTER SIDEWALKS,KOLBERT PARK RC PERIMETER,cpd11-20bk.pdf
P-214LTFN,Lt. Federico Navaez Tot Lot- RC B397-117M,846,DEPT OF PARKS AND RECREATION,NEIGHBORHOOD PARKS AND PLAYGROUNDS,300 314,BROOKLYN,P-1018,950,1334,0,99,0,0,0,0,1433,1334,0,99,0,0,0,0,1433,2668,0,198,0,0,0,0,2866,PROJECT DELAYED PENDING RESOLUTION OF LEGAL ISSUES,ARGYLE ROAD AND CORTELYOU ROAD. BROOKLYN,LT. FEDERICO NAVAEZ TOT LOT,cpd11-20bk.pdf
P-214PARK,CD #44- New Park /Playground,846,DEPT OF PARKS AND RECREATION,NEIGHBORHOOD PARKS AND PLAYGROUNDS,300,BROOKLYN,P-D017,1065,0,990,0,0,0,0,0,990,0,990,0,0,0,0,0,990,0,1980,0,0,0,0,0,1980,,"COUNCIL DISTRICT 44, CB#14, BOROUGH OF BROOKLYN",NEW PARK/ PLAYGROUND IN CD#44- NOT YET IDENTIFIED,cpd11-20bk.pdf
P-214RIDE,PPA - GALLOPNYC- RIDING RING IN PROSP. PK,846,DEPT OF PARKS AND RECREATION,"LARGE, MAJOR AND REGIONAL PARK RECONSTRUCTION",314 300,BROOKLYN,P-D017 P-K001,2900,0,680,1460,2000,0,0,0,4140,0,680,1460,2000,0,0,0,4140,0,1360,2920,4000,0,0,0,8280,PROJECT DELAYED DUE TO CHANGES IN SCOPE/DESIGN,"BROOKLYN - PARKSIDE AVENUE, CATON AVENUEM BETWEEN PARADE PLACE AND CONEY ISLAND",PROJECT TO BUILD A RIDING ARENA IN PROSPECT PARK,cpd11-20bk.pdf
P-214UMMA,Umma Park & Plg Reconstruction,846,DEPT OF PARKS AND RECREATION,NEIGHBORHOOD PARKS AND PLAYGROUNDS,300,BROOKLYN,P-K001 P-K011,295,0,0,0,600,250,0,0,850,0,0,0,600,250,0,0,850,0,0,0,1200,500,0,0,1700,,,UMMA PARK AND PLAYGROUND REHABILITATION,cpd11-20bk.pdf
P-215BBPG,BILL BROWN PLAYGROUND FLDHSE CMFT ST. FY'10 B109-112M,846,DEPT OF PARKS AND RECREATION,NEIGHBORHOOD PARKS AND PLAYGROUNDS,315 300,BROOKLYN,P-1018,1400,5894,180,37,0,0,0,0,6111,5894,180,37,0,0,0,0,6111,11788,360,74,0,0,0,0,12222,PROJECT DELAYED DUE TO UNFORESEEN SITE/FIELD CONDITION,BEDFORD AVENUE BETWEEN AVENUE X & AVENUE Y,RECONSTRUCT FIELD HOUSE INCLUDING NEW REST ROOMS AND COMMUNITY SPACE.,cpd11-20bk.pdf
P-215HCPL,HOMECREST PLAYGROUND,846,DEPT OF PARKS AND RECREATION,NEIGHBORHOOD PARKS AND PLAYGROUNDS,300,BROOKLYN,P-1018,2200,4113,239,0,0,0,0,0,4352,4113,239,0,0,0,0,0,4352,8226,478,0,0,0,0,0,8704,,HOMECREST PLAYGROUNG,HOMECREST PLAYGROUND,cpd11-20bk.pdf
P-215KELL,Kelly Park Playground - Recon. of Playground (B051-120M),846,DEPT OF PARKS AND RECREATION,NEIGHBORHOOD PARKS AND PLAYGROUNDS,300,BROOKLYN,P-0245K P-1018,1761,168,0,0,0,0,0,0,168,168,0,0,0,0,0,0,168,336,0,0,0,0,0,0,336,PROJECT DELAYED DUE TO CHANGES IN SCOPE/DESIGN,,KELLY PARY,cpd11-20bk.pdf
P-215KLCS,KELLY PARK COMFORT STATION,846,DEPT OF PARKS AND RECREATION,NEIGHBORHOOD PARKS AND PLAYGROUNDS,300,BROOKLYN,P-1072 P-K011,1425,0,0,925,0,500,0,0,1425,0,0,925,0,500,0,0,1425,0,0,1850,0,1000,0,0,2850,,BROOKLYN,KELLY PLGD COMFORT STATION,cpd11-20bk.pdf
P-215KLLY,Kelly Playground - Renovate,846,DEPT OF PARKS AND RECREATION,NEIGHBORHOOD PARKS AND PLAYGROUNDS,300 315,BROOKLYN,P-D017,2843,342,0,0,2501,0,0,0,2843,342,0,0,2501,0,0,0,2843,684,0,0,5002,0,0,0,5686,,AVENUE S. MORRE PLACE BETWEEN E 16 STREET AND E17 STREET,KELLY PLAYGROUND - RENOVATION PLAYGROUND,cpd11-20bk.pdf
P-215MBGD,MANHATTAN BCH. COMM. GARDEN & DOG RUN (B251-117M),846,DEPT OF PARKS AND RECREATION,NEIGHBORHOOD PARKS AND PLAYGROUNDS,315 300,BROOKLYN,P-0245K,500,1055,56,0,0,0,0,0,1111,1055,56,0,0,0,0,0,1111,2110,112,0,0,0,0,0,2222,PROJECT DELAYED PENDING RESOLUTION OF LEGAL ISSUES,BOROUGH OF BROOKLYN,MANHATTAN BEACH COMMUNITY GARDEN & DOG RUN- REPLACE CURRENT DOG RUN WITH COMMUNITY,cpd11-20bk.pdf
P-215MBP2,Manhattan Beach Park - Ctr Promenade & Beach Entryway Recons,846,DEPT OF PARKS AND RECREATION,"LARGE, MAJOR AND REGIONAL PARK RECONSTRUCTION",300,BROOKLYN,P-1018 P-1245,4582,507,401,0,0,0,0,0,908,507,401,0,0,0,0,0,908,1014,802,0,0,0,0,0,1816,,,PHASE 2,cpd11-20bk.pdf
P-215MBTC,Manhattan Beach Park,846,DEPT OF PARKS AND RECREATION,"LARGE, MAJOR AND REGIONAL PARK RECONSTRUCTION",315,BROOKLYN,P-D017,3800,82,312,0,3488,0,0,0,3882,82,312,0,3488,0,0,0,3882,164,624,0,6976,0,0,0,7764,,,MANHATTAN BEACH PARK,cpd11-20bk.pdf
P-215MCDD,McDonald Playground - RC Play Equipment Area B244-118M,846,DEPT OF PARKS AND RECREATION,NEIGHBORHOOD PARKS AND PLAYGROUNDS,300 315,BROOKLYN,P-D017 P-0935 P-K011 P-0245K,1010,500,0,0,3298,0,0,0,3798,500,0,0,3298,0,0,0,3798,1000,0,0,6596,0,0,0,7596,PROJECT DELAYED PENDING RESOLUTION OF LEGAL ISSUES,BROOKLYN - MCDONALD BETWEEN AVENUE S & AVENUE T,MCDONALD PLAYGROUND,cpd11-20bk.pdf
P-215MELL,MELLET PLAYGROUND- RECONSTRUCT PLAYGROUND (B197-118M),846,DEPT OF PARKS AND RECREATION,NEIGHBORHOOD PARKS AND PLAYGROUNDS,300,BROOKLYN,P-D017 P-0245K,2728,250,0,2295,0,0,0,0,2545,250,0,2295,0,0,0,0,2545,500,0,4590,0,0,0,0,5090,,,RECONSTRUCTION,cpd11-20bk.pdf
P-215MHAT,Manhattan Beach Park B251-115M,846,DEPT OF PARKS AND RECREATION,"LARGE, MAJOR AND REGIONAL PARK RECONSTRUCTION",315,BROOKLYN,P-D017,1500,1592,0,68,0,0,0,0,1660,1592,0,68,0,0,0,0,1660,3184,0,136,0,0,0,0,3320,PROJECT DELAYED DUE TO UNFORESEEN SITE/FIELD CONDITION,"ORIENTAL BLVD, BETWEEN OCEAN AVENUE AND MACKENZIE STREET","MANHATTAN BEACH PARK - PLAYGROUND UPGRADE, FENCING, DOGRUN, BASKETBALL COURTS",cpd11-20bk.pdf
P-215MHBP,Manhattan Beach promenade (B251-217M),846,DEPT OF PARKS AND RECREATION,"LARGE, MAJOR AND REGIONAL PARK RECONSTRUCTION",300,BROOKLYN,P-1018,2000,3593,235,0,0,0,0,0,3828,3593,235,0,0,0,0,0,3828,7186,470,0,0,0,0,0,7656,,ORIENTAL BLVED BETWEEN OCEAN AVENUE AND MACKENZIE STREET. BROOKLYN,MANHATTAN BEACH PROMENADE,cpd11-20bk.pdf
P-215PB15,EMMONS AVENUE SIDEWALKS & SHEEPSHEAD PIER RCNSTR NYSMMGRANTS,846,DEPT OF PARKS AND RECREATION,NEIGHBORHOOD PARKS AND PLAYGROUNDS,315 300,BROOKLYN,P-0245K,407,51,0,0,0,0,0,0,51,51,0,0,0,0,0,0,51,102,0,0,0,0,0,0,102,PROJECT DELAYED PENDING NON-CITY GRANT APPROVAL,"BRIGHTON 15TH ST AND CONEY ISLAND AVENUE, BROOKLYN","PEDESTRIAN BIKEWAY CONSTRUCTION, BRIGHTON 15TH ST AND CONEY ISLAND AVENUE, BROOKLYN",cpd11-20bk.pdf
P-215PIER,SHEEPSHEAD BAY PIERS B393-118M,846,DEPT OF PARKS AND RECREATION,MAJOR RECREATIONAL FACILITIES AND FACILITY RECONSTRUCTION,300,BROOKLYN,PU-0200 P-0501,4096,367,0,2705,1024,0,0,0,4096,367,0,2705,1024,0,0,0,4096,734,0,5410,2048,0,0,0,8192,,SHEEPSHEAD BAY PIERS,SHEEPSHEAD BAY PIERS,cpd11-20bk.pdf
P-216BHIP,BETSY HEAD - IMAGINATION PLGD CS B008,846,DEPT OF PARKS AND RECREATION,"LARGE, MAJOR AND REGIONAL PARK RECONSTRUCTION",300,BROOKLYN,P-0505,2000,3427,985,0,0,0,0,0,4412,3427,985,0,0,0,0,0,4412,6854,1970,0,0,0,0,0,8824,,,BETSY HEAD - IMAGINATION PLGD CS,cpd11-20bk.pdf
P-216CHES,Chester Park - Playground Renovation Phase 1,846,DEPT OF PARKS AND RECREATION,NEIGHBORHOOD PARKS AND PLAYGROUNDS,316,BROOKLYN,P-0245K P-D017,6000,150,800,0,0,7200,0,0,8150,150,800,0,0,7200,0,0,8150,300,1600,0,0,14400,0,0,16300,,"CHESTER ST. TO BRISTOL ST. BETWEEN SUTTER AVE. AND PITKIN AVE., BROOKLYN",CHESTER PARK - PLAYGROUND RENOVATION PHASE 1,cpd11-20bk.pdf
P-216OCAN,Ocean Hill Playground - Brooklyn,846,DEPT OF PARKS AND RECREATION,NEIGHBORHOOD PARKS AND PLAYGROUNDS,300,BROOKLYN,P-0245K,5891,663,0,791,4130,0,0,0,5584,663,0,791,4130,0,0,0,5584,1326,0,1582,8260,0,0,0,11168,,,OCEAN HILL PLAYGROUND - BROOKLYN,cpd11-20bk.pdf
P-216OSBN,Osborn Playground - Park Renovation (B343-119M),846,DEPT OF PARKS AND RECREATION,NEIGHBORHOOD PARKS AND PLAYGROUNDS,300 316,BROOKLYN,P-D017,3427,367,1,0,2807,0,0,0,3175,367,1,0,2807,0,0,0,3175,734,2,0,5614,0,0,0,6350,,"LINDEN BLVD, OSBORN STREET, ROCKAWAY AVENUE, HEGEMAN AVENUE IN THE BOROUGH OF",OSBORN PLAYGORUND PARK RENOVATION-CONVERT EXISTING FIELD TO SYNTHETICTURF WITH,cpd11-20bk.pdf
P-216OSPL,Osborn Playground - Phase 2 Reconstruction,846,DEPT OF PARKS AND RECREATION,NEIGHBORHOOD PARKS AND PLAYGROUNDS,316,BROOKLYN,P-D017,1075,0,0,0,1000,0,0,0,1000,0,0,0,1000,0,0,0,1000,0,0,0,2000,0,0,0,2000,,"LINDEN BLVD., OSBORN ST., ROCKAWAY AVE., HEGEMAN AVE., BROOKLYN",OSBORN PLAYGROUND - PHASE 2 RECONSTRUCTION,cpd11-20bk.pdf
P-216PS25,PS 125 Playground - Brooklyn,846,DEPT OF PARKS AND RECREATION,NEIGHBORHOOD PARKS AND PLAYGROUNDS,300,BROOKLYN,P-0245K,1064,163,900,0,0,0,0,0,1063,163,900,0,0,0,0,0,1063,326,1800,0,0,0,0,0,2126,,,PS 125 PLAYGROUND - BROOKLYN,cpd11-20bk.pdf
P-217AQBO,Paerdegat Aquatic Center Boiler Reconstruction,846,DEPT OF PARKS AND RECREATION,MAJOR RECREATIONAL FACILITIES AND FACILITY RECONSTRUCTION,300,BROOKLYN,P-1250,500,0,500,0,0,0,0,0,500,0,500,0,0,0,0,0,500,0,1000,0,0,0,0,0,1000,,,PAERDEGAT AQUATIC CENTER BOILER RECONSTRUCTION,cpd11-20bk.pdf
P-217C17F,"HARRY MAZE MEMORIAL PARK RECONSTR PLGD AREA, B285-103M",846,DEPT OF PARKS AND RECREATION,NEIGHBORHOOD PARKS AND PLAYGROUNDS,317,BROOKLYN,P-D017,1022,835,60,0,0,0,0,0,895,835,60,0,0,0,0,0,895,1670,120,0,0,0,0,0,1790,PROJECT DELAYED DUE TO UNFORESEEN SITE/FIELD CONDITION,BROOKLYN CB 17,HARRY MAZE PARK,cpd11-20bk.pdf
P-217C17H,"WYCKOFF HOUSE PARK RECONSTR, B376-102MA1 & B376-104M OMBP",846,DEPT OF PARKS AND RECREATION,MAJOR RECREATIONAL FACILITIES AND FACILITY RECONSTRUCTION,317,BROOKLYN,P-D017,769,475,41,0,0,0,0,0,516,475,41,0,0,0,0,0,516,950,82,0,0,0,0,0,1032,PROJECT DELAYED DUE TO CHANGES IN SCOPE/DESIGN,"WYCKOFF HISTORICAL HOUSE, BROOKLYN, CB 17",WYCKOFF HOUSE LANDSCAPE AND IRRIGATION SYSEM FOR SURROUNDING PARK,cpd11-20bk.pdf
P-217D017,WYCKOFF HOUSE PARK CULT. EDUC. COMPLX B376-113M,846,DEPT OF PARKS AND RECREATION,MAJOR RECREATIONAL FACILITIES AND FACILITY RECONSTRUCTION,317,BROOKLYN,P-D017 P-K011,2250,1636,280,0,4189,0,0,0,6105,1636,280,0,4189,0,0,0,6105,3272,560,0,8378,0,0,0,12210,PROJECT DELAYED DUE TO CHANGES IN SCOPE/DESIGN,"WYCKOFF HOUSE AND GROUNDS, BROOKLYN",WYCKOFF HOUSE MUSEUM AND SURROUNDING PASSIVE PARK...FY20 JAN PLAN ROLLS,cpd11-20bk.pdf
P-217HMCS,Harry Maze Playground - Comfort Station Reconstruction,846,DEPT OF PARKS AND RECREATION,NEIGHBORHOOD PARKS AND PLAYGROUNDS,317,BROOKLYN,P-D017,0,0,500,0,0,0,0,0,500,0,500,0,0,0,0,0,500,0,1000,0,0,0,0,0,1000,,"AVE. D, DITMAS AVE. BET. E. 56 ST. AND E. 57 ST., BROOKLYN",HARRY MAZE PLAYGROUND - COMFORT STATION RECONSTRUCTION,cpd11-20bk.pdf
P-217NOST,Nostrand Playground - B250-117M,846,DEPT OF PARKS AND RECREATION,NEIGHBORHOOD PARKS AND PLAYGROUNDS,317 300,BROOKLYN,P-D017 P-1018,3043,2233,1,620,0,0,0,0,2854,2233,1,620,0,0,0,0,2854,4466,2,1240,0,0,0,0,5708,PROJECT DELAYED DUE TO UNFORESEEN SITE/FIELD CONDITION,BOROUGH OF BROOKLYN-NOSTRAND AVENUE BETWEEN FOSTER AVENUE AND FARRAGUT PLACE,NOSTRAND PLAYGROUND,cpd11-20bk.pdf
P-217PAER,"PAERDEGAT PK- RECON. BSKT BALL, SIDEWALKS, LIGHTS, B218-112M",846,DEPT OF PARKS AND RECREATION,NEIGHBORHOOD PARKS AND PLAYGROUNDS,317 300,BROOKLYN,P-D017,800,1878,27,68,0,0,0,0,1973,1878,27,68,0,0,0,0,1973,3756,54,136,0,0,0,0,3946,PROJECT DELAYED DUE TO UNFORESEEN SITE/FIELD CONDITION,"BOROUGH OF BROOKLYN - FOSTER AVENUE, E. 40 -41 STREETS","RECONSTRUCTION OF SIDEWALKS, INSTALLATION OF EQUIPMENT ALONG PATHWAYS.",cpd11-20bk.pdf
P-217PDGT,PAERDEGAT ATHLETIC CLUB - HVAC WORK,846,DEPT OF PARKS AND RECREATION,NEIGHBORHOOD PARKS AND PLAYGROUNDS,300,BROOKLYN,P-1018 P-1250,1850,420,10,552,0,0,0,0,982,420,10,552,0,0,0,0,982,840,20,1104,0,0,0,0,1964,PROJECT DELAYED DUE TO CHANGES IN SCOPE/DESIGN,BOROUGH OF BROOKLYN,PAERDEGAT ATHLETIC CLUB HVAC WORK,cpd11-20bk.pdf
P-217TILD,TILDEN PLAYGROUND-SHIRLEY CHISHOLM COMM CTR B234,846,DEPT OF PARKS AND RECREATION,NEIGHBORHOOD PARKS AND PLAYGROUNDS,300,BROOKLYN,P-0245K P-D017 P-D056 P-K011,7255,3012,0,14000,2000,13349,25000,0,57361,3012,0,14000,2000,13349,25000,0,57361,6024,0,28000,4000,26698,50000,0,114722,,,TILDEN PLAYGROUND-SHIRLEY CHISHOLM COMM CTR B234,cpd11-20bk.pdf
P-217WYKF,WYCKOFF FARMHOUSE - ROOF RESTORATION B376-111M,846,DEPT OF PARKS AND RECREATION,MAJOR RECREATIONAL FACILITIES AND FACILITY RECONSTRUCTION,300,BROOKLYN,P-0245K,550,230,0,0,0,0,0,0,230,230,0,0,0,0,0,0,230,460,0,0,0,0,0,0,460,PROJECT DELAYED DUE TO CHANGES IN SCOPE/DESIGN,BOROUGH OF BROOKLYN,FARMHOUSE ROOF RESTORATION,cpd11-20bk.pdf
P-218BILD,Bildersee Playground (B335-116M),846,DEPT OF PARKS AND RECREATION,NEIGHBORHOOD PARKS AND PLAYGROUNDS,318,BROOKLYN,P-D017 P-1018,1825,4405,543,596,0,0,0,0,5544,4405,543,596,0,0,0,0,5544,8810,1086,1192,0,0,0,0,11088,PROJECT DELAYED DUE TO UNFORESEEN SITE/FIELD CONDITION,"FLATLANDS AVENUE BETWEEN EAST 81 STREET AND EAST 82 STREET, BOROUGH OF BROOKLYN",BILDERSEE PLAYGROUND - MULTIPURPOSE PLAY AREA AND PLAYGROUND,cpd11-20bk.pdf
P-218BPLG,Bildersee plgd-new plgd and ph2,846,DEPT OF PARKS AND RECREATION,NEIGHBORHOOD PARKS AND PLAYGROUNDS,300,BROOKLYN,P-K011 P-0245K,3227,36,0,0,0,1367,0,0,1403,36,0,0,0,1367,0,0,1403,72,0,0,0,2734,0,0,2806,PROJECT DELAYED DUE TO BUDGETARY CONSTRAINTS,,RECONSTRUCTION,cpd11-20bk.pdf
P-218CCMF,CANARSIE PARK PHASE V- COMFORT STATION B018-214M,846,DEPT OF PARKS AND RECREATION,"LARGE, MAJOR AND REGIONAL PARK RECONSTRUCTION",318 300,BROOKLYN,P-D017 P-K011 P-1018,850,755,2711,411,0,0,0,0,3877,755,2711,411,0,0,0,0,3877,1510,5422,822,0,0,0,0,7754,PROJECT DELAYED DUE TO CHANGES IN SCOPE/DESIGN,"SEAVIEW AVENUE BETWEEN PAERDEGAT BASIN AND EAST 93 STREET, EAST 102 STREET AND FRESH","NEW COMFORT STATION FOR CRICKET, SKATE PARK AND PLAYGROUND",cpd11-20bk.pdf
P-218D17L,LINDOWER (ALEX LINDOWER) PARK PLAYGROUND PH 1 B329-109M,846,DEPT OF PARKS AND RECREATION,NEIGHBORHOOD PARKS AND PLAYGROUNDS,318,BROOKLYN,P-D017,300,2675,216,0,0,0,0,0,2891,2675,216,0,0,0,0,0,2891,5350,432,0,0,0,0,0,5782,PROJECT DELAYED DUE TO BUDGETARY CONSTRAINTS,LINDOWER PARK (ALEX LINDOWER PARK),LINDOWER PARK PLAYGROUND PHASE 1,cpd11-20bk.pdf
P-218D17S,DR. JOHN'S PLAYGROUND- MARINE PK (B057-114M),846,DEPT OF PARKS AND RECREATION,"LARGE, MAJOR AND REGIONAL PARK RECONSTRUCTION",318 300,BROOKLYN,P-D017,1200,3408,0,111,0,0,0,0,3519,3408,0,111,0,0,0,0,3519,6816,0,222,0,0,0,0,7038,PROJECT DELAYED DUE TO UNFORESEEN SITE/FIELD CONDITION,"BOROUGH OF BROOKLYN -FLATBUSH , GERRITSEN & FILLMORE AVENUES, JAMAICABAY","RECONSTRUCT PLAYGROUND WITH NEW EQUIPMENT, SAFETY SURFACE, ETC.",cpd11-20bk.pdf
P-218GERT,Marine Park - Gerritsen Ave. Ped. Path PH 2 (B057-117M),846,DEPT OF PARKS AND RECREATION,"LARGE, MAJOR AND REGIONAL PARK RECONSTRUCTION",300 318,BROOKLYN,P-0245K,500,444,60,0,0,0,0,0,504,444,60,0,0,0,0,0,504,888,120,0,0,0,0,0,1008,,BOROUGH OF BROOKLYN,MARINE PARK GERRITSEN AVENUE PEDESTRIAN PATH PH 2,cpd11-20bk.pdf
P-218GLEN,Glenwood Playground - recon. multi-purpose area B236-114M,846,DEPT OF PARKS AND RECREATION,NEIGHBORHOOD PARKS AND PLAYGROUNDS,318 300,BROOKLYN,P-D017,1500,1766,0,280,779,0,0,0,2825,1766,0,280,779,0,0,0,2825,3532,0,560,1558,0,0,0,5650,PROJECT DELAYED DUE TO UNFORESEEN SITE/FIELD CONDITION,"RALPH AVENUE AND FARRAGUT ROAD, BOROUGH OF BROOKLYN","RECONSTRUCTION ASPHALT MULTI PURPOSE PLAY AREA FOR SOFTBALL, SOCCER AND FOOTBALL.",cpd11-20bk.pdf
P-218GOLF,BK Golf Alliance - Marine Pk. Golf Course - B057-119M,846,DEPT OF PARKS AND RECREATION,"LARGE, MAJOR AND REGIONAL PARK RECONSTRUCTION",318 300,BROOKLYN,P-K011 P-D017,840,276,0,0,1450,0,0,0,1726,276,0,0,1450,0,0,0,1726,552,0,0,2900,0,0,0,3452,PROJECT DELAYED DUE TO CHANGES IN SCOPE/DESIGN,"BOROUGH OF BROOKLYN - FLATBUSH AVENUE, GERRITSEN AVENUE, FILLMORE AVENUE, JAMAICA BAY",BROOKLYN GOLF ALLIANCE INC. - MARINE PARK GOLF COURSE,cpd11-20bk.pdf
P-218JCOB,Jacob Joffe Playground - B324,846,DEPT OF PARKS AND RECREATION,NEIGHBORHOOD PARKS AND PLAYGROUNDS,300 318,BROOKLYN,P-D017,1064,1216,0,96,0,0,0,0,1312,1216,0,96,0,0,0,0,1312,2432,0,192,0,0,0,0,2624,PROJECT DELAYED DUE TO UNFORESEEN SITE/FIELD CONDITION,AVENUE K BETWEEN E. 58 STREET & E. 59 STREET.,JACOB JOFFE PLAYGROUND,cpd11-20bk.pdf
P-218JFEE,Jacob Joffe Playground- Park Renovations,846,DEPT OF PARKS AND RECREATION,"LARGE, MAJOR AND REGIONAL PARK RECONSTRUCTION",300,BROOKLYN,P-K011,3000,3137,254,0,0,0,0,0,3391,3137,254,0,0,0,0,0,3391,6274,508,0,0,0,0,0,6782,,AVENUE K BETWEEN EAST 58 STREET AND EAST 59 STREET.,JACOB JOFFE PLAYGROUND,cpd11-20bk.pdf
P-218LOTT,HENDRICK I. LOTT HOUSE -INTERIOR RESTORATION,846,DEPT OF PARKS AND RECREATION,MAJOR RECREATIONAL FACILITIES AND FACILITY RECONSTRUCTION,300 318,BROOKLYN,P-D017,800,131,816,0,1750,0,0,0,2697,131,816,0,1750,0,0,0,2697,262,1632,0,3500,0,0,0,5394,PROJECT DELAYED DUE TO CHANGES IN SCOPE/DESIGN,BOROUGH OF BROOKLYN,PHASE 3 - RENOVATION OF THE INTERIOR OF THE HOUSE FOR PUBLIC USE,cpd11-20bk.pdf
P-218MPOV,Marine Park,846,DEPT OF PARKS AND RECREATION,"LARGE, MAJOR AND REGIONAL PARK RECONSTRUCTION",315 318,BROOKLYN,P-D017 P-0077,5114,250,0,0,0,7500,6000,0,13750,250,0,0,0,7500,6000,0,13750,500,0,0,0,15000,12000,0,27500,,,MARINE PARK BICYCLE AND PEDESTRIAN OVALS - RE-SURFACE ASPHALT TRACK.,cpd11-20bk.pdf
P-218MPPG,Marine Park Playground - Reconstruction of Playground 278,846,DEPT OF PARKS AND RECREATION,NEIGHBORHOOD PARKS AND PLAYGROUNDS,318 315,BROOKLYN,P-0245K P-D017,4000,60,0,0,1930,0,0,0,1990,60,0,0,1930,0,0,0,1990,120,0,0,3860,0,0,0,3980,,,RECONSTRUCTION OF A PLAYGROUND AT MARINE PARK IN BROOKLYN,cpd11-20bk.pdf
P-218PWMP,Power-Memorial- Seating Area ( B219-120M),846,DEPT OF PARKS AND RECREATION,NEIGHBORHOOD PARKS AND PLAYGROUNDS,300 318,BROOKLYN,P-D017 P-K001 P-K011,250,145,191,0,3874,0,0,0,4210,145,191,0,3874,0,0,0,4210,290,382,0,7748,0,0,0,8420,PROJECT DELAYED DUE TO CHANGES IN SCOPE/DESIGN,AVENUE N BETWEEN EAST 49 STREET & UTICA AVENUE,POWER -MEMORIAL PLAYGROUND,cpd11-20bk.pdf
P-218SUNN,Sunners Playground - Renovate Playground (B206-119M),846,DEPT OF PARKS AND RECREATION,NEIGHBORHOOD PARKS AND PLAYGROUNDS,300 318,BROOKLYN,P-D017,1432,202,0,0,1250,0,0,0,1452,202,0,0,1250,0,0,0,1452,404,0,0,2500,0,0,0,2904,,"AVENUE H BETWEEN KINGS HIGHWAY, EAST 49 STREET IN THE BOROUGH OF BROOKLYN",RENOVATION OF PLAYGROUND DEVASTATED BY HURRICANE SANDY - SUNNERS PLAYGROUND,cpd11-20bk.pdf
P-2ANCH01,ANCHOR PARK- Betsy Head (B008-),846,DEPT OF PARKS AND RECREATION,"LARGE, MAJOR AND REGIONAL PARK RECONSTRUCTION",300 316,BROOKLYN,P-0605 P-1018,10388,2770,386,0,0,0,0,0,3156,2770,386,0,0,0,0,0,3156,5540,772,0,0,0,0,0,6312,,"BLAKE AVENUE, DUMONT AVENUE, LIVONIA AVENUE BETWEEN STRAUSS STREET, HOPKINSON AVENUE",BETSY HEAD,cpd11-20bk.pdf
P-2ANCH02,Betsy Head Park Comfort Station Reconstruction (B008-218M),846,DEPT OF PARKS AND RECREATION,"LARGE, MAJOR AND REGIONAL PARK RECONSTRUCTION",300,BROOKLYN,P-0605,4000,2818,122,0,0,0,0,0,2940,2818,122,0,0,0,0,0,2940,5636,244,0,0,0,0,0,5880,,,BETSY HEAD RECONSTRUCTION,cpd11-20bk.pdf
P-2ANCH03,"Betsy Head Park Syn. Turf, Field, Track, Sport Crts Ft Ctr",846,DEPT OF PARKS AND RECREATION,"LARGE, MAJOR AND REGIONAL PARK RECONSTRUCTION",300,BROOKLYN,P-0605,20091,14407,4268,0,0,0,0,0,18675,14407,4268,0,0,0,0,0,18675,28814,8536,0,0,0,0,0,37350,,,BETSY HEAD,cpd11-20bk.pdf
P-2ANCH04,ANCHOR PARK- Betsy Head Multi-Purpose Play Area Reconst.,846,DEPT OF PARKS AND RECREATION,"LARGE, MAJOR AND REGIONAL PARK RECONSTRUCTION",300 316,BROOKLYN,P-1018,7200,6246,557,0,0,0,0,0,6803,6246,557,0,0,0,0,0,6803,12492,1114,0,0,0,0,0,13606,,,BETSY HEAD,cpd11-20bk.pdf
P-2BELTPA,Belt Pkwy Lndscp Restoration & Tree Planting Ph2 B166-113M,846,DEPT OF PARKS AND RECREATION,LAND ACQUISITION AND TREE PLANTING,300,BROOKLYN,P-0822,2260,6822,1764,0,0,0,0,0,8586,6822,1764,0,0,0,0,0,8586,13644,3528,0,0,0,0,0,17172,PROJECT DELAYED DUE TO CHANGES IN SCOPE/DESIGN,,RESTORATION OF LANDSCAPE AND TREE PLANTING ALONG THE BELT PARKWAY,cpd11-20bk.pdf
P-2BELTPC,FY14 Belt Parkway Street Trees,846,DEPT OF PARKS AND RECREATION,LAND ACQUISITION AND TREE PLANTING,399,BROOKLYN,P-0822 HB-0643,5826,5943,1598,140,0,0,0,0,7681,5943,1598,140,0,0,0,0,7681,11886,3196,280,0,0,0,0,15362,PROJECT DELAYED DUE TO UNFORESEEN SITE/FIELD CONDITION,BROOKLYN,STREET TREE PLANTING,cpd11-20bk.pdf
P-2BELTPD,CON - BIKE PATH THRU CANARSIE PARK WEST,846,DEPT OF PARKS AND RECREATION,LAND ACQUISITION AND TREE PLANTING,300,BROOKLYN,P-1018,1550,182,0,0,0,0,0,0,182,182,0,0,0,0,0,0,182,364,0,0,0,0,0,0,364,PROJECT DELAYED DUE TO CHANGES IN SCOPE/DESIGN,BOROUGH OF BROOKLYN,CONSTRUCTION OF BIKE PATH THRU CANARSIE PARK WEST,cpd11-20bk.pdf
P-2BELTPE,Mill Basin Bridge Trees,846,DEPT OF PARKS AND RECREATION,LAND ACQUISITION AND TREE PLANTING,300,BROOKLYN,HB-1023 PU-0200,10429,976,41,10269,0,0,0,0,11286,976,41,10269,0,0,0,0,11286,1952,82,20538,0,0,0,0,22572,,MIL BASIN BRIDGE TREES,MIL BASIN BRIDGE TREES,cpd11-20bk.pdf
P-2BKPAV1,Brooklyn Multisite Pavement Reconstruction,846,DEPT OF PARKS AND RECREATION,NEIGHBORHOOD PARKS AND PLAYGROUNDS,300,BROOKLYN,P-1018,2290,356,8,0,1583,1900,1000,0,4847,356,8,0,1583,1900,1000,0,4847,712,16,0,3166,3800,2000,0,9694,,BROOKLYN,BROOKLYN MULTISITE PAVEMENT RECONSTRUCTION,cpd11-20bk.pdf
P-2BKPLG1,Brooklyn MPPA SOGR Reconstruction,846,DEPT OF PARKS AND RECREATION,NEIGHBORHOOD PARKS AND PLAYGROUNDS,300,BROOKLYN,WP-0169 P-1018,3200,50,3506,0,4000,0,0,0,7556,50,3506,0,4000,0,0,0,7556,100,7012,0,8000,0,0,0,15112,,BROOKLYN,"THIS PROJECT WILL RECONSTRUCT MULTI-PURPOSE PLAY AREAS IN DYKER PLAYGROUND, O'ROURKE",cpd11-20bk.pdf
P-2BQGRN,BQ GREEN,846,DEPT OF PARKS AND RECREATION,NEIGHBORHOOD PARKS AND PLAYGROUNDS,300,BROOKLYN,P-D017,11818,300,0,0,0,3375,0,0,3675,300,0,0,0,3375,0,0,3675,600,0,0,0,6750,0,0,7350,PROJECT DELAYED DUE TO CHANGES IN SCOPE/DESIGN,,BQ GREEN,cpd11-20bk.pdf
P-2BRIGHM,Brigham Park - plgd & passive area B057-212M/512M,846,DEPT OF PARKS AND RECREATION,NEIGHBORHOOD PARKS AND PLAYGROUNDS,315 318 300,BROOKLYN,P-D017 P-0245K P-1018,400,6026,613,0,0,0,0,0,6639,6026,613,0,0,0,0,0,6639,12052,1226,0,0,0,0,0,13278,PROJECT DELAYED PENDING RESOLUTION OF LEGAL ISSUES,BOROUGH OF BROOKLYN,GRIGHAM STREET PARK DESIGN,cpd11-20bk.pdf
P-2BSKBL1,Brooklyn Basketball Courts Reconstruction (SoGR) BG-320M,846,DEPT OF PARKS AND RECREATION,NEIGHBORHOOD PARKS AND PLAYGROUNDS,300,BROOKLYN,WP-0169 P-1018,2800,45,1516,0,2000,0,0,0,3561,45,1516,0,2000,0,0,0,3561,90,3032,0,4000,0,0,0,7122,,BROOKLYN,BROOKLYN BASKETBALL COURTS RECONSTRUCTION (SOGR),cpd11-20bk.pdf
P-2BWCC04,BKLYN MULTISITE CMFT STA.- TILDEN & BANNEKER BG-111M,846,DEPT OF PARKS AND RECREATION,NEIGHBORHOOD PARKS AND PLAYGROUNDS,300 303 318,BROOKLYN,P-D017 P-1018,1300,264,0,1674,0,0,0,0,1938,264,0,1674,0,0,0,0,1938,528,0,3348,0,0,0,0,3876,PROJECT DELAYED PENDING RESOLUTION OF LEGAL ISSUES,IN BOROUGH OF BROOKLYN.,RECONSTRUCTION OF COMFORT STATIONS AT BANNEKER AND TILDEN PLAYGROUNDS,cpd11-20bk.pdf
P-2BWK11I,RQMT CNTR BKLYN BP FY00 PLEQ SFTYSRF PAV FNC GNLSW BG-300M,846,DEPT OF PARKS AND RECREATION,NEIGHBORHOOD PARKS AND PLAYGROUNDS,300,BROOKLYN,P-K011,966,929,35,0,0,0,0,0,964,929,35,0,0,0,0,0,964,1858,70,0,0,0,0,0,1928,,BROOKLYN,BROOKLYN REQUIREMENTS CONTRACT FY2000 BP FUNDS,cpd11-20bk.pdf
P-2BWK11J,BROOKLYN REQMT FY03/4 INCL OCEAN PKWY MALLS BENCHES BG-504M,846,DEPT OF PARKS AND RECREATION,NEIGHBORHOOD PARKS AND PLAYGROUNDS,300 307 312 313 314 315,BROOKLYN,P-K011,839,579,119,0,0,0,0,0,698,579,119,0,0,0,0,0,698,1158,238,0,0,0,0,0,1396,PROJECT DELAYED DUE TO CHANGES IN SCOPE/DESIGN,BROOKLYN BOROUGH-WIDE,BROOKLYN PARKS REQUIREMENT CONTRACT FY03,cpd11-20bk.pdf
P-2CIBBOL,Coney Island Boardwalk - Cons Security Measures B169-120M,846,DEPT OF PARKS AND RECREATION,"LARGE, MAJOR AND REGIONAL PARK RECONSTRUCTION",300,BROOKLYN,P-1095,0,0,0,1150,4000,0,0,0,5150,0,0,1150,4000,0,0,0,5150,0,0,2300,8000,0,0,0,10300,,CONEY ISL BDWK- CONSTRUCTION SECURITY MEASURES,CONEY ISL BDWK- CONSTRUCTION SECURITY MEASURES,cpd11-20bk.pdf
P-2CIGNWY,CONEY ISLAND GREENWAY PROPOSED SAFETEA GRANT,846,DEPT OF PARKS AND RECREATION,"LARGE, MAJOR AND REGIONAL PARK RECONSTRUCTION",300 313,BROOKLYN,P-0007,2608,0,0,0,0,0,0,0,0,0,0,0,0,0,0,0,0,0,0,0,0,0,0,0,0,PROJECT DELAYED DUE TO UNFORESEEN SITE/FIELD CONDITION,BRIGHTON 15TH STREET & CONEY ISLAND AVE,CONEY ISALAND GREENWAY (AKA BRIGHTON 15TH STREET & CONEY ISLAND AVE,cpd11-20bk.pdf
P-2CIWALK,CONEY ISLAND BWALK - RC OF VARIOUS SEGMENT B169-220M,846,DEPT OF PARKS AND RECREATION,"LARGE, MAJOR AND REGIONAL PARK RECONSTRUCTION",300,BROOKLYN,P-1245 P-0007,9818,290,77,0,848,575,8000,0,9790,290,77,0,848,575,8000,0,9790,580,154,0,1696,1150,16000,0,19580,,CONEY ISLAND BOARDWALK IN THE BOROUGH OF BROOKLYN,THE RECONSTRUCTION OF VARIOUS SEGMENTS OF CONEY ISLAND BOARDWALK - KNOWN AS,cpd11-20bk.pdf
P-2CONYGS,CONEY ISLAND COASTAL RESIL. GREENSTREETS BG-515MA,846,DEPT OF PARKS AND RECREATION,LAND ACQUISITION AND TREE PLANTING,300,BROOKLYN,P-0822,990,326,161,0,0,0,0,0,487,326,161,0,0,0,0,0,487,652,322,0,0,0,0,0,974,PROJECT DELAYED DUE TO CHANGES IN SCOPE/DESIGN,BOROUGH OF BROOKLYN,TO STRENGTHEN CONEY ISLAND RESILIENCY THROUHG GREENSTREETS.,cpd11-20bk.pdf
P-2COOPCS,Cooper Park-Reconstruction of Comfort Station,846,DEPT OF PARKS AND RECREATION,NEIGHBORHOOD PARKS AND PLAYGROUNDS,300,BROOKLYN,P-0505,2243,206,9,0,1636,0,0,0,1851,206,9,0,1636,0,0,0,1851,412,18,0,3272,0,0,0,3702,,,COOPER PARK-RECONSTRUCTION OF COMFORT STATION,cpd11-20bk.pdf
P-2CPIBN2,"CPI PH1- J. Owens, Stockton & Stroud C/S RC BG-815M",846,DEPT OF PARKS AND RECREATION,"LARGE, MAJOR AND REGIONAL PARK RECONSTRUCTION",300,BROOKLYN,P-1018,315,5093,31,433,0,0,0,0,5557,5093,31,433,0,0,0,0,5557,10186,62,866,0,0,0,0,11114,PROJECT DELAYED DUE TO SCHEDULING OF UTILITY WORK,"JESSE OWENS- STUYVESANT & LAFAYETTE AVES.- STOCKTON N- MARCY & PARK AVENUES, STROUD -","THE RECONSTRUCTION OF JESSE OWENS, STOCKTON AND STROUD PLAYGROUND COMFORT",cpd11-20bk.pdf
P-2CPIBPG,CPI PH2 - Bartlett Playground,846,DEPT OF PARKS AND RECREATION,NEIGHBORHOOD PARKS AND PLAYGROUNDS,300,BROOKLYN,P-1018,9636,6227,1849,0,0,0,0,0,8076,6227,1849,0,0,0,0,0,8076,12454,3698,0,0,0,0,0,16152,,,"RECONSTRUCTION OF BARTLETT PLAYGROUND, BOROUGH OF KINGS",cpd11-20bk.pdf
P-2CPIEPP,CPI PH2 - R/C Epiphany Playground (B405 -116M),846,DEPT OF PARKS AND RECREATION,NEIGHBORHOOD PARKS AND PLAYGROUNDS,300 301,BROOKLYN,WP-0169 P-1018,2879,405,0,299,3277,0,0,0,3981,405,0,299,3277,0,0,0,3981,810,0,598,6554,0,0,0,7962,PROJECT DELAYED DUE TO CHANGES IN SCOPE/DESIGN,"BOROUGH OF BROOKLYN - BERRY STREET, BETWEEN SOUTH 9TH STREET, AND SOUTH 10TH STREET",THE RECONSTRUCTION OF EPIPHANY PLAYGROUND (CPI),cpd11-20bk.pdf
P-2CPIJOP,CPI Ph1- RC of Jesse Owens Play. B269-116M,846,DEPT OF PARKS AND RECREATION,NEIGHBORHOOD PARKS AND PLAYGROUNDS,303 300,BROOKLYN,P-1018 P-D017,7472,6890,116,481,0,0,0,0,7487,6890,116,481,0,0,0,0,7487,13780,232,962,0,0,0,0,14974,PROJECT DELAYED DUE TO UNFORESEEN SITE/FIELD CONDITION,"BROOKLYN- LAFAYETTE AVENUE, BETWEEN STUYVESANT AVENANT & MALCOM X BLVD.",THE RECONSTRUCTION OF JESSE OWENS PLAYGROUND,cpd11-20bk.pdf
P-2CPILAG,CPI ph2. - LaGuardia Playground Ph 2. (B167-217M),846,DEPT OF PARKS AND RECREATION,NEIGHBORHOOD PARKS AND PLAYGROUNDS,300 301,BROOKLYN,P-0245K TF-0777 P-1018,3545,501,0,3504,0,0,0,0,4005,501,0,3504,0,0,0,0,4005,1002,0,7008,0,0,0,0,8010,,"SOUTH 4 STREET BETWEEN ROEBLING STREET AND WILLIAMSBURG GRIDGE RAMP, BOROUGH OF",RECONSTRUCTION OF LAGUARDIA PLAYGROUND,cpd11-20bk.pdf
P-2CPILFT,CPI PH2 - Lafayette Playground Reconstruction (B106B-116M),846,DEPT OF PARKS AND RECREATION,NEIGHBORHOOD PARKS AND PLAYGROUNDS,300 313,BROOKLYN,P-1018,6086,4697,2,206,0,0,0,0,4905,4697,2,206,0,0,0,0,4905,9394,4,412,0,0,0,0,9810,PROJECT DELAYED DUE TO UNFORESEEN SITE/FIELD CONDITION,"BROOKLYN - STILLWELL AVENUE, BENSON AVENUE, BAY 43 STREET",FY'16 PH2 RECONSTRUCTION OF OF LAFAYETTE PLAYGROUND...,cpd11-20bk.pdf
P-2CPILGD,CPI PH2 - LaGuardia Playground (B167-117M),846,DEPT OF PARKS AND RECREATION,NEIGHBORHOOD PARKS AND PLAYGROUNDS,300 301,BROOKLYN,P-0245K,5212,2913,642,0,0,0,0,0,3555,2913,642,0,0,0,0,0,3555,5826,1284,0,0,0,0,0,7110,,"SOUTH 4 STREET, BETWEEN ROEBLING STREET AND WILLIAMSBURG BRIDGE RAMP",LA GUARDIA PLAYGROUND,cpd11-20bk.pdf
P-2CPILJP,CPI PH2 - RC- Lt. Joseph Petrosino Park (B099-),846,DEPT OF PARKS AND RECREATION,NEIGHBORHOOD PARKS AND PLAYGROUNDS,300 311,BROOKLYN,P-1018 WP-0169,4605,4708,2,156,0,0,0,0,4866,4708,2,156,0,0,0,0,4866,9416,4,312,0,0,0,0,9732,PROJECT DELAYED DUE TO UNFORESEEN SITE/FIELD CONDITION,"16TH AVENUE, NEW UTRECHT AVENUE, BETWEEN 70 TH STREET AND 71TH STREET",THE RECONSTRUCTION OF LT. JOSEPH PETROSINO PARK PLAYGROUND,cpd11-20bk.pdf
P-2CPINEW,CPI Ph2.- Newport Comfort Station (B339-117M),846,DEPT OF PARKS AND RECREATION,NEIGHBORHOOD PARKS AND PLAYGROUNDS,300 316,BROOKLYN,P-1018,1500,1459,6,350,0,0,0,0,1815,1459,6,350,0,0,0,0,1815,2918,12,700,0,0,0,0,3630,PROJECT DELAYED DUE TO UNFORESEEN SITE/FIELD CONDITION,"NEWPORT AVENUE, THATFORD AVENUE AND OSBORN STREET",CPI - PH.2 - NEWPORT COMFORT STATION,cpd11-20bk.pdf
P-2CPINPL,CPI-PH2. Newport playground (B339-216M),846,DEPT OF PARKS AND RECREATION,NEIGHBORHOOD PARKS AND PLAYGROUNDS,300 316,BROOKLYN,WP-0169 P-1018,3500,4072,0,491,0,0,0,0,4563,4072,0,491,0,0,0,0,4563,8144,0,982,0,0,0,0,9126,PROJECT DELAYED PENDING RESOLUTION OF LEGAL ISSUES,"NEWPORT AVENUE, THATFORD AVENUE AND OSBORN STREET",CPI PH2- NEWPORT PLAYGROUND,cpd11-20bk.pdf
P-2CPIPEN,CPI PHASE 2 - RC Penn Triangle and Playground B223NC-118M,846,DEPT OF PARKS AND RECREATION,NEIGHBORHOOD PARKS AND PLAYGROUNDS,300,BROOKLYN,P-1018,1520,1904,218,0,0,0,0,0,2122,1904,218,0,0,0,0,0,2122,3808,436,0,0,0,0,0,4244,,,CPI PHASE 2 PENN TRIANGLE,cpd11-20bk.pdf
P-2CPISBF,CPI Ph1- RC Saratoga Ballfields (B387-116M),846,DEPT OF PARKS AND RECREATION,NEIGHBORHOOD PARKS AND PLAYGROUNDS,300 316,BROOKLYN,P-1018,5379,4428,199,0,0,0,0,0,4627,4428,199,0,0,0,0,0,4627,8856,398,0,0,0,0,0,9254,,BROOKLYN - HOPKINSON AVENUE BETWEEN PACIFIC STREET AND DEAN STREET,THE RECONSTRUCTION OF SARATOGA BALLFIELDS,cpd11-20bk.pdf
P-2CPITBP,CPI Ph1 - Thomas Boyland Park,846,DEPT OF PARKS AND RECREATION,NEIGHBORHOOD PARKS AND PLAYGROUNDS,300 304,BROOKLYN,P-1018,3300,5308,69,0,0,0,0,0,5377,5308,69,0,0,0,0,0,5377,10616,138,0,0,0,0,0,10754,PROJECT DELAYED DUE TO UNFORESEEN SITE/FIELD CONDITION,"BOROUGH OF BROOKLYN - BROADWAY, FURMAN, GRANITE, ABERDEEN STREETS.",RECONSTRUCTION OF PLAYGROUND,cpd11-20bk.pdf
P-2CPITEN,CPI Ph1.- Ten Eyck Play. (B311-116M),846,DEPT OF PARKS AND RECREATION,NEIGHBORHOOD PARKS AND PLAYGROUNDS,300 301,BROOKLYN,WP-0169 P-1018,5242,3902,0,296,0,0,0,0,4198,3902,0,296,0,0,0,0,4198,7804,0,592,0,0,0,0,8396,,"BROOKLYN- SCHOLES STREET, BETWEEN BUSHWICK AVENUE AND WATERBURY STREET",THE RC OF TEN EYCK PLAYGROUND,cpd11-20bk.pdf
P-2CPIWKS,CPI PH2- Weeksville Playground,846,DEPT OF PARKS AND RECREATION,NEIGHBORHOOD PARKS AND PLAYGROUNDS,300 303,BROOKLYN,P-1018,2061,1380,2,271,0,0,0,0,1653,1380,2,271,0,0,0,0,1653,2760,4,542,0,0,0,0,3306,PROJECT DELAYED DUE TO UNFORESEEN SITE/FIELD CONDITION,"HOWARD AVENUE, BETWEEN ATLANTIC AVENUE AND HERKIMER STREET",WEEKSVILLE,cpd11-20bk.pdf
P-2GATE10,Gateway Estates-Multi-purpose ballfield B548-118M,846,DEPT OF PARKS AND RECREATION,NEIGHBORHOOD PARKS AND PLAYGROUNDS,300,BROOKLYN,P-0245K,8377,1098,0,0,7252,0,0,0,8350,1098,0,0,7252,0,0,0,8350,2196,0,0,14504,0,0,0,16700,PROJECT DELAYED DUE TO UNFORESEEN SITE/FIELD CONDITION,,COMBINING GATEWAY PROJECTS,cpd11-20bk.pdf
P-2GATEW2,Gateway Estates - Constru. Plgd & comft. stat. B541-115M,846,DEPT OF PARKS AND RECREATION,"LARGE, MAJOR AND REGIONAL PARK RECONSTRUCTION",300 305,BROOKLYN,P-1018,29500,6110,77,0,0,0,0,0,6187,6110,77,0,0,0,0,0,6187,12220,154,0,0,0,0,0,12374,PROJECT DELAYED DUE TO CHANGES IN SCOPE/DESIGN,GATEWAY ESTATES II - BROOKLYN,GATEWAY ESTATES II,cpd11-20bk.pdf
P-2GATEW6,Gateway Estates -Cleveland Pk playground (B547- 114M),846,DEPT OF PARKS AND RECREATION,"LARGE, MAJOR AND REGIONAL PARK RECONSTRUCTION",300 305,BROOKLYN,P-1018,2170,11,0,0,0,1678,0,0,1689,11,0,0,0,1678,0,0,1689,22,0,0,0,3356,0,0,3378,PROJECT DELAYED DUE TO CHANGES IN SCOPE/DESIGN,BOROUGH OF BROOKLYN,CONSTRUCTION OF A PLAYGROUND IN GATEWAY ESTATES- PHASE II,cpd11-20bk.pdf
P-2GPWB25,GPWB-Bushwick Inlet Park- Motiva Parcel Remediation,846,DEPT OF PARKS AND RECREATION,MAJOR RECREATIONAL FACILITIES AND FACILITY RECONSTRUCTION,300,BROOKLYN,P-0839,11603,1215,607,99,0,8122,0,0,10043,1215,607,99,0,8122,0,0,10043,2430,1214,198,0,16244,0,0,20086,,GREENPOINT WILLIAMSBURG BROOKLYN,GREENPOINT WILLIAMSBURG,cpd11-20bk.pdf
P-2GPWBKT,GPWB- 50 Kent Development,846,DEPT OF PARKS AND RECREATION,"LARGE, MAJOR AND REGIONAL PARK RECONSTRUCTION",300,BROOKLYN,P-0839,9157,921,395,6607,0,0,0,0,7923,921,395,6607,0,0,0,0,7923,1842,790,13214,0,0,0,0,15846,,BOROUGH OF BROOKLYN,GPWB- KENT DEVELOPMENT,cpd11-20bk.pdf
P-2GTGRDN,RPZ installation at various sites in Brooklyn BG-618M,846,DEPT OF PARKS AND RECREATION,NEIGHBORHOOD PARKS AND PLAYGROUNDS,300,BROOKLYN,P-1018 P-D017 P-1250,489,61,752,0,0,0,0,0,813,61,752,0,0,0,0,0,813,122,1504,0,0,0,0,0,1626,,,RPZ INSTALLATION,cpd11-20bk.pdf
P-2HWRDPL,POOL,846,DEPT OF PARKS AND RECREATION,NEIGHBORHOOD PARKS AND PLAYGROUNDS,300,BROOKLYN,P-1008,1077,0,0,1077,0,0,0,0,1077,0,0,1077,0,0,0,0,1077,0,0,2154,0,0,0,0,2154,,BROOKLYN,POOL,cpd11-20bk.pdf
P-2LINDTF,Linden Park Synthetic Turf Field and Track (B214-117M),846,DEPT OF PARKS AND RECREATION,NEIGHBORHOOD PARKS AND PLAYGROUNDS,300,BROOKLYN,P-1018,5893,4431,52,930,0,0,0,0,5413,4431,52,930,0,0,0,0,5413,8862,104,1860,0,0,0,0,10826,PROJECT DELAYED DUE TO UNFORESEEN SITE/FIELD CONDITION,LINDEN PARK,LINDEN PARK SYNTHETIC TURF FIELD AND TRACK,cpd11-20bk.pdf
P-2LITCHF,Litchfield Villa - Renovations,846,DEPT OF PARKS AND RECREATION,NEIGHBORHOOD PARKS AND PLAYGROUNDS,300,BROOKLYN,P-D017,272,3,775,819,0,0,0,0,1597,3,775,819,0,0,0,0,1597,6,1550,1638,0,0,0,0,3194,,,RENOVATION,cpd11-20bk.pdf
P-2MRNPRK,MARINE PARK PLAYGROUND,846,DEPT OF PARKS AND RECREATION,NEIGHBORHOOD PARKS AND PLAYGROUNDS,300,BROOKLYN,P-K011,1000,0,0,1000,0,0,0,0,1000,0,0,1000,0,0,0,0,1000,0,0,2000,0,0,0,0,2000,,,"MARINE PARK AND PLAYGROUND RECONSTRUCTION, BROOKLYN",cpd11-20bk.pdf
P-2OWLHD1,OWLS HEAD PARK - PLAYGROUND RECONSTRUCTION,846,DEPT OF PARKS AND RECREATION,NEIGHBORHOOD PARKS AND PLAYGROUNDS,300,BROOKLYN,P-0245K,4000,100,100,500,0,3400,0,0,4100,100,100,500,0,3400,0,0,4100,200,200,1000,0,6800,0,0,8200,,,"RECONSTRUCTION OF OWL'S HEAD PARK PLAYGROUND, PAVEMENT, SAFETY SURFACE, AND DRAINAGE",cpd11-20bk.pdf
P-2PDBRC2,Brownsville Rec Ctr RC B270-214M,846,DEPT OF PARKS AND RECREATION,MAJOR RECREATIONAL FACILITIES AND FACILITY RECONSTRUCTION,300,BROOKLYN,P-1018,18000,1728,12,0,18731,0,0,0,20471,1728,12,0,18731,0,0,0,20471,3456,24,0,37462,0,0,0,40942,,BROOKLYN,BROWNSVILLE REC CTR,cpd11-20bk.pdf
P-2PDSSRC,Sunset Pk Rec Ctr RC B087-115M,846,DEPT OF PARKS AND RECREATION,MAJOR RECREATIONAL FACILITIES AND FACILITY RECONSTRUCTION,300,BROOKLYN,P-0506,4000,733,22,0,4307,0,0,0,5062,733,22,0,4307,0,0,0,5062,1466,44,0,8614,0,0,0,10124,PROJECT DELAYED DUE TO UNFORESEEN SITE/FIELD CONDITION,BROOKLYN,SUNSET PK RC,cpd11-20bk.pdf
P-2PEDPLZ,Public Place -Pedestrian Plaza-Eldert & liberty,846,DEPT OF PARKS AND RECREATION,NEIGHBORHOOD PARKS AND PLAYGROUNDS,300,BROOKLYN,P-D017,1000,1024,0,75,0,0,0,0,1099,1024,0,75,0,0,0,0,1099,2048,0,150,0,0,0,0,2198,PROJECT DELAYED DUE TO UNFORESEEN SITE/FIELD CONDITION,ELDERT LANE BETWEEN LIBERTY AND GLENMORE AVENUES.,PEDESTRIAN PLAZA- ELDERT AVENUE AND LIBERTY AND GLENMORE AVENUE,cpd11-20bk.pdf
P-2PEPWIN,Prospect Park Parade Ground PEP HQ window replace,846,DEPT OF PARKS AND RECREATION,NEIGHBORHOOD PARKS AND PLAYGROUNDS,300,BROOKLYN,P-1018,600,0,0,700,0,0,0,0,700,0,0,700,0,0,0,0,700,0,0,1400,0,0,0,0,1400,,"PROSPECT PARK PARADE GROUND PEP HQ, BROOKLYN",PROSPECT PARK PARADE GROUND PEP HQ WINDOW REPLACE,cpd11-20bk.pdf
P-2PGRD11,"MULTISITE- PAVEMTS,TENNIS CTS, BB CTS, FENCING (BG-711M)",846,DEPT OF PARKS AND RECREATION,NEIGHBORHOOD PARKS AND PLAYGROUNDS,300,BROOKLYN,P-D017 P-0245K,1576,3169,0,0,631,0,0,0,3800,3169,0,0,631,0,0,0,3800,6338,0,0,1262,0,0,0,7600,PROJECT DELAYED DUE TO UNFORESEEN SITE/FIELD CONDITION,BOROUGH OF BROOKLYN,"MULTISITE- PAVEMENTS, TENNIS COURTS, BASKETBALL COURTS, FENCING , PLANTINGS AND GENERAL",cpd11-20bk.pdf
P-2PKTR21,FY21-Park Trees - Brooklyn,846,DEPT OF PARKS AND RECREATION,LAND ACQUISITION AND TREE PLANTING,300,BROOKLYN,P-0822,2880,75,2880,0,0,0,0,0,2955,75,2880,0,0,0,0,0,2955,150,5760,0,0,0,0,0,5910,,FY21-PARK TREES - BROOKLYN,FY21-PARK TREES - BROOKLYN,cpd11-20bk.pdf
P-2PLAY13,"MULTISITE- OCEAN HILL PLGD, WINGATE, MLK SPRAY SHWER BG-114M",846,DEPT OF PARKS AND RECREATION,NEIGHBORHOOD PARKS AND PLAYGROUNDS,309 316 300 305,BROOKLYN,P-K011,635,1714,128,0,0,0,0,0,1842,1714,128,0,0,0,0,0,1842,3428,256,0,0,0,0,0,3684,PROJECT DELAYED DUE TO UNFORESEEN SITE/FIELD CONDITION,BOROUGH OF BROOKLYN,LINCOLN TERRACE PLAYGROUND AND OCEAN HILL PLAYGROUND,cpd11-20bk.pdf
P-2PLG14D,RECON. CHARLES PINNTRIANGLE - PAVE. CURBS FENCING BG-613M,846,DEPT OF PARKS AND RECREATION,NEIGHBORHOOD PARKS AND PLAYGROUNDS,300,BROOKLYN,P-1018,174,251,0,74,0,0,0,0,325,251,0,74,0,0,0,0,325,502,0,148,0,0,0,0,650,PROJECT DELAYED DUE TO CHANGES IN SCOPE/DESIGN,BOROUGH OF BROOKLYN,CHARLES PINN PLAYGROUND REQUIREMENTS,cpd11-20bk.pdf
P-2PNYC01,PlaNYC - McCarren Pk Pool & Bathhouse RC - B058-108M/408M,846,DEPT OF PARKS AND RECREATION,MAJOR RECREATIONAL FACILITIES AND FACILITY RECONSTRUCTION,301,BROOKLYN,P-1018,50510,56863,63,0,0,0,0,0,56926,56863,63,0,0,0,0,0,56926,113726,126,0,0,0,0,0,113852,PROJECT DELAYED DUE TO CHANGES IN SCOPE/DESIGN,LORIMER ST B/T BAYARD ST & DRIGGS AVE (B058),MCCARREN PK POOL RC ... $293K DR & TRF TO P-2PNYMC1..TRF $132K (BL P-0127 CHANGED TO,cpd11-20bk.pdf
P-2PNYC05,PlaNYC - Calvert Vaux CS/M&O bldg (B125-112M),846,DEPT OF PARKS AND RECREATION,"LARGE, MAJOR AND REGIONAL PARK RECONSTRUCTION",313,BROOKLYN,P-1018,2760,9477,980,0,0,0,0,0,10457,9477,980,0,0,0,0,0,10457,18954,1960,0,0,0,0,0,20914,PROJECT DELAYED DUE TO BUDGETARY CONSTRAINTS,BOROUGH OF BROOKLYN,CALVERT VAUX,cpd11-20bk.pdf
P-2PNYCB3,PlaNYC-FY09 Playgrounds BG-2309M,846,DEPT OF PARKS AND RECREATION,"LARGE, MAJOR AND REGIONAL PARK RECONSTRUCTION",300,BROOKLYN,P-D017,1200,1734,116,0,0,0,0,0,1850,1734,116,0,0,0,0,0,1850,3468,232,0,0,0,0,0,3700,,PS 192K BROOKLYN,PLANYC PLAYGROUNDS,cpd11-20bk.pdf
P-2POWPRK,POWELL PARK PLAYGROUND,846,DEPT OF PARKS AND RECREATION,NEIGHBORHOOD PARKS AND PLAYGROUNDS,300,BROOKLYN,P-K011,1000,0,0,1000,0,0,0,0,1000,0,0,1000,0,0,0,0,1000,0,0,2000,0,0,0,0,2000,,,RECONSTRUCTION OF POWELL PARK AND PLAYGROUND,cpd11-20bk.pdf
P-2PPANEP,Northeast Paths - Prospect Park Alliance,846,DEPT OF PARKS AND RECREATION,"LARGE, MAJOR AND REGIONAL PARK RECONSTRUCTION",300,BROOKLYN,P-0245K,2000,313,1736,0,0,0,0,0,2049,313,1736,0,0,0,0,0,2049,626,3472,0,0,0,0,0,4098,PROJECT DELAYED PENDING RESOLUTION OF LEGAL ISSUES,,NORTHEAST PATHS - PROSPECT PARK ALLIANCE,cpd11-20bk.pdf
P-2PPESIT,PROSPECT PARK EXPRESSWAY SITTING AREA RC,846,DEPT OF PARKS AND RECREATION,NEIGHBORHOOD PARKS AND PLAYGROUNDS,300,BROOKLYN,P-K001 P-D017,916,98,720,0,0,0,0,0,818,98,720,0,0,0,0,0,818,196,1440,0,0,0,0,0,1636,,,"RECONSTRUCT SITTING AREAS INCLUDING WATER SERVICE, BENCHES, SEATING, LANDSCAPING,",cpd11-20bk.pdf
P-2PWBFTG,PWOB- Fort Greene (B032-117M),846,DEPT OF PARKS AND RECREATION,"LARGE, MAJOR AND REGIONAL PARK RECONSTRUCTION",300,BROOKLYN,P-1018 P-D017 P-0935 P-K011,900,876,176,13300,0,0,0,0,14352,876,176,13300,0,0,0,0,14352,1752,352,26600,0,0,0,0,28704,PROJECT DELAYED PENDING RESOLUTION OF LEGAL ISSUES,"MYRTLE AVENUE, DE KALB AVENUE, BETWEEN WASHINGTON PARK AND ST EDWARDS'S STREET",FORT GREENE,cpd11-20bk.pdf
P-2PWBPFB,PWOB- PP Flatbush Avenue (B073-117M),846,DEPT OF PARKS AND RECREATION,"LARGE, MAJOR AND REGIONAL PARK RECONSTRUCTION",300,BROOKLYN,P-1018,3200,3317,194,0,0,0,0,0,3511,3317,194,0,0,0,0,0,3511,6634,388,0,0,0,0,0,7022,,PROSPECT PARK - BOROUGH OF BROOKLYN,PWOB- PROSPECT PARK,cpd11-20bk.pdf
P-2REGION,REQUIREMENTS - LARGE PKS -BKLYN BG-799R,846,DEPT OF PARKS AND RECREATION,"LARGE, MAJOR AND REGIONAL PARK RECONSTRUCTION",300,BROOKLYN,P-0221 P-1018,637,546,44,0,0,0,0,0,590,546,44,0,0,0,0,0,590,1092,88,0,0,0,0,0,1180,,LARGE PARKS BKLYN,LARGE PARKS BKLYN,cpd11-20bk.pdf
P-2RHBALL,Red Hook ball fields B126-116M,846,DEPT OF PARKS AND RECREATION,NEIGHBORHOOD PARKS AND PLAYGROUNDS,300 306,BROOKLYN,P-0245K,11690,13714,2158,0,0,0,0,0,15872,13714,2158,0,0,0,0,0,15872,27428,4316,0,0,0,0,0,31744,PROJECT DELAYED DUE TO UNFORESEEN SITE/FIELD CONDITION,,RED HOOK BALL FIELDS,cpd11-20bk.pdf
P-2SEAGTE,SEAGATE SHORELINE REMEDIATION,846,DEPT OF PARKS AND RECREATION,NEIGHBORHOOD PARKS AND PLAYGROUNDS,313 300,BROOKLYN,P-D017 P-0379,600,0,0,2600,0,0,0,0,2600,0,0,2600,0,0,0,0,2600,0,0,5200,0,0,0,0,5200,PROJECT DELAYED DUE TO CHANGES IN SCOPE/DESIGN,BOROUGH OF BROOKLYN,REMEDIATION OF SHORELINE AT SEAGATE,cpd11-20bk.pdf
P-2SNSTRW,Commodore Barry Park C.S,846,DEPT OF PARKS AND RECREATION,NEIGHBORHOOD PARKS AND PLAYGROUNDS,300,BROOKLYN,P-0505,4550,225,0,0,3574,0,0,0,3799,225,0,0,3574,0,0,0,3799,450,0,0,7148,0,0,0,7598,,,COMMODORE BARRY PARK COMFORT STATION,cpd11-20bk.pdf
P-2SNTGNS,Senerity Gardens,846,DEPT OF PARKS AND RECREATION,NEIGHBORHOOD PARKS AND PLAYGROUNDS,300,BROOKLYN,P-D017,58,0,50,0,0,0,0,0,50,0,50,0,0,0,0,0,50,0,100,0,0,0,0,0,100,,BOROUGH OF BROOKLYN,SENERITY GARDENS - NEED MORE INFORMATION,cpd11-20bk.pdf
P-2STFBSH,"Synthetic Turf Field Reconstruction at Bushwick Inlet Pk, BK",846,DEPT OF PARKS AND RECREATION,NEIGHBORHOOD PARKS AND PLAYGROUNDS,300,BROOKLYN,P-0510,1058,0,0,1058,0,0,0,0,1058,0,0,1058,0,0,0,0,1058,0,0,2116,0,0,0,0,2116,,"BUSHWICK INLET PK, BROOKLYN","SYNTHETIC TURF FIELD RECONSTRUCTION AT BUSHWICK INLET PK, BK",cpd11-20bk.pdf
P-2STFHM,Hamilton-Metz Field Synthetic Turf Field Reconstruction,846,DEPT OF PARKS AND RECREATION,NEIGHBORHOOD PARKS AND PLAYGROUNDS,,BROOKLYN,P-0510,2133,1889,364,171,0,0,0,0,2424,1889,364,171,0,0,0,0,2424,3778,728,342,0,0,0,0,4848,,,HAMILTON-METZ FIELD SYNTHETIC TURF FIELD,cpd11-20bk.pdf
P-2STFLEF,"Synthetic Turf Field Recon at Quaker Parrot Pk, BK",846,DEPT OF PARKS AND RECREATION,NEIGHBORHOOD PARKS AND PLAYGROUNDS,300,BROOKLYN,P-1018,1060,0,1060,0,0,0,0,0,1060,0,1060,0,0,0,0,0,1060,0,2120,0,0,0,0,0,2120,,"LEIF ERICSON, BK","SYNTHETIC TURF FIELD RECONSTRUCTION AT LEIF ERICSON, BK",cpd11-20bk.pdf
P-2STFMH,Maria Hernandez Park - Synthetic Turf Field (B016-118M),846,DEPT OF PARKS AND RECREATION,NEIGHBORHOOD PARKS AND PLAYGROUNDS,300,BROOKLYN,P-0510,4642,310,0,3404,0,0,0,0,3714,310,0,3404,0,0,0,0,3714,620,0,6808,0,0,0,0,7428,,,SYNTHETIC TURF FIELD,cpd11-20bk.pdf
P-2SUCSGN,Success Garden - Park Renovation,846,DEPT OF PARKS AND RECREATION,NEIGHBORHOOD PARKS AND PLAYGROUNDS,300,BROOKLYN,P-K011 P-D017,2009,241,0,1950,0,0,0,0,2191,241,0,1950,0,0,0,0,2191,482,0,3900,0,0,0,0,4382,,BOROUGH OF BROOKLYN,SUCCESS GARDEN PARK RENOVATION INCLUDING THE RECONSTRUCTION OF BROKEN ASPHALT AND,cpd11-20bk.pdf
P-2TRE14A,"FY14 Street Tree Planting, Brooklyn CB's 1 - 6 & 8 - BG-813M",846,DEPT OF PARKS AND RECREATION,LAND ACQUISITION AND TREE PLANTING,300 301 302 303 304 305 306 308,BROOKLYN,P-0822 P-D822 P-K822,2638,2439,43,0,0,0,0,0,2482,2439,43,0,0,0,0,0,2482,4878,86,0,0,0,0,0,4964,PROJECT DELAYED DUE TO UNFORESEEN SITE/FIELD CONDITION,,PLANTING OF NEW AND REPLACEMENT STREET TREES AT,cpd11-20bk.pdf
P-2TRE15B,"FY 15 Street Tree Planting - Bkln CB 6,7,10,12, BG-315M",846,DEPT OF PARKS AND RECREATION,LAND ACQUISITION AND TREE PLANTING,300,BROOKLYN,P-0822,1770,1299,91,0,0,0,0,0,1390,1299,91,0,0,0,0,0,1390,2598,182,0,0,0,0,0,2780,PROJECT DELAYED DUE TO UNFORESEEN SITE/FIELD CONDITION,"CB 6,7,10, 12 IN THE BOROUGH OF BROOKLYN",FY 15 PLANT NEW AND REPLACEMENT STREET TREES,cpd11-20bk.pdf
P-2TRE18A,"FY18 Street Tree Brooklyn1,2,3,4,16, BG-",846,DEPT OF PARKS AND RECREATION,LAND ACQUISITION AND TREE PLANTING,300,BROOKLYN,P-0822,175,23,0,240,0,0,0,0,263,23,0,240,0,0,0,0,263,46,0,480,0,0,0,0,526,,"FY18 STREET TREE BROOKLYN1,2,3,4,16, BG-","FY18 STREET TREE BROOKLYN1,2,3,4,16, BG-",cpd11-20bk.pdf
P-2TRE18B,"FY18 Street Tree Brooklyn1,5,14,18",846,DEPT OF PARKS AND RECREATION,LAND ACQUISITION AND TREE PLANTING,300,BROOKLYN,P-0822,2520,3186,80,0,0,0,0,0,3266,3186,80,0,0,0,0,0,3266,6372,160,0,0,0,0,0,6532,,"FY18 STREET TREE BROOKLYN1,5,14,18","FY18 STREET TREE BROOKLYN1,5,14,18",cpd11-20bk.pdf
P-2TRE18C,"FY18 Street Tree Brooklyn6,7,9,12",846,DEPT OF PARKS AND RECREATION,LAND ACQUISITION AND TREE PLANTING,300,BROOKLYN,P-1018,2057,3130,180,0,0,0,0,0,3310,3130,180,0,0,0,0,0,3310,6260,360,0,0,0,0,0,6620,,"FY18 STREET TREE BROOKLYN6,7,9,12","FY18 STREET TREE BROOKLYN6,7,9,12",cpd11-20bk.pdf
P-2TRE20A,"FY20 Street Tree Brooklyn1,2,3,4,, BG-319M",846,DEPT OF PARKS AND RECREATION,LAND ACQUISITION AND TREE PLANTING,300,BROOKLYN,P-1018 P-0822 P-D822 P-K822,2997,75,0,3207,0,0,0,0,3282,75,0,3207,0,0,0,0,3282,150,0,6414,0,0,0,0,6564,,"FY20 STREET TREE BROOKLYN1,2,3,4,, BG-319M","FY20 STREET TREE BROOKLYN1,2,3,4,, BG-319M",cpd11-20bk.pdf
P-2TRE20C,"FY20 Street Tree Brooklyn 6,7,10,12 BG-719M",846,DEPT OF PARKS AND RECREATION,LAND ACQUISITION AND TREE PLANTING,300,BROOKLYN,SE-0004 P-1018 P-0822 P-D822,1275,75,231,1044,0,0,0,0,1350,75,231,1044,0,0,0,0,1350,150,462,2088,0,0,0,0,2700,,"FY20 STREET TREE BROOKLYN 6,7,10,12 BG-719M","FY20 STREET TREE BROOKLYN 6,7,10,12 BG-719M",cpd11-20bk.pdf
P-2TRE20E,"FY20 Street Tree Brooklyn 11,13 BG-419M",846,DEPT OF PARKS AND RECREATION,LAND ACQUISITION AND TREE PLANTING,300,BROOKLYN,P-1018,1188,1343,0,0,0,0,0,0,1343,1343,0,0,0,0,0,0,1343,2686,0,0,0,0,0,0,2686,,"FY20 STREET TREE BROOKLYN 11,13 BG-419M","FY20 STREET TREE BROOKLYN 11,13 BG-419M",cpd11-20bk.pdf
P-2TRE21A,"FY21 Street Tree Brooklyn13,4,,5,16 BG-",846,DEPT OF PARKS AND RECREATION,LAND ACQUISITION AND TREE PLANTING,300,BROOKLYN,P-D822 P-0822 P-1018 WM-0006,2990,0,1315,0,0,0,0,0,1315,0,1315,0,0,0,0,0,1315,0,2630,0,0,0,0,0,2630,,BOROWIDE,"FY21 STREET TREE BROOKLYN13,4,,5,16",cpd11-20bk.pdf
P-2TRE21B,"FY21 Street Tree Brooklyn2,6,7,10 BG-",846,DEPT OF PARKS AND RECREATION,LAND ACQUISITION AND TREE PLANTING,300,BROOKLYN,P-D017 P-K822 P-0822 WP-0269,1376,25,2633,0,0,0,0,0,2658,25,2633,0,0,0,0,0,2658,50,5266,0,0,0,0,0,5316,,BOROWIDE,"FY21 STREET TREE BROOKLYN2,6,7,10",cpd11-20bk.pdf
P-2TRE21C,"FY21 Street Tree Brooklyn11,13,15 BG-",846,DEPT OF PARKS AND RECREATION,LAND ACQUISITION AND TREE PLANTING,300,BROOKLYN,P-0822,2356,0,2356,0,0,0,0,0,2356,0,2356,0,0,0,0,0,2356,0,4712,0,0,0,0,0,4712,,"FY21 STREET TREE BROOKLYN11,13,15","FY21 STREET TREE BROOKLYN11,13,15",cpd11-20bk.pdf
P-2TRE21D,"FY21 Street Tree Brooklyn12,14 BG-",846,DEPT OF PARKS AND RECREATION,LAND ACQUISITION AND TREE PLANTING,300,BROOKLYN,P-0822,990,30,2530,0,0,0,0,0,2560,30,2530,0,0,0,0,0,2560,60,5060,0,0,0,0,0,5120,,"FY21 STREET TREE BROOKLYN12,14","FY21 STREET TREE BROOKLYN12,14",cpd11-20bk.pdf
P-2TREL21,"FY21 Street Trees BK CB's9,17,18 (3Y)",846,DEPT OF PARKS AND RECREATION,LAND ACQUISITION AND TREE PLANTING,300,BROOKLYN,P-D017 P-0822,5950,25,5950,0,0,0,0,0,5975,25,5950,0,0,0,0,0,5975,50,11900,0,0,0,0,0,11950,,BROOKLYN,"FY21 STREET TREES BK CB'S9,17,18 (3Y)",cpd11-20bk.pdf
P-2TRS19A,"BrooklynTree-Damaged Sidewalk R/C CB 7,10-13,15,18",846,DEPT OF PARKS AND RECREATION,LAND ACQUISITION AND TREE PLANTING,300,BROOKLYN,P-1331,1482,1512,543,0,0,0,0,0,2055,1512,543,0,0,0,0,0,2055,3024,1086,0,0,0,0,0,4110,,"BROOKLYNTREE-DAMAGED SIDEWALK R/C CB 7,10-13,15,18","BROOKLYNTREE-DAMAGED SIDEWALK R/C CB 7,10-13,15,18",cpd11-20bk.pdf
P-2TRSD19,BrooklynTree-Damaged Sidewalk R/C,846,DEPT OF PARKS AND RECREATION,LAND ACQUISITION AND TREE PLANTING,300,BROOKLYN,P-1331 P-D017,1524,1554,501,0,0,0,0,0,2055,1554,501,0,0,0,0,0,2055,3108,1002,0,0,0,0,0,4110,,BROOKLYNTREE-DAMAGED SIDEWALK R/C,BROOKLYNTREE-DAMAGED SIDEWALK R/C,cpd11-20bk.pdf
P-2WPKBGH,NYCHA Kingsborough Houses Open Space Construction,846,DEPT OF PARKS AND RECREATION,LAND ACQUISITION AND TREE PLANTING,305,BROOKLYN,P-1018,5000,100,100,400,100,4500,0,0,5200,100,100,400,100,4500,0,0,5200,200,200,800,200,9000,0,0,10400,,KINGSBOROUGH - BOROUGH OF BROOKLYN,"NYCHA KINGSBOROUGH HOUSES OPEN SPACE CONSTRUCTION, BOROUGH OF BROOKLYN",cpd11-20bk.pdf
P-2WPS228,I.S. 228 Playground Reconstruction (BG-39100-117M),846,DEPT OF PARKS AND RECREATION,NEIGHBORHOOD PARKS AND PLAYGROUNDS,300,BROOKLYN,P-1018,1508,1064,547,0,0,0,0,0,1611,1064,547,0,0,0,0,0,1611,2128,1094,0,0,0,0,0,3222,,"228 AVENUE S, BROOKLYN, NY 11223",I.S. 228 PLAYGROUND RECONSTRUCTION,cpd11-20bk.pdf
P-6CADMAR,Recon Marlboro & Cadman Plaza CS,846,DEPT OF PARKS AND RECREATION,NEIGHBORHOOD PARKS AND PLAYGROUNDS,300,BROOKLYN,P-0505 P-K011 P-1008,837,354,524,0,1560,0,0,0,2438,354,524,0,1560,0,0,0,2438,708,1048,0,3120,0,0,0,4876,,BROOKLYN,RECON MARLBORO & CADMAN PLAZA CS,cpd11-20bk.pdf
P-6PNYR01,PlaNYC-Reforestation,846,DEPT OF PARKS AND RECREATION,LAND ACQUISITION AND TREE PLANTING,300,BROOKLYN,P-0822,520,391,49,0,0,0,0,0,440,391,49,0,0,0,0,0,440,782,98,0,0,0,0,0,880,PROJECT DELAYED DUE TO CHANGES IN SCOPE/DESIGN,NORTH CONDUIT BLVD (SUTTER TO ATLANTIC AVES),PLANYC - REFORESTATION,cpd11-20bk.pdf
P-6WPEBCS,Recon War Mem bldg & Elenor Roosevelt CS,846,DEPT OF PARKS AND RECREATION,NEIGHBORHOOD PARKS AND PLAYGROUNDS,300,BROOKLYN,P-0505 P-D017,1782,128,0,2060,0,0,0,0,2188,128,0,2060,0,0,0,0,2188,256,0,4120,0,0,0,0,4376,,BROOKLYN,"RECON WAR MEM BLDG, PIERREPONT & ELENOR ROOSEVELT CS",cpd11-20bk.pdf
SANDY2-03,SANDY-Emergency Clean up & Safe Up - Shore Pkway B166-313M,846,DEPT OF PARKS AND RECREATION,NEIGHBORHOOD PARKS AND PLAYGROUNDS,300,BROOKLYN,P-1018,600,278,0,0,1,0,0,0,279,278,0,0,1,0,0,0,279,556,0,0,2,0,0,0,558,PROJECT DELAYED DUE TO UNFORESEEN SITE/FIELD CONDITION,BOROUGH OF BROOKLYN,HURRICANE SANDY EMERGENCY WORK AT SHORE PARKWAY,cpd11-20bk.pdf
SANDY2-12,SANDY - Brooklyn Plgd requirements (Type 2) BG-1113M,846,DEPT OF PARKS AND RECREATION,NEIGHBORHOOD PARKS AND PLAYGROUNDS,300,BROOKLYN,P-1018,3168,556,12,118,0,0,0,0,686,556,12,118,0,0,0,0,686,1112,24,236,0,0,0,0,1372,PROJECT DELAYED DUE TO UNFORESEEN SITE/FIELD CONDITION,BOROUGH OF BROOKLYN,STORM SANDY - PLAYGROUND R/C,cpd11-20bk.pdf
SANDY2-13,SANDY - PNP Prospect Park Alliance,846,DEPT OF PARKS AND RECREATION,NEIGHBORHOOD PARKS AND PLAYGROUNDS,300 306 307 308 309 314,BROOKLYN,P-1018,548,37,0,0,0,46,0,0,83,37,0,0,0,46,0,0,83,74,0,0,0,92,0,0,166,PROJECT DELAYED DUE TO UNFORESEEN SITE/FIELD CONDITION,BROOKLYN,PROSPECT PARK,cpd11-20bk.pdf
SANDY2-14,SANDY- Abe Stark boilers and chillers (B169-111M),846,DEPT OF PARKS AND RECREATION,MAJOR RECREATIONAL FACILITIES AND FACILITY RECONSTRUCTION,300 313,BROOKLYN,P-1018,1852,101,0,0,54,0,0,0,155,101,0,0,54,0,0,0,155,202,0,0,108,0,0,0,310,,"LOCATED ADJACENT TO THE CONEY ISLAND BOARDWALK AT WEST 19TH STREET, IN THE BOROUGH OF",SANDY RELATED WORK AT ABE STARK SKATING RINK,cpd11-20bk.pdf
SANDY2-15,SANDY-Nautilus Playground (Type 3 ),846,DEPT OF PARKS AND RECREATION,NEIGHBORHOOD PARKS AND PLAYGROUNDS,300 313,BROOKLYN,P-1018,540,6,0,0,0,45,0,0,51,6,0,0,0,45,0,0,51,12,0,0,0,90,0,0,102,PROJECT DELAYED DUE TO CHANGES IN SCOPE/DESIGN,"NAUTILUS PLGR , BROOKLYN",RECONSTRUCTION OF PLGR,cpd11-20bk.pdf
SANDY2-16,SANDY-Sheepshead Bay Piers Type 3,846,DEPT OF PARKS AND RECREATION,NEIGHBORHOOD PARKS AND PLAYGROUNDS,300,BROOKLYN,P-1018,653,353,0,694,0,0,0,0,1047,353,0,694,0,0,0,0,1047,706,0,1388,0,0,0,0,2094,PROJECT DELAYED DUE TO UNFORESEEN SITE/FIELD CONDITION,"SHEEPSHEAD BAY PIERS AT EMMONS AVE, BROOKLYN",R/C OF TRANSFORMERS AND ELECTRICAL COMPONENTS AT SHEEPSHEAD BAY PIERS,cpd11-20bk.pdf
SANDY2-17,SRU-TYPE 3-MCGUIRE FIELDS SCOREBOARDS,846,DEPT OF PARKS AND RECREATION,NEIGHBORHOOD PARKS AND PLAYGROUNDS,300,BROOKLYN,P-1018,480,0,0,36,0,0,0,0,36,0,0,36,0,0,0,0,36,0,0,72,0,0,0,0,72,PROJECT DELAYED DUE TO UNFORESEEN SITE/FIELD CONDITION,BERGEN AVENUE AND AVENUE W. BOROUGH OF BROOKLYN,THE RECONSTRUCTION OF THE SCOREBOARDS AND ELECTRICAL EQUIPMENT AT JOSEPH T. MCGUIRE,cpd11-20bk.pdf
SANDY2-21,SANDY - Tree removals -Brooklyn CB 7-18 BG-614M,846,DEPT OF PARKS AND RECREATION,LAND ACQUISITION AND TREE PLANTING,300,BROOKLYN,P-1018,2100,472,0,41,0,0,0,0,513,472,0,41,0,0,0,0,513,944,0,82,0,0,0,0,1026,,BOROUGH OF BROOKLYN,TREE REMOVALS IN BROOKLYN CB 7-18 RELATED TO SANDY,cpd11-20bk.pdf
SANDY2-25,Abe Stark - Non-Boiler Repair,846,DEPT OF PARKS AND RECREATION,NEIGHBORHOOD PARKS AND PLAYGROUNDS,300,BROOKLYN,P-1018,2603,0,0,0,0,260,0,0,260,0,0,0,0,260,0,0,260,0,0,0,0,520,0,0,520,,BOROUGH OF BROOKLYN,SANDY - ABE STARK,cpd11-20bk.pdf
SANDY2-26,Prospect Pk - Lily Pond & Pool Viewing Platform Repair,846,DEPT OF PARKS AND RECREATION,"LARGE, MAJOR AND REGIONAL PARK RECONSTRUCTION",300,BROOKLYN,P-1018,294,44,0,0,0,25,0,0,69,44,0,0,0,25,0,0,69,88,0,0,0,50,0,0,138,,,PROSPECT PK LILY POND POOL PLATFORM REPAIR,cpd11-20bk.pdf
SANDY2-27,CI Beach & Boardwalk - West 25 ST Maint Office Boiler,846,DEPT OF PARKS AND RECREATION,BEACHES AND BOARDWALKS,300,BROOKLYN,P-1018,563,0,0,0,0,56,0,0,56,0,0,0,0,56,0,0,56,0,0,0,0,112,0,0,112,,,CI BEACH & BOARDWALK - WEST 25 ST MAINT OFFICE BOILER,cpd11-20bk.pdf
SANDY2-28,Red Hook Recreation Center,846,DEPT OF PARKS AND RECREATION,MAJOR RECREATIONAL FACILITIES AND FACILITY RECONSTRUCTION,300,BROOKLYN,P-1018,3109,0,0,0,548,311,0,0,859,0,0,0,548,311,0,0,859,0,0,0,1096,622,0,0,1718,,,RED HOOK RECREATION CENTER,cpd11-20bk.pdf
SANDY2-30,Hudson River Yacht Club,846,DEPT OF PARKS AND RECREATION,MAJOR RECREATIONAL FACILITIES AND FACILITY RECONSTRUCTION,300,BROOKLYN,P-1018,440,0,0,0,0,205,0,0,205,0,0,0,0,205,0,0,205,0,0,0,0,410,0,0,410,,,HUDSON RIVER YACHT CLUB,cpd11-20bk.pdf
SANDY2-31,Diamond Point Yacht Club,846,DEPT OF PARKS AND RECREATION,MAJOR RECREATIONAL FACILITIES AND FACILITY RECONSTRUCTION,300,BROOKLYN,P-1018,483,0,0,0,0,166,0,0,166,0,0,0,0,166,0,0,166,0,0,0,0,332,0,0,332,,,DIAMOND PONT YACHT CLUB,cpd11-20bk.pdf
SANDY2-32,Paerdegat Squadron Yacht Club,846,DEPT OF PARKS AND RECREATION,MAJOR RECREATIONAL FACILITIES AND FACILITY RECONSTRUCTION,300,BROOKLYN,P-1018,294,0,0,0,90,30,0,0,120,0,0,0,90,30,0,0,120,0,0,0,180,60,0,0,240,,,PAERDEGAT SQUADRON YACHT CLUB,cpd11-20bk.pdf
SANDY2-33,Sandy - Midget Squadron Yacht Club,846,DEPT OF PARKS AND RECREATION,MAJOR RECREATIONAL FACILITIES AND FACILITY RECONSTRUCTION,300,BROOKLYN,P-1018,2029,0,0,0,0,800,0,0,800,0,0,0,0,800,0,0,800,0,0,0,0,1600,0,0,1600,,,MIDGET SQUADRON YACHT CLUB,cpd11-20bk.pdf
SANDY2-34,Paerdegat Athletic Center HVAC recon. B406-114M,846,DEPT OF PARKS AND RECREATION,MAJOR RECREATIONAL FACILITIES AND FACILITY RECONSTRUCTION,300,BROOKLYN,P-1018,2696,779,9,0,0,0,0,0,788,779,9,0,0,0,0,0,788,1558,18,0,0,0,0,0,1576,,,PAERDEGAT ATHLETIC CENTER HVAC RECON. B406-114M,cpd11-20bk.pdf
SANDY2-35,Paerdegat Athletic Center - Remaining Scope,846,DEPT OF PARKS AND RECREATION,MAJOR RECREATIONAL FACILITIES AND FACILITY RECONSTRUCTION,300,BROOKLYN,P-1018,12797,0,0,0,0,1233,0,0,1233,0,0,0,0,1233,0,0,1233,0,0,0,0,2466,0,0,2466,,,PAERDEGAT ATHLETIC CENTER - REMAINING SCOPE,cpd11-20bk.pdf
SANDY2-36,SANDY-BK,846,DEPT OF PARKS AND RECREATION,NEIGHBORHOOD PARKS AND PLAYGROUNDS,300,BROOKLYN,P-1018,887,0,0,0,0,88,0,0,88,0,0,0,0,88,0,0,88,0,0,0,0,176,0,0,176,,,SANDY2-36,cpd11-20bk.pdf
SANDY2-37,SANDY-John Malone Community Center,846,DEPT OF PARKS AND RECREATION,MAJOR RECREATIONAL FACILITIES AND FACILITY RECONSTRUCTION,300,BROOKLYN,P-1018,1978,40,40,0,158,0,0,0,238,40,40,0,158,0,0,0,238,80,80,0,316,0,0,0,476,,"BERGEN AVENUE, BETWEEN AVENUE W AND AVENUE X.",JOHN MALONE COMMUNITY CENTER IN BOROUGH OF BROOKLYN,cpd11-20bk.pdf
BBJ-K,Borough Based Jails New Brooklyn Detention Facility,850,DEPT OF DESIGN & CONSTRUCTION,New Jail Facilities,,BROOKLYN,C-0114,0,0,100,66466,280114,478373,472162,673647,1970862,0,100,66466,280114,478373,472162,673647,1970862,0,200,132932,560228,956746,944324,1347294,3941724,,,CONSTRUCTION OF NEW BROOKLYN FACILITY,cpd11-20bk.pdf
BED-768B,WATER MAIN CONNECTIONS TO SHAFT 23B - PHASE II (HWK700B),850,DEPT OF DESIGN & CONSTRUCTION,TRUNK AND DISTRIBUTION MAIN EXTENSION,300,BROOKLYN,WM-0001 WM-0006 SE-0002K,7244,0,0,58964,0,0,0,0,58964,0,0,58964,0,0,0,0,58964,0,0,117928,0,0,0,0,117928,PROJECT DELAYED DUE TO CHANGES IN SCOPE/DESIGN,WATER MAIN CONNECTIONS TO SHAFT 23B - PHASE II,WATER MAIN CONNECTIONS TO SHAFT 23B - PHASE II,cpd11-20bk.pdf
BED-776,"WM REPLMT EAST NEW YORK AVE B/T HOWARD AV & PACIFIC ST, ETC",850,DEPT OF DESIGN & CONSTRUCTION,TRUNK AND DISTRIBUTION MAIN REPLACEMENT,305 316,BROOKLYN,EP-0007 SE-0002K SE-0944 WM-0001 WM-0006 HW-0001K HW-0200 HW-0944 TF-0002,18872,2411,86356,0,0,0,0,0,88767,2411,86356,0,0,0,0,0,88767,4822,172712,0,0,0,0,0,177534,PROJECT DELAYED DUE TO CHANGES IN SCOPE/DESIGN,,"WM REPLMT EAST NEW YORK AVE B/T HOWARD AV & PACIFIC ST, IN JAMAICA AVE B/T HERLIMER ST",cpd11-20bk.pdf
BED-777,WM REPLMT IN LEONARD STRET B/T DRIGGS AV AND MAUJER ST,850,DEPT OF DESIGN & CONSTRUCTION,TRUNK AND DISTRIBUTION MAIN REPLACEMENT,301,BROOKLYN,WM-0006 SE-0002K,10234,44369,1047,0,0,0,0,0,45416,44369,1047,0,0,0,0,0,45416,88738,2094,0,0,0,0,0,90832,PROJECT DELAYED DUE TO UNFORESEEN SITE/FIELD CONDITION,,WM REPLMT IN LEONARD STRET B/T DRIGGS AV AND MAUJER ST,cpd11-20bk.pdf
BED-780,RECON OF WM & SWR IN 5 AVE B/T 65 ST & 34 ST,850,DEPT OF DESIGN & CONSTRUCTION,TRUNK AND DISTRIBUTION MAIN REPLACEMENT,307,BROOKLYN,SE-0002K WM-0001 WM-0006,21800,0,0,0,0,0,0,23880,23880,0,0,0,0,0,0,23880,23880,0,0,0,0,0,0,47760,47760,PROJECT DELAYED DUE TO UNFORESEEN SITE/FIELD CONDITION,,RECON OF WM & SWR IN 5 AVE B/T 65 ST & 34 ST,cpd11-20bk.pdf
BED-782A,"Reconstuction of water main & combined sewer,Tillary st. PH2",850,DEPT OF DESIGN & CONSTRUCTION,AUGMENTATION OF WATER SUPPLY SYSTEMS,302,BROOKLYN,WM-0001,14039,13994,47,0,0,0,0,0,14041,13994,47,0,0,0,0,0,14041,27988,94,0,0,0,0,0,28082,PROJECT DELAYED DUE TO UNFORESEEN SITE/FIELD CONDITION,,"RECONSTRUCTION OF WATER MAIN & COMBINED SEWER,TILLARY ST. PHASE 2",cpd11-20bk.pdf
BED-784,RECON OF WM I& STORM SWR IN BERGEN AVE AREA,850,DEPT OF DESIGN & CONSTRUCTION,TRUNK AND DISTRIBUTION MAIN REPLACEMENT,318,BROOKLYN,WM-0001 SE-0200K,11730,37333,16361,0,1075,0,0,0,54769,37333,16361,0,1075,0,0,0,54769,74666,32722,0,2150,0,0,0,109538,PROJECT DELAYED DUE TO BUDGETARY CONSTRAINTS,,RECON OF WM IN BERGEN AVE AREA,cpd11-20bk.pdf
BED-785B,"Recon WM, Comb & San Swrs in Atlantic Ave, Ph 2 (HWD10105A)",850,DEPT OF DESIGN & CONSTRUCTION,TRUNK AND DISTRIBUTION MAIN REPLACEMENT,305,BROOKLYN,EP-0007 SE-0002K WM-0001,4326,0,6304,0,0,0,0,0,6304,0,6304,0,0,0,0,0,6304,0,12608,0,0,0,0,0,12608,PROJECT DELAYED DUE TO UNFORESEEN SITE/FIELD CONDITION,,"RECON WM & COMB AND SAN SEWERS IN ATLANTIC AVE, PH 2",cpd11-20bk.pdf
BED-794,DUMBO/Vinegar Hill Area Reconstruction & Plaza.,850,DEPT OF DESIGN & CONSTRUCTION,TRUNK AND DISTRIBUTION MAIN REPLACEMENT,302 306,BROOKLYN,SE-0002K SE-0004,9413,48296,157,6288,0,0,0,0,54741,48296,157,6288,0,0,0,0,54741,96592,314,12576,0,0,0,0,109482,PROJECT DELAYED DUE TO UNFORESEEN SITE/FIELD CONDITION,,"TRUNK/DIST WM REPLAC. & INSTALLATION, COMBINED SWR REPLACE, HI LEVEL STORM SWR",cpd11-20bk.pdf
BED798,"72"" Replacement in Flatbush Avenue between Sterling Pl & 8th",850,DEPT OF DESIGN & CONSTRUCTION,TRUNK AND DISTRIBUTION MAIN REPLACEMENT,306 308,BROOKLYN,SE-0002K WM-0006 HW-0001K TF-0002,25804,48384,1059,1270,0,0,0,0,50713,48384,1059,1270,0,0,0,0,50713,96768,2118,2540,0,0,0,0,101426,PROJECT DELAYED DUE TO UNFORESEEN SITE/FIELD CONDITION,,"72"" REPLACEMENT IN FLATBUSH AVENUE BETWEEN STERLING PL & 8TH AVE. (WITH COMBINED AND",cpd11-20bk.pdf
BED-802,"WM Replacement Hamilton Ave Gowanus Connector, BK HWK1048D",850,DEPT OF DESIGN & CONSTRUCTION,TRUNK AND DISTRIBUTION MAIN REPLACEMENT,306 307,BROOKLYN,SE-0002K WM-0001 SE-0200K,1920,11649,3834,1044,1566,0,0,0,18093,11649,3834,1044,1566,0,0,0,18093,23298,7668,2088,3132,0,0,0,36186,PROJECT DELAYED DUE TO CHANGES IN SCOPE/DESIGN,,"WM REPLACEMENT HAMILTON AVE GOWARNUS CONNECTOR B/T SMITH & 19 ST, BKLYN",cpd11-20bk.pdf
BED-803,"WM Replacment in Schenck Ave b/t Flatlands & Jamaica Ave, Bk",850,DEPT OF DESIGN & CONSTRUCTION,TRUNK AND DISTRIBUTION MAIN REPLACEMENT,305,BROOKLYN,SE-0002K WP-0169,4600,0,1484,0,0,55,0,0,1539,0,1484,0,0,55,0,0,1539,0,2968,0,0,110,0,0,3078,,,"WM REPLAC. SCHENCK AVE B/T FLATLANDS & JAMAICA AVES, BKLYN",cpd11-20bk.pdf
BED-805,"New Storm & San Swrs & WM-Gateway Estates, Phase E (HD-161E)",850,DEPT OF DESIGN & CONSTRUCTION,TRUNK AND DISTRIBUTION MAIN REPLACEMENT,305,BROOKLYN,SE-0002K SE-0200K WM-0001,5776,13712,1100,0,0,0,0,0,14812,13712,1100,0,0,0,0,0,14812,27424,2200,0,0,0,0,0,29624,PROJECT DELAYED DUE TO UNFORESEEN SITE/FIELD CONDITION,,"NEW STORM & SANI SWRS & WM IN GATEWAY ESTATES, PHASE E, BKLY",cpd11-20bk.pdf
BED-806,Water Main work in Brooklyn Waterfront Greenway,850,DEPT OF DESIGN & CONSTRUCTION,TRUNK AND DISTRIBUTION MAIN REPLACEMENT,301,BROOKLYN,WM-0001,1594,0,0,0,1594,0,0,0,1594,0,0,0,1594,0,0,0,1594,0,0,0,3188,0,0,0,3188,PROJECT DELAYED DUE TO UNFORESEEN SITE/FIELD CONDITION,,"WATER MAIN WORK IN BROOKLYN WATERFRONT GREENWAY (COMMERCIAL STREET, ASH STREET AND",cpd11-20bk.pdf
BED-807,WM work in Brooklyn Waterfront Greenway. SAND1048,850,DEPT OF DESIGN & CONSTRUCTION,TRUNK AND DISTRIBUTION MAIN REPLACEMENT,301,BROOKLYN,WM-0001 SE-0002K EP-0007,569,0,3255,0,0,0,0,0,3255,0,3255,0,0,0,0,0,3255,0,6510,0,0,0,0,0,6510,PROJECT DELAYED DUE TO UNFORESEEN SITE/FIELD CONDITION,,WM WORK IN BROOKLYN WATERFRONT GREENWAY. (2ND AVENUE BETWEEN 37TH STREET & 39TH,cpd11-20bk.pdf
BED-809,Replacement of Water Mains in Avenue S,850,DEPT OF DESIGN & CONSTRUCTION,TRUNK AND DISTRIBUTION MAIN REPLACEMENT,315,BROOKLYN,WM-0944 WM-0001 HW-0200,14445,25894,1220,0,0,0,0,0,27114,25894,1220,0,0,0,0,0,27114,51788,2440,0,0,0,0,0,54228,,,REPLACEMENT OF WATER MAINS IN AVENUE S BET. CONEY ISLAND AVENUE AND EAST 18TH STREET,cpd11-20bk.pdf
BED-810,Water Main work in Brooklyn Waterfront Gateway,850,DEPT OF DESIGN & CONSTRUCTION,AUGMENTATION OF WATER SUPPLY SYSTEMS,301,BROOKLYN,WM-0001 SE-0002K,244,11259,801,0,0,0,0,0,12060,11259,801,0,0,0,0,0,12060,22518,1602,0,0,0,0,0,24120,PROJECT DELAYED DUE TO UNFORESEEN SITE/FIELD CONDITION,,WATER MAIN WORK IN BROOKLYN WATERFRONT GATEWAY (KENT AVENUE BET. CLYMER ST & TAYLOR,cpd11-20bk.pdf
BED-819,WM replacement in Oriental Blvd,850,DEPT OF DESIGN & CONSTRUCTION,TRUNK AND DISTRIBUTION MAIN REPLACEMENT,315,BROOKLYN,WM-0944 EP-0007 WM-0001 F-0001,17750,800,0,0,38370,0,0,0,39170,800,0,0,38370,0,0,0,39170,1600,0,0,76740,0,0,0,78340,PROJECT DELAYED DUE TO UNFORESEEN SITE/FIELD CONDITION,,"WM REPLACEMENT IN ORIENTAL BLVD BETWEEN CORBIN PLACE AND PEMBROKE ST,ETC MANHATTAN",cpd11-20bk.pdf
BED-830,Rplment WM Park Ave btw Classon Ave & Ryerson (HWD007K03),850,DEPT OF DESIGN & CONSTRUCTION,REPLACEMENT OR AUGMENTATION OF EXISTING SYSTEMS,302,BROOKLYN,SE-0002K WM-0001,2308,0,0,0,0,2308,0,0,2308,0,0,0,0,2308,0,0,2308,0,0,0,0,4616,0,0,4616,,,(HW007K03) REPLACEMENT OF WATER MAIN ALONG PARK AVENUE BETWEEN CLASSON AVENUE AND,cpd11-20bk.pdf
BEDA-001,Accelerated Distribution WM replcmnt & sewer rehab- BKLYN,850,DEPT OF DESIGN & CONSTRUCTION,TRUNK AND DISTRIBUTION MAIN REPLACEMENT,300,BROOKLYN,WM-0001,15000,15844,415,0,0,0,0,0,16259,15844,415,0,0,0,0,0,16259,31688,830,0,0,0,0,0,32518,PROJECT DELAYED DUE TO UNFORESEEN SITE/FIELD CONDITION,,"ACCELERATED DISTRIBUTION WATER MAIN REPLCMNT & SEWER REHAB/REPLCMNT, BROOKLYN",cpd11-20bk.pdf
BEDA-003,Accelerated Distribution WM replcmnt & sewer rehab- BKLYN,850,DEPT OF DESIGN & CONSTRUCTION,TRUNK AND DISTRIBUTION MAIN REPLACEMENT,300,BROOKLYN,WM-0001 SE-0002K,17175,23940,2048,0,1116,0,0,0,27104,23940,2048,0,1116,0,0,0,27104,47880,4096,0,2232,0,0,0,54208,PROJECT DELAYED DUE TO UNFORESEEN SITE/FIELD CONDITION,,"ACCELERATED DISTRIBUTION WATER MAIN REPLCMNT & SEWER REHAB/REPLCMNT, BROOKLYN",cpd11-20bk.pdf
CJCREN,FACIILITY RENOVATIONS AT CROSSROADS JC,850,DEPT OF DESIGN & CONSTRUCTION,CHILD WELFARE FACILITIES,300,BROOKLYN,CS-0005 PU-0026,15205,63703,9656,955,0,0,0,0,74314,63703,9656,955,0,0,0,0,74314,127406,19312,1910,0,0,0,0,148628,PROJECT DELAYED DUE TO UNFORESEEN SITE/FIELD CONDITION,,THIS PROJECT ENCOMPASSES THE RENOVATION OF THE SECURE JUVENILE DETENTION CENTER,cpd11-20bk.pdf
CO272ELC2,45 MONROE PL - ELECTRICAL / FA UPGRADE,850,DEPT OF DESIGN & CONSTRUCTION,RECONSTRUCTION/RENOVATION OF COURT FACILITIES,302,BROOKLYN,CO-0272,7126,1035,0,0,0,0,0,0,1035,1035,0,0,0,0,0,0,1035,2070,0,0,0,0,0,0,2070,PROJECT DELAYED DUE TO UNFORESEEN SITE/FIELD CONDITION,,BROOKLYN APPELLATE COURT WILL HAVE ITS ELECTRICAL SYSTEM UPGRADED.,cpd11-20bk.pdf
CO272ELV2,45 MONROE PL. - ELEVATOR,850,DEPT OF DESIGN & CONSTRUCTION,RECONSTRUCTION/RENOVATION OF COURT FACILITIES,302,BROOKLYN,CO-0272,1056,411,0,0,0,0,0,0,411,411,0,0,0,0,0,0,411,822,0,0,0,0,0,0,822,PROJECT DELAYED DUE TO BUDGETARY CONSTRAINTS,,45 MONROE PL. - ELEVATOR,cpd11-20bk.pdf
CO278EXT2,360 ADAMS ST. - EXTERIOR,850,DEPT OF DESIGN & CONSTRUCTION,RECONSTRUCTION/RENOVATION OF COURT FACILITIES,301,BROOKLYN,CO-0278,3269,661,0,319,0,2286,0,0,3266,661,0,319,0,2286,0,0,3266,1322,0,638,0,4572,0,0,6532,,,EXTERIOR RESTORATION,cpd11-20bk.pdf
CO278FA3,360 ADAMS STREET - FIRE ALARM SYSTEM & SPRINKLER UPGRADE,850,DEPT OF DESIGN & CONSTRUCTION,RECONSTRUCTION/RENOVATION OF COURT FACILITIES,302,BROOKLYN,CO-0278,40820,9265,638,0,1439,52483,0,0,63825,9265,638,0,1439,52483,0,0,63825,18530,1276,0,2878,104966,0,0,127650,PROJECT DELAYED DUE TO BUDGETARY CONSTRAINTS,,COMPREHENSIVE FIRE ALARM SYSTEM & SPRINKLER UPGRADE,cpd11-20bk.pdf
CO281LL11,120 SCHERMERHORN ST - FACADE REPAIRS LOCAL LAW 11,850,DEPT OF DESIGN & CONSTRUCTION,RECONSTRUCTION/RENOVATION OF COURT FACILITIES,302,BROOKLYN,CO-0281,3235,0,0,0,0,380,0,3357,3737,0,0,0,0,380,0,3357,3737,0,0,0,0,760,0,6714,7474,PROJECT DELAYED DUE TO CHANGES IN SCOPE/DESIGN,,120 SCHERMERHORN ST - FAÝADE REPAIRS LOCAL LAW 11,cpd11-20bk.pdf
CO281TOIL,120 SCHERMERHORN ST.- CODE COMPLIANT TOILET UPGRADE,850,DEPT OF DESIGN & CONSTRUCTION,RECONSTRUCTION/RENOVATION OF COURT FACILITIES,302,BROOKLYN,CO-0281 C-0075 CO-0264,4000,822,0,12139,0,0,0,0,12961,822,0,12139,0,0,0,0,12961,1644,0,24278,0,0,0,0,25922,PROJECT DELAYED DUE TO BUDGETARY CONSTRAINTS,,120 SCHERMERHORN ST.- CODE COMPLIANT TOILET UPGRADE,cpd11-20bk.pdf
CONISPH01,"SAN & STRM SWR, WM1, WM6 IN CONEY ISL AREA, PH 1",850,DEPT OF DESIGN & CONSTRUCTION,REPLACEMENT OR AUGMENTATION OF EXISTING SYSTEMS,313,BROOKLYN,SE-0200K,22139,35819,0,0,180,0,0,0,35999,35819,0,0,180,0,0,0,35999,71638,0,0,360,0,0,0,71998,PROJECT DELAYED DUE TO UNFORESEEN SITE/FIELD CONDITION,,"STORM & SANITARY SEWER, TRUNK AND DISTRIBUTION WATER MAIN IN CONEY ISLAND ARE, PHASE 1",cpd11-20bk.pdf
CONISPH04,"SAN & STRM SWR, WM1, IN CONEY ISL AREA, PH 4",850,DEPT OF DESIGN & CONSTRUCTION,REPLACEMENT OR AUGMENTATION OF EXISTING SYSTEMS,313,BROOKLYN,SE-0200K WM-0006 WM-0001,27679,250,0,0,0,27679,0,0,27929,250,0,0,0,27679,0,0,27929,500,0,0,0,55358,0,0,55858,PROJECT DELAYED DUE TO CHANGES IN SCOPE/DESIGN,"STORM & SANITARY SEWER, DISTRIBUTION WATER MAIN IN CONEY ISLAND AREA,PHASE 4","STORM & SANITARY SEWER, DISTRIBUTION PWATER MAIN IN CONEY ISLAND AREA, PHASE 4",cpd11-20bk.pdf
CONISPH2B,"SAN & STRM SWR, WM1, WM6 IN CONEY ISL AREA, PH 2B",850,DEPT OF DESIGN & CONSTRUCTION,REPLACEMENT OR AUGMENTATION OF EXISTING SYSTEMS,313,BROOKLYN,SE-0200K SE-0002K,18282,57155,2557,0,0,0,0,0,59712,57155,2557,0,0,0,0,0,59712,114310,5114,0,0,0,0,0,119424,PROJECT DELAYED DUE TO UNFORESEEN SITE/FIELD CONDITION,"STORM & SANITARY SEWER, TRUNK AND DISTRIBUTION WATER MAIN IN CONEY ISLAND AREA, PHASE 2B","STORM & SANITARY SEWER, TRUNK AND DISTRIBUTION WATER MAIN IN CONEY ISLAND AREA, PHASE 2B",cpd11-20bk.pdf
CONISPH3A,"Storm and Sanitary Sewer, Trunk and Distribution Water Main",850,DEPT OF DESIGN & CONSTRUCTION,REPLACEMENT OR AUGMENTATION OF EXISTING SYSTEMS,313,BROOKLYN,SE-0200K SE-0002K,38399,59992,832,0,1950,0,0,0,62774,59992,832,0,1950,0,0,0,62774,119984,1664,0,3900,0,0,0,125548,PROJECT DELAYED DUE TO UNFORESEEN SITE/FIELD CONDITION,,"STORM AND SANITARY SEWER, TRUNK AND DISTRIBUTION WATER MAIN IN CONEY ISLAND AREA, PHASE",cpd11-20bk.pdf
CV19COEBU,Centers of Excellence,850,DEPT OF DESIGN & CONSTRUCTION,NEW FACILITIES,,BROOKLYN,HO-0214,66858,25683,12761,0,0,0,0,0,38444,25683,12761,0,0,0,0,0,38444,51366,25522,0,0,0,0,0,76888,,"BUILDING IS A NEWLY LEASED SPACE LOCATED AT 815 BROADWAY, BROOKLYN, NY 11206.","THE WORK TO BE DONE WILL INCLUDE GENERAL CONSTRUCTION, NEW PLUMBING FIXTURES ON ALL",cpd11-20bk.pdf
E12-0023,DCLA,850,DEPT OF DESIGN & CONSTRUCTION,"BUILDING CONSTRUCTION, RECONSTRUCTION OR RETROFIT",301,BROOKLYN,LB-D104,1465,8579,0,0,0,44,0,0,8623,8579,0,0,0,44,0,0,8623,17158,0,0,0,88,0,0,17246,PROJECT DELAYED DUE TO UNFORESEEN SITE/FIELD CONDITION,,BROOKLYN MUSEUM ENERGY EFFICIENCY UPGRADES,cpd11-20bk.pdf
E12-0043,NYPD 84th Precinct - EE Upgrade,850,DEPT OF DESIGN & CONSTRUCTION,"BUILDING CONSTRUCTION, RECONSTRUCTION OR RETROFIT",301,BROOKLYN,PO-0079,694,3596,168,214,0,0,0,0,3978,3596,168,214,0,0,0,0,3978,7192,336,428,0,0,0,0,7956,PROJECT DELAYED DUE TO UNFORESEEN SITE/FIELD CONDITION,,NYPD 84TH PRECINCT & EC 207 ENERGY UPGRADES,cpd11-20bk.pdf
E14-0001,NYPD-FDNY - 67 PCT AND EC248 ENERGY UPGRADE,850,DEPT OF DESIGN & CONSTRUCTION,"BUILDING CONSTRUCTION, RECONSTRUCTION OR RETROFIT",300,BROOKLYN,PU-0025,1248,2204,0,106,0,0,0,0,2310,2204,0,106,0,0,0,0,2310,4408,0,212,0,0,0,0,4620,PROJECT DELAYED DUE TO UNFORESEEN SITE/FIELD CONDITION,,ENERGY UPGRADE,cpd11-20bk.pdf
E17-0006,DSNY - BROOKLYN NORTH 1 DISTRICT &4 DISTRICT GARAGE,850,DEPT OF DESIGN & CONSTRUCTION,"BUILDING CONSTRUCTION, RECONSTRUCTION OR RETROFIT",301,BROOKLYN,PU-0025,13191,810,0,8198,0,0,0,0,9008,810,0,8198,0,0,0,0,9008,1620,0,16396,0,0,0,0,18016,,,BROOKLYN NORTH 1 DISTRICT &4 DISTRICT GARAGE,cpd11-20bk.pdf
EO26-0013,DCLA -New York Aquarium Campus,850,DEPT OF DESIGN & CONSTRUCTION,"BUILDING CONSTRUCTION, RECONSTRUCTION OR RETROFIT",301,BROOKLYN,PU-0025,300,0,0,61,405,0,0,0,466,0,0,61,405,0,0,0,466,0,0,122,810,0,0,0,932,,,NEW YORK BOTANICAL GARDEN CAMPUS,cpd11-20bk.pdf
EO26-0014,DCLA - New York Aquarium Campus,850,DEPT OF DESIGN & CONSTRUCTION,"BUILDING CONSTRUCTION, RECONSTRUCTION OR RETROFIT",301,BROOKLYN,PU-0025,300,0,0,57,261,0,0,0,318,0,0,57,261,0,0,0,318,0,0,114,522,0,0,0,636,,,NEW YORK BOTANICAL GARDEN CAMPUS,cpd11-20bk.pdf
EP6-KENT2,"356 FLUSING, BUILDING REPAIR/UPGRADE",850,DEPT OF DESIGN & CONSTRUCTION,FACILITY PURCHASES AND RECONSTRUCTION,301 302,BROOKLYN,EP-0006,954,36010,972,0,0,0,0,0,36982,36010,972,0,0,0,0,0,36982,72020,1944,0,0,0,0,0,73964,PROJECT DELAYED DUE TO UNFORESEEN SITE/FIELD CONDITION,,BASE BUILDING REPAIRS REQUIRED TO BE DONE AS PART OF MAINTENANCE OF FACILITY,cpd11-20bk.pdf
F175RES2,NEW FIREHOUSE - RESCUE 2,850,DEPT OF DESIGN & CONSTRUCTION,NEW FACILITIES AND RENOVATIONS,300,BROOKLYN,F-0175,22525,34270,1551,0,0,0,0,0,35821,34270,1551,0,0,0,0,0,35821,68540,3102,0,0,0,0,0,71642,PROJECT DELAYED DUE TO UNFORESEEN SITE/FIELD CONDITION,,NEW FIREHOUSE - RESCUE 2,cpd11-20bk.pdf
GCNC77-PA,GI - PERMEABLE ASPHALT PAVEMENT PILOT & GI IN CSO AREA NC-77,850,DEPT OF DESIGN & CONSTRUCTION,GREEN INFRASTRUCTURE PROGRAM,300,BROOKLYN,WP-0169,5172,4490,1089,0,0,0,0,0,5579,4490,1089,0,0,0,0,0,5579,8980,2178,0,0,0,0,0,11158,,,PERMEABLE ASPHALT PAVEMENT PILOT AND GREEN INFRASTRUCTURE N CSO TRIBUTARY AREA NC-077,cpd11-20bk.pdf
GKOH15-01,GI - GREEN INFRASTRUCTURE IN OH-015 GRAVESEND BAY CSO PH 1,850,DEPT OF DESIGN & CONSTRUCTION,GREEN INFRASTRUCTURE PROGRAM,300,BROOKLYN,WP-0169,18817,8367,0,32050,0,0,0,0,40417,8367,0,32050,0,0,0,0,40417,16734,0,64100,0,0,0,0,80834,PROJECT DELAYED DUE TO CHANGES IN SCOPE/DESIGN,,GI - GREEN INFRASTRUCTURE IN OH-015 GRAVESEND BAY CSO TIBUTARY AREA PHASE 1,cpd11-20bk.pdf
GKOH15-02,GI - GREEN INFRASTRUCTURE IN OH-015 GRAVESEND BAY CSO PH 2,850,DEPT OF DESIGN & CONSTRUCTION,GREEN INFRASTRUCTURE PROGRAM,300,BROOKLYN,WP-0169,17234,1277,10310,0,26840,0,0,0,38427,1277,10310,0,26840,0,0,0,38427,2554,20620,0,53680,0,0,0,76854,PROJECT DELAYED DUE TO UNFORESEEN SITE/FIELD CONDITION,,GI - GREEN INFRASTRUCTURE IN OH-015 GRAVESEND BAY CSO TIBUTARY AREA PHASE 2,cpd11-20bk.pdf
GKOH15-03,GI - GREEN INFRASTRUCTURE IN OH-015 GRAVESEND BAY CSO PH 3,850,DEPT OF DESIGN & CONSTRUCTION,GREEN INFRASTRUCTURE PROGRAM,300,BROOKLYN,WP-0169,17982,8232,0,37252,0,0,0,0,45484,8232,0,37252,0,0,0,0,45484,16464,0,74504,0,0,0,0,90968,PROJECT DELAYED DUE TO CHANGES IN SCOPE/DESIGN,,GI - GREEN INFRASTRUCTURE IN OH-015 GRAVESEND BAY CSO TIBUTARY AREA PHASE 3,cpd11-20bk.pdf
GKOH15-04,GI - GREEN INFRASTRUCTURE IN OH-015 GRAVESEND BAY CSO PH 4,850,DEPT OF DESIGN & CONSTRUCTION,GREEN INFRASTRUCTURE PROGRAM,300,BROOKLYN,WP-0169,23046,4395,3023,49,26690,0,0,0,34157,4395,3023,49,26690,0,0,0,34157,8790,6046,98,53380,0,0,0,68314,,,GI - GREEN INFRASTRUCTURE IN OH-015 GRAVESEND BAY CSO TIBUTARY AREA PHASE 4,cpd11-20bk.pdf
GNCB14-2A,"GI-CONSTRUCTION OF GI NIN NCB-014, PHASE II",850,DEPT OF DESIGN & CONSTRUCTION,GREEN INFRASTRUCTURE PROGRAM,300,BROOKLYN,WP-0169,5750,23974,658,231,0,0,0,0,24863,23974,658,231,0,0,0,0,24863,47948,1316,462,0,0,0,0,49726,PROJECT DELAYED DUE TO UNFORESEEN SITE/FIELD CONDITION,,"GI-CONSTRUCTION OF GREEN INFRASTRUCTURE IN NCB-014, PHASE II",cpd11-20bk.pdf
HAM14GOCC,GOWANUS COMMUNITY CENTER RENOVATIONS,850,DEPT OF DESIGN & CONSTRUCTION,LOW TO MODERATE INCOME PUBLIC HOUSING UPGRADE,306,BROOKLYN,HA-D001 HA-0001,150,0,4000,0,0,0,0,0,4000,0,4000,0,0,0,0,0,4000,0,8000,0,0,0,0,0,8000,PROJECT DELAYED DUE TO CHANGES IN SCOPE/DESIGN,,COMMUNITY CENTER RENOVATIONS,cpd11-20bk.pdf
HAM17GHSE,MARLBOROUGH HOUSES BSCAH GREENHOUSE,850,DEPT OF DESIGN & CONSTRUCTION,LOW TO MODERATE INCOME PUBLIC HOUSING UPGRADE,313,BROOKLYN,HA-K001,2000,0,2354,13807,0,0,0,0,16161,0,2354,13807,0,0,0,0,16161,0,4708,27614,0,0,0,0,32322,PROJECT DELAYED DUE TO BUDGETARY CONSTRAINTS,,MARLBOROUGH HOUSES BSCAH GREENHOUSE,cpd11-20bk.pdf
HAM17MRCC,MARCY HOUSES - RENOVATE 492 MARCY AVE INTO A COMM CENTER,850,DEPT OF DESIGN & CONSTRUCTION,LOW TO MODERATE INCOME PUBLIC HOUSING UPGRADE,303,BROOKLYN,HA-0001 HA-D001,5335,10085,2532,0,0,0,0,0,12617,10085,2532,0,0,0,0,0,12617,20170,5064,0,0,0,0,0,25234,PROJECT DELAYED DUE TO BUDGETARY CONSTRAINTS,,RENOVATE VACANT SPACE AT 492 MARCY AVENUE TO CREATE A COMMUNITY CENTER,cpd11-20bk.pdf
HD-161C,GATEWAY ESTATE - PHASE C (SEK20056),850,DEPT OF DESIGN & CONSTRUCTION,OTHER HOUSING SUPPORT INVESTMENT,305,BROOKLYN,HD-0161 HW-0001K,6271,10846,1102,0,0,0,0,0,11948,10846,1102,0,0,0,0,0,11948,21692,2204,0,0,0,0,0,23896,PROJECT DELAYED DUE TO UNFORESEEN SITE/FIELD CONDITION,GATEWAY ESTATE - PHASE C,GATEWAY ESTATE - PHASE C,cpd11-20bk.pdf
HD-161D,GATEWAY ESTATE - PHASE D (SEK002354/SEK20057),850,DEPT OF DESIGN & CONSTRUCTION,OTHER HOUSING SUPPORT INVESTMENT,305,BROOKLYN,TF-0502 HD-0161,6221,15502,593,0,0,0,0,0,16095,15502,593,0,0,0,0,0,16095,31004,1186,0,0,0,0,0,32190,PROJECT DELAYED DUE TO CHANGES IN SCOPE/DESIGN,GATEWAY ESTATE - PHASE D,GATEWAY ESTATE - PHASE D,cpd11-20bk.pdf
HH112AAFS,ATLANTIC ARMORY FIRE SAFETY,850,DEPT OF DESIGN & CONSTRUCTION,SHELTERS FOR HOMELESS INDIVIDUALS,,BROOKLYN,HH-0112,4975,527,0,4489,506,0,0,0,5522,527,0,4489,506,0,0,0,5522,1054,0,8978,1012,0,0,0,11044,PROJECT DELAYED DUE TO BUDGETARY CONSTRAINTS,,ATLANTIC ARMORY FIRE SAFETY,cpd11-20bk.pdf
HH112BVFA,BROWNSVILLE WOMEN FIRE SAFETY,850,DEPT OF DESIGN & CONSTRUCTION,SHELTERS FOR HOMELESS INDIVIDUALS,,BROOKLYN,HH-0112,598,250,0,1233,0,0,0,0,1483,250,0,1233,0,0,0,0,1483,500,0,2466,0,0,0,0,2966,PROJECT DELAYED DUE TO BUDGETARY CONSTRAINTS,,BROWNSVILLE WOMEN FIRE SAFETY,cpd11-20bk.pdf
HH112FBFS,FANNIE BARNES FIRE SAFETY,850,DEPT OF DESIGN & CONSTRUCTION,SHELTERS FOR HOMELESS INDIVIDUALS,,BROOKLYN,HH-0112,1400,299,0,3090,1400,0,0,0,4789,299,0,3090,1400,0,0,0,4789,598,0,6180,2800,0,0,0,9578,PROJECT DELAYED DUE TO BUDGETARY CONSTRAINTS,,FANNIE BARNES FIRE SAFETY,cpd11-20bk.pdf
HH112HWFS,HELP WOMEN'S CENTER FIRE SAFETY,850,DEPT OF DESIGN & CONSTRUCTION,SHELTERS FOR HOMELESS INDIVIDUALS,,BROOKLYN,HH-0112,1313,250,353,0,1250,0,0,0,1853,250,353,0,1250,0,0,0,1853,500,706,0,2500,0,0,0,3706,PROJECT DELAYED DUE TO BUDGETARY CONSTRAINTS,,HELP WOMEN'S CENTER FIRE SAFETY,cpd11-20bk.pdf
HH112LXEP,85 LEXINGTON AVE BOILER RECONSTRUCTION,850,DEPT OF DESIGN & CONSTRUCTION,SHELTERS FOR HOMELESS INDIVIDUALS,,BROOKLYN,HH-0112,2040,0,0,170,1870,0,0,0,2040,0,0,170,1870,0,0,0,2040,0,0,340,3740,0,0,0,4080,,,BOILER RECONS,cpd11-20bk.pdf
HH112PJBO,PAMOJA - BOILER,850,DEPT OF DESIGN & CONSTRUCTION,SHELTERS FOR HOMELESS INDIVIDUALS,,BROOKLYN,HH-0112,2934,1103,0,0,9940,0,0,0,11043,1103,0,0,9940,0,0,0,11043,2206,0,0,19880,0,0,0,22086,,,PAMOJA - BOILER,cpd11-20bk.pdf
HH112PJFC,PAMOJA HOUSE - FACADE REHABILITATION/RESTORATION,850,DEPT OF DESIGN & CONSTRUCTION,SHELTERS FOR HOMELESS INDIVIDUALS,,BROOKLYN,HH-0112,1693,368,663,372,1703,1500,2355,0,6961,368,663,372,1703,1500,2355,0,6961,736,1326,744,3406,3000,4710,0,13922,PROJECT DELAYED DUE TO BUDGETARY CONSTRAINTS,,PAMOJA HOUSE - FACADE REHABILITATION/RESTORATION,cpd11-20bk.pdf
HH112PJPL,PAMOJA HOUSE - PLUMBING UPGRADE,850,DEPT OF DESIGN & CONSTRUCTION,SHELTERS FOR HOMELESS INDIVIDUALS,,BROOKLYN,HH-0112,2600,357,0,394,2400,0,0,0,3151,357,0,394,2400,0,0,0,3151,714,0,788,4800,0,0,0,6302,PROJECT DELAYED DUE TO BUDGETARY CONSTRAINTS,,PAMOJA HOUSE - PLUMBING UPGRADE,cpd11-20bk.pdf
HH112PJRC,PAMOJA HOUSE FIRE SAFETY,850,DEPT OF DESIGN & CONSTRUCTION,SHELTERS FOR HOMELESS INDIVIDUALS,,BROOKLYN,HH-0112,4035,833,0,0,50,0,5924,0,6807,833,0,0,50,0,5924,0,6807,1666,0,0,100,0,11848,0,13614,,,FIRE SAFETY SYSTEM AND FIRE DOORS,cpd11-20bk.pdf
HH115BMEP,BUSHWICK FAMILY BOILER RECONSTRUCTION,850,DEPT OF DESIGN & CONSTRUCTION,SHELTERS FOR HOMELESS FAMILIES,,BROOKLYN,HH-0115,2160,0,430,500,1230,0,0,0,2160,0,430,500,1230,0,0,0,2160,0,860,1000,2460,0,0,0,4320,,,BOILER RECONSTRUCTION,cpd11-20bk.pdf
HH115DSFA,DEAN STREET FIRE SAFETY,850,DEPT OF DESIGN & CONSTRUCTION,SHELTERS FOR HOMELESS FAMILIES,,BROOKLYN,HH-0115,860,360,0,2580,15,0,0,0,2955,360,0,2580,15,0,0,0,2955,720,0,5160,30,0,0,0,5910,PROJECT DELAYED DUE TO BUDGETARY CONSTRAINTS,,DEAN STREET FIRE SAFETY,cpd11-20bk.pdf
HH115LFAU,LINDEN FIRE ALARM UPGRADE,850,DEPT OF DESIGN & CONSTRUCTION,SHELTERS FOR HOMELESS FAMILIES,,BROOKLYN,HH-0112,1115,684,581,0,0,0,0,0,1265,684,581,0,0,0,0,0,1265,1368,1162,0,0,0,0,0,2530,PROJECT DELAYED DUE TO BUDGETARY CONSTRAINTS,,FIRE ALARM UPGRADE,cpd11-20bk.pdf
HH115SFFA,"Stockholm at 99-103 Stockholm St, 11221 - Fire Alarm Upgrade",850,DEPT OF DESIGN & CONSTRUCTION,SHELTERS FOR HOMELESS FAMILIES,,BROOKLYN,HH-0115,335,939,371,0,0,0,0,0,1310,939,371,0,0,0,0,0,1310,1878,742,0,0,0,0,0,2620,,,"STOCKHOLM AT 99-103 STOCKHOLM ST, 11221 - FIRE ALARM UPGRADE",cpd11-20bk.pdf
HH115SRFA,ROSE MCCARTHY - FIRE ALARM SYSTEM UPGRADE,850,DEPT OF DESIGN & CONSTRUCTION,SHELTERS FOR HOMELESS FAMILIES,,BROOKLYN,HH-0115,583,774,293,0,0,0,0,0,1067,774,293,0,0,0,0,0,1067,1548,586,0,0,0,0,0,2134,,,ROSE MCCARTHY - FIRE ALARM SYSTEM UPGRADE,cpd11-20bk.pdf
HIFHPD,Housing Infrastructure Fund for HPD Projects,850,DEPT OF DESIGN & CONSTRUCTION,OTHER HOUSING SUPPORT INVESTMENT,305,BROOKLYN,ED-0075,3482,2229,1253,0,0,0,0,0,3482,2229,1253,0,0,0,0,0,3482,4458,2506,0,0,0,0,0,6964,,HPD,INFRASTRUCTURE COSTS RELATED TO HPD PROJECTS,cpd11-20bk.pdf
HL82BRKLN,Brooklyn Animal Care Center Upgrade,850,DEPT OF DESIGN & CONSTRUCTION,ANIMAL CARE,,BROOKLYN,HL-0082,3500,9591,3142,5469,27000,0,0,0,45202,9591,3142,5469,27000,0,0,0,45202,19182,6284,10938,54000,0,0,0,90404,,,BROOKLYN ANIMAL SHELTER HVAC UPGRADE,cpd11-20bk.pdf
HL82BUSHX,BUSHWICK HEALTH CENTER - EXTERIOR RENOVATION,850,DEPT OF DESIGN & CONSTRUCTION,CLINIC RENOVATION AND REHABILITATION,,BROOKLYN,HL-0082,1736,2715,14212,1500,0,0,0,0,18427,2715,14212,1500,0,0,0,0,18427,5430,28424,3000,0,0,0,0,36854,PROJECT DELAYED DUE TO BUDGETARY CONSTRAINTS,EXTERIOR RENOVATION AND OTHER REHAB PROJECTS AT THE BUSHWICK HEALTH CENTER,EXTERIOR RENOVATION AND OTHER REHAB PROJECTS AT THE BUSHWICK HEALTH CENTER,cpd11-20bk.pdf
HWD005K01,"FULTON ST IMPROVEMENTS AT GREEN AV, HANSEN PL & GATES AV",850,DEPT OF DESIGN & CONSTRUCTION,PRIMARY STREET RECONSTRUCTION,302,BROOKLYN,HW-D101,400,4263,0,0,0,0,0,121,4384,4263,0,0,0,0,0,121,4384,8526,0,0,0,0,0,242,8768,PROJECT DELAYED DUE TO UNFORESEEN SITE/FIELD CONDITION,"FULTON ST IMPROVEMENTS AT GREEN AV, HANSEN PL & GATES AV INTERSECTIONS","FULTON ST IMPROVEMENTS AT GREEN AV, HANSEN PL & GATES AV INTERSECTIONS",cpd11-20bk.pdf
HWD007K03,"Park Avenue Ped Safety Improvement at the Crossover,BED-830",850,DEPT OF DESIGN & CONSTRUCTION,PRIMARY STREET RECONSTRUCTION,302 303 304,BROOKLYN,HW-K005 HW-D101 HW-0001K,300,650,0,854,0,5251,0,0,6755,650,0,854,0,5251,0,0,6755,1300,0,1708,0,10502,0,0,13510,PROJECT DELAYED DUE TO UNFORESEEN SITE/FIELD CONDITION,,MYRTLE AVE WORK,cpd11-20bk.pdf
HWD10105,"Ped Safety Upgrades on Atlantic Ave (BED-785A, NDF-ATLAV)",850,DEPT OF DESIGN & CONSTRUCTION,PRIMARY STREET RECONSTRUCTION,302 303 305 316,BROOKLYN,TF-0002,32000,13758,57,0,0,0,0,0,13815,13758,57,0,0,0,0,0,13815,27516,114,0,0,0,0,0,27630,PROJECT DELAYED DUE TO UNFORESEEN SITE/FIELD CONDITION,PED SAFETY UPGRADES ON ATLANTIC AVE,PED SAFETY UPGRADES ON ATLANTIC AVE,cpd11-20bk.pdf
HWD10105A,Ped Safety Upgrades on Atlantic Ave - Phase 2 (BED-785B),850,DEPT OF DESIGN & CONSTRUCTION,PRIMARY STREET RECONSTRUCTION,300,BROOKLYN,HW-0001K HW-K005 HW-0001Q HW-0200 HW-0944 TF-0002 TF-0502,31830,3073,35378,1264,667,0,0,0,40382,3073,35378,1264,667,0,0,0,40382,6146,70756,2528,1334,0,0,0,80764,PROJECT DELAYED DUE TO UNFORESEEN SITE/FIELD CONDITION,PEDESTIAN SAFETY UPGRADES ON ATLANTIC AVE - PHASE 2,PEDESTIAN SAFETY UPGRADES ON ATLANTIC AVE - PHASE 2,cpd11-20bk.pdf
HWK002377,East 72nd Street Reconstruction Brooklyn,850,DEPT OF DESIGN & CONSTRUCTION,PRIMARY STREET RECONSTRUCTION,300,BROOKLYN,HW-0001K,5670,0,207,0,0,5463,0,0,5670,0,207,0,0,5463,0,0,5670,0,414,0,0,10926,0,0,11340,PROJECT DELAYED DUE TO CHANGES IN SCOPE/DESIGN,,EAST 72ND STREET RECONSTRUCTION BROOKLYN,cpd11-20bk.pdf
HWK100BUS,Utica Ave Bus Priority,850,DEPT OF DESIGN & CONSTRUCTION,TRAFFIC WORK IN CONJUNCTION WITH HIGHWAY RECONSTRUCTION,300 308 309 317 318,BROOKLYN,HW-1684 HW-0001K TF-0502 WM-0001 HW-D101,6400,10439,770,0,0,0,0,0,11209,10439,770,0,0,0,0,0,11209,20878,1540,0,0,0,0,0,22418,PROJECT DELAYED DUE TO UNFORESEEN SITE/FIELD CONDITION,UTICA AVE BROOKLYN,UTICA AVE BUS PRIORITY,cpd11-20bk.pdf
HWK100SBC,South Brooklyn Crosstown SBS,850,DEPT OF DESIGN & CONSTRUCTION,PRIMARY STREET RECONSTRUCTION,300,BROOKLYN,HW-D101 HW-1684,7750,3467,150,74412,0,0,0,0,78029,3467,150,74412,0,0,0,0,78029,6934,300,148824,0,0,0,0,156058,PROJECT DELAYED DUE TO BUDGETARY CONSTRAINTS,SOUTH BROOKLYN CROSSTOWN SBS,SOUTH BROOKLYN CROSSTOWN SBS,cpd11-20bk.pdf
HWK1048C,KENT AVE,850,DEPT OF DESIGN & CONSTRUCTION,PRIMARY STREET RECONSTRUCTION,300,BROOKLYN,HW-0001K,32633,8663,1715,0,0,0,0,0,10378,8663,1715,0,0,0,0,0,10378,17326,3430,0,0,0,0,0,20756,PROJECT DELAYED DUE TO UNFORESEEN SITE/FIELD CONDITION,KENT AVE,KENT AVE,cpd11-20bk.pdf
HWK1048D,BK Waterfront Greenway,850,DEPT OF DESIGN & CONSTRUCTION,PRIMARY STREET RECONSTRUCTION,307,BROOKLYN,HW-0001K HW-K005 WM-0001 TF-0002 TF-0502,12060,11594,7763,1078,1166,0,0,0,21601,11594,7763,1078,1166,0,0,0,21601,23188,15526,2156,2332,0,0,0,43202,PROJECT DELAYED DUE TO CHANGES IN SCOPE/DESIGN,IMPROVEMENTS TO THE PEDESTRIAN AND BICYCLE NETWORK FROM THE HAMILTON AVENUE BRIDGE,IMPROVEMENTS TO THE PEDESTRIAN AND BICYCLE NETWORK FROM THE HAMILTON AVENUE BRIDGE,cpd11-20bk.pdf
HWK1048E,Brooklyn Waterfront Greenway - Commercial Street/Ash Street,850,DEPT OF DESIGN & CONSTRUCTION,PRIMARY STREET RECONSTRUCTION,300,BROOKLYN,HW-0001K HW-D101,10300,0,972,0,0,999,0,0,1971,0,972,0,0,999,0,0,1971,0,1944,0,0,1998,0,0,3942,PROJECT DELAYED DUE TO BUDGETARY CONSTRAINTS,BROOKLYN WATERFRONT GREENWAY - COMMERCIAL STREET/ASH STREET,BROOKLYN WATERFRONT GREENWAY - COMMERCIAL STREET/ASH STREET,cpd11-20bk.pdf
HWK1048G,OWL'S HEAD-BROOKLYN GREENWAY (SEK002378),850,DEPT OF DESIGN & CONSTRUCTION,PRIMARY STREET RECONSTRUCTION,300,BROOKLYN,HW-0001K,6400,15538,313,0,0,0,0,0,15851,15538,313,0,0,0,0,0,15851,31076,626,0,0,0,0,0,31702,PROJECT DELAYED DUE TO UNFORESEEN SITE/FIELD CONDITION,OWL'S HEAD - BROOKLYN GREENWAY,OWL'S HEAD - BROOKLYN GREENWAY,cpd11-20bk.pdf
HWK1148,JEWEL STREET AREA,850,DEPT OF DESIGN & CONSTRUCTION,PRIMARY STREET RECONSTRUCTION,305,BROOKLYN,WM-0001 HW-1148 HW-0061 HW-0200 TF-0002 TF-0502,9274,3128,0,0,0,0,0,33902,37030,3128,0,0,0,0,0,33902,37030,6256,0,0,0,0,0,67804,74060,PROJECT DELAYED DUE TO CHANGES IN SCOPE/DESIGN,,,cpd11-20bk.pdf
HWK1170,Willoughby Street Plaza Reconstruction PINX550.59,850,DEPT OF DESIGN & CONSTRUCTION,PRIMARY STREET RECONSTRUCTION,302,BROOKLYN,HW-0001K,3300,2686,0,0,0,0,0,0,2686,2686,0,0,0,0,0,0,2686,5372,0,0,0,0,0,0,5372,PROJECT DELAYED DUE TO UNFORESEEN SITE/FIELD CONDITION,WILLOUGHBY STREET PLAZA RECONSTRUCTION,WILLOUGHBY STREET PLAZA RECONSTRUCTION,cpd11-20bk.pdf
HWK1182,Belt Parkway Guardrails,850,DEPT OF DESIGN & CONSTRUCTION,PRIMARY STREET RECONSTRUCTION,300,BROOKLYN,HW-0001K,4016,0,0,0,0,3078,0,0,3078,0,0,0,0,3078,0,0,3078,0,0,0,0,6156,0,0,6156,PROJECT DELAYED DUE TO UNFORESEEN SITE/FIELD CONDITION,BELT PARKWAY GUARDRAILS,BELT PARKWAY GUARDRAILS,cpd11-20bk.pdf
HWK1669A,4th Ave Safety Improvements - Phase A,850,DEPT OF DESIGN & CONSTRUCTION,PRIMARY STREET RECONSTRUCTION,300,BROOKLYN,HW-0001K HW-0200 HW-0944 TF-0002 TF-0502,54835,6565,26547,0,4375,0,0,0,37487,6565,26547,0,4375,0,0,0,37487,13130,53094,0,8750,0,0,0,74974,PROJECT DELAYED DUE TO UNFORESEEN SITE/FIELD CONDITION,4TH AVE FROM 18TH TO 33RD ST,4TH AVE SAFETY IMPROVEMENTS - PHASE 2,cpd11-20bk.pdf
HWK1672,WASHINGTON AVENUE SAFETY IMPROVEMENTS,850,DEPT OF DESIGN & CONSTRUCTION,PRIMARY STREET RECONSTRUCTION,300,BROOKLYN,HW-0001K,11100,1393,0,0,9323,0,0,0,10716,1393,0,0,9323,0,0,0,10716,2786,0,0,18646,0,0,0,21432,,WASHINGTON AVENUE SAFETY IMPROVEMENTS,WASHINGTON AVENUE SAFETY IMPROVEMENTS,cpd11-20bk.pdf
HWK2048,Jamaica Bay Greenway - Paerdegat Ave.North Connector BED-883,850,DEPT OF DESIGN & CONSTRUCTION,PRIMARY STREET RECONSTRUCTION,300,BROOKLYN,HW-0001K,3540,991,0,4692,0,0,0,0,5683,991,0,4692,0,0,0,0,5683,1982,0,9384,0,0,0,0,11366,PROJECT DELAYED DUE TO CHANGES IN SCOPE/DESIGN,JAMAICA BAY GREENWAY - PAERDEGAT AVE. NORTH CONNECTOR,JAMAICA BAY GREENWAY - PAERDEGAT AVE. NORTH CONNECTOR,cpd11-20bk.pdf
HWK614D,"RECONSTRUCTION OF BERGEN AVENUE AREA, BKLYN /BED-784",850,DEPT OF DESIGN & CONSTRUCTION,PRIMARY STREET RECONSTRUCTION,318,BROOKLYN,HW-0001K,30591,29785,0,0,0,495,0,0,30280,29785,0,0,0,495,0,0,30280,59570,0,0,0,990,0,0,60560,PROJECT DELAYED DUE TO CHANGES IN SCOPE/DESIGN,"RECONSTRUCTION OF BERGEN AVENUE AREA, BKLYN","RECONSTRUCTION OF BERGEN AVENUE AREA, BKLYN",cpd11-20bk.pdf
HWK639W,RECON,850,DEPT OF DESIGN & CONSTRUCTION,PRIMARY STREET RECONSTRUCTION,302,BROOKLYN,HW-0001K TF-0002,16406,9771,323,0,0,0,0,0,10094,9771,323,0,0,0,0,0,10094,19542,646,0,0,0,0,0,20188,PROJECT DELAYED DUE TO CHANGES IN SCOPE/DESIGN,RECONSTRUCT CADMAN PLAZA EAST,TILLARY ST,cpd11-20bk.pdf
HWK639WA,RECON,850,DEPT OF DESIGN & CONSTRUCTION,PRIMARY STREET RECONSTRUCTION,300,BROOKLYN,TF-0002 TF-0502 HW-0001K,17200,13311,728,0,0,0,0,0,14039,13311,728,0,0,0,0,0,14039,26622,1456,0,0,0,0,0,28078,PROJECT DELAYED DUE TO BUDGETARY CONSTRAINTS,RECON,RECON,cpd11-20bk.pdf
HWK700B,Reconstruction of Columbia Street Area Phase II (BED-768B),850,DEPT OF DESIGN & CONSTRUCTION,PRIMARY STREET RECONSTRUCTION,306,BROOKLYN,HW-0001K,14097,2038,0,48185,0,0,0,0,50223,2038,0,48185,0,0,0,0,50223,4076,0,96370,0,0,0,0,100446,PROJECT DELAYED DUE TO CHANGES IN SCOPE/DESIGN,COLUMBIA STREET RECONSTRUCTION (SOUTH OF HAMILTON AVE.) THIS PROJECTIS IN CONJUNCTION,COLUMBIA STREET RECONSTRUCTION (SOUTH OF HAMILTON AVE.) THIS PROJECTIS IN CONJUNCTION,cpd11-20bk.pdf
HWK797W,Schenck Avenue,850,DEPT OF DESIGN & CONSTRUCTION,PRIMARY STREET RECONSTRUCTION,305,BROOKLYN,HW-0944 TF-0002 TF-0502 HW-0796 HW-0200,4882,1124,941,8630,0,0,0,0,10695,1124,941,8630,0,0,0,0,10695,2248,1882,17260,0,0,0,0,21390,PROJECT DELAYED DUE TO CHANGES IN SCOPE/DESIGN,SCHENCK AVENUE,SCHENCK AVENUE,cpd11-20bk.pdf
HWK876,"RECONSTRUCTION OF WYCKOFF AVENUE, BROOKLYN",850,DEPT OF DESIGN & CONSTRUCTION,PRIMARY STREET RECONSTRUCTION,304,BROOKLYN,HW-D101 HW-0876 HW-K005 HW-0200 TF-0002 TF-0502 HW-0944,19145,6698,0,0,0,160,31548,0,38406,6698,0,0,0,160,31548,0,38406,13396,0,0,0,320,63096,0,76812,PROJECT DELAYED DUE TO CHANGES IN SCOPE/DESIGN,,WYCKOFF AVENUE FROM FLUSHING AVENUE TO GATES AVENUERECONSTRUCTION OF THE EXISTING,cpd11-20bk.pdf
HWK900,Brownsville Pedestrian Safety Improvements,850,DEPT OF DESIGN & CONSTRUCTION,PRIMARY STREET RECONSTRUCTION,300,BROOKLYN,HW-0001K,10400,0,0,0,8914,0,0,1486,10400,0,0,0,8914,0,0,1486,10400,0,0,0,17828,0,0,2972,20800,PROJECT DELAYED DUE TO BUDGETARY CONSTRAINTS,BROWNSVILLE PEDESTRIAN SAFETY IMPROVEMENTS,BROWNSVILLE PEDESTRIAN SAFETY IMPROVEMENTS,cpd11-20bk.pdf
HWKDTBK,Park Avenue - Ingersoll Safety Improvements,850,DEPT OF DESIGN & CONSTRUCTION,PRIMARY STREET RECONSTRUCTION,300,BROOKLYN,HW-0001K HW-K005,1700,0,0,0,0,0,4116,0,4116,0,0,0,0,0,4116,0,4116,0,0,0,0,0,8232,0,8232,PROJECT DELAYED DUE TO BUDGETARY CONSTRAINTS,PARK AVENUE - INGERSOLL SAFETY IMPROVEMENTS,PARK AVENUE - INGERSOLL SAFETY IMPROVEMENTS,cpd11-20bk.pdf
HWKF488R,Hamilton Asphalt Plant Roof Replacement,850,DEPT OF DESIGN & CONSTRUCTION,FACILITY RECONSTRUCTION,300,BROOKLYN,HW-0003,727,1102,19,3160,0,0,0,0,4281,1102,19,3160,0,0,0,0,4281,2204,38,6320,0,0,0,0,8562,PROJECT DELAYED DUE TO UNFORESEEN SITE/FIELD CONDITION,HAMILTON ASPHALT PLANT ROOF REPLACEMENT,HAMILTON ASPHALT PLANT ROOF REPLACEMENT,cpd11-20bk.pdf
HWKKP005,DUMBO D.M.A. - VINEGAR HILL AREA,850,DEPT OF DESIGN & CONSTRUCTION,PRIMARY STREET RECONSTRUCTION,302,BROOKLYN,HW-0001K TF-0502 HW-0944,2200,41423,1839,5052,0,0,0,0,48314,41423,1839,5052,0,0,0,0,48314,82846,3678,10104,0,0,0,0,96628,PROJECT DELAYED DUE TO UNFORESEEN SITE/FIELD CONDITION,DUMBO D.M.A.,DUMBO D.M.A.,cpd11-20bk.pdf
HWP19KC1,Citywide Complex Pedestrian Ramps - Brooklyn,850,DEPT OF DESIGN & CONSTRUCTION,PEDESTRIAN RAMP CONSTRUCTION,300,BROOKLYN,HW-0200,6687,1162,0,6180,0,0,0,0,7342,1162,0,6180,0,0,0,0,7342,2324,0,12360,0,0,0,0,14684,PROJECT DELAYED DUE TO BUDGETARY CONSTRAINTS,,CITYWIDE COMPLEX PEDESTRIAN RAMPS- BROOKLYN,cpd11-20bk.pdf
HWP19KC2,Citywide Complex Pedestrian Ramps - Brooklyn,850,DEPT OF DESIGN & CONSTRUCTION,PEDESTRIAN RAMP CONSTRUCTION,300,BROOKLYN,HW-0200,6687,1667,0,7215,0,0,0,0,8882,1667,0,7215,0,0,0,0,8882,3334,0,14430,0,0,0,0,17764,PROJECT DELAYED DUE TO BUDGETARY CONSTRAINTS,,CITYWIDE COMPLEX PEDESTRIAN RAMPS- BROOKLYN,cpd11-20bk.pdf
HWP19KC3,Citywide Complex Pedestrian Ramps - Brooklyn,850,DEPT OF DESIGN & CONSTRUCTION,PEDESTRIAN RAMP CONSTRUCTION,300,BROOKLYN,HW-0200,6687,1948,0,6180,0,0,0,0,8128,1948,0,6180,0,0,0,0,8128,3896,0,12360,0,0,0,0,16256,PROJECT DELAYED DUE TO BUDGETARY CONSTRAINTS,,CITYWIDE COMPLEX PEDESTRIAN RAMPS- BROOKLYN,cpd11-20bk.pdf
HWP2020KC,Non-Standard Ped Ramp Installs - Brooklyn,850,DEPT OF DESIGN & CONSTRUCTION,PEDESTRIAN RAMP CONSTRUCTION,300,BROOKLYN,HW-0200,7275,571,496,0,6724,0,0,0,7791,571,496,0,6724,0,0,0,7791,1142,992,0,13448,0,0,0,15582,PROJECT DELAYED DUE TO BUDGETARY CONSTRAINTS,COMPLEX PED RAMP INSTALLS - BROOKLYN,COMPLEX PED RAMP INSTALLS - BROOKLYN,cpd11-20bk.pdf
HWPEDSF4,Multi-Site Pedestrian Safety,850,DEPT OF DESIGN & CONSTRUCTION,LOCAL STREET RECONSTRUCTION,399,BROOKLYN,HW-0988,563,16756,544,0,0,0,0,0,17300,16756,544,0,0,0,0,0,17300,33512,1088,0,0,0,0,0,34600,PROJECT DELAYED DUE TO CHANGES IN SCOPE/DESIGN,FUNDING IS FOR TWO LOCATIONS; 1) $200K FOR CHRUCH AVE/PROSPECT EXPY AND 2) $189K FOR 8TH,FUNDING IS FOR TWO LOCATIONS; 1) $200K FOR CHRUCH AVE/PROSPECT EXPY AND 2) $189K FOR 8TH,cpd11-20bk.pdf
HWPEDSF4A,Multi-Site Pedestrian Safety - Phase 4A,850,DEPT OF DESIGN & CONSTRUCTION,PRIMARY STREET RECONSTRUCTION,300,BROOKLYN,HW-1684 HW-0200 HW-0944 TF-0002 TF-0502 HW-D103,4123,60,3966,0,0,0,0,0,4026,60,3966,0,0,0,0,0,4026,120,7932,0,0,0,0,0,8052,PROJECT DELAYED DUE TO UNFORESEEN SITE/FIELD CONDITION,MULTI-SITE PEDESTRIAN SAFETY - PHASE 4A,MULTI-SITE PEDESTRIAN SAFETY - PHASE 4A,cpd11-20bk.pdf
HWPEDSF5,Multi-Site Pedestrian Safety Phase 5,850,DEPT OF DESIGN & CONSTRUCTION,PRIMARY STREET RECONSTRUCTION,300,BROOKLYN,HW-0001K HW-0001M HW-0001Q HW-0001X SE-0002M HW-D102,400,16405,7528,728,728,0,0,0,25389,16405,7528,728,728,0,0,0,25389,32810,15056,1456,1456,0,0,0,50778,PROJECT DELAYED DUE TO CHANGES IN SCOPE/DESIGN,MULTI-SITE LOCATIONS,MULTI-SITE LOCATIONS,cpd11-20bk.pdf
HWPLZ017K,Osborn Street Plaza,850,DEPT OF DESIGN & CONSTRUCTION,PRIMARY STREET RECONSTRUCTION,300,BROOKLYN,HW-0061 HW-1684,2500,939,182,0,3050,0,0,0,4171,939,182,0,3050,0,0,0,4171,1878,364,0,6100,0,0,0,8342,PROJECT DELAYED DUE TO BUDGETARY CONSTRAINTS,OSBORN STREET PLAZA,OSBORN STREET PLAZA,cpd11-20bk.pdf
HWPR19K1,Pedestrian Ramp Rehabilitation - Brooklyn,850,DEPT OF DESIGN & CONSTRUCTION,PEDESTRIAN RAMP CONSTRUCTION,300,BROOKLYN,HW-0200,13813,7998,5347,1156,0,0,0,0,14501,7998,5347,1156,0,0,0,0,14501,15996,10694,2312,0,0,0,0,29002,PROJECT DELAYED DUE TO UNFORESEEN SITE/FIELD CONDITION,,PEDESTRIAN RAMP REHABILITATION- BROOKLYN,cpd11-20bk.pdf
HWPR19K2,Pedestrian Ramp Rehabilitation - Brooklyn,850,DEPT OF DESIGN & CONSTRUCTION,PEDESTRIAN RAMP CONSTRUCTION,300,BROOKLYN,HW-0200,13813,8518,5333,1639,0,0,0,0,15490,8518,5333,1639,0,0,0,0,15490,17036,10666,3278,0,0,0,0,30980,PROJECT DELAYED DUE TO UNFORESEEN SITE/FIELD CONDITION,,PEDESTRIAN RAMP REHABILITATION- BROOKLYN,cpd11-20bk.pdf
HWPR19KC,Complex Upgrades Ped Ramp - Brooklyn,850,DEPT OF DESIGN & CONSTRUCTION,PEDESTRIAN RAMP CONSTRUCTION,300,BROOKLYN,HW-0200,7705,1975,0,7783,0,0,0,0,9758,1975,0,7783,0,0,0,0,9758,3950,0,15566,0,0,0,0,19516,PROJECT DELAYED DUE TO BUDGETARY CONSTRAINTS,COMPLEX UPGRADES PED RAMP - BROOKLYN,COMPLEX UPGRADES PED RAMP - BROOKLYN,cpd11-20bk.pdf
HWPR20K1,Pedestrian Ramps Rehabilitation - Brooklyn,850,DEPT OF DESIGN & CONSTRUCTION,PEDESTRIAN RAMP CONSTRUCTION,300,BROOKLYN,HW-0200,17211,85,8605,8606,0,0,0,0,17296,85,8605,8606,0,0,0,0,17296,170,17210,17212,0,0,0,0,34592,PROJECT DELAYED DUE TO BUDGETARY CONSTRAINTS,PEDESTRIAN RAMP REHAB - BROOKLYN,PEDESTRIAN RAMPS REHAB - BROOKLYN,cpd11-20bk.pdf
HWPR20K2,Pedestrian Ramp Rehabilitation - Brooklyn,850,DEPT OF DESIGN & CONSTRUCTION,PEDESTRIAN RAMP CONSTRUCTION,300,BROOKLYN,HW-0200,17211,200,8605,8606,0,0,0,0,17411,200,8605,8606,0,0,0,0,17411,400,17210,17212,0,0,0,0,34822,PROJECT DELAYED DUE TO BUDGETARY CONSTRAINTS,PEDESTRIAN RAMP REHABILITATION - BROOKLYN,PEDESTRIAN RAMP REHABILITATION - BROOKLYN,cpd11-20bk.pdf
HWPR20K3,Pedestrian Ramp Rehabilitation - Brooklyn,850,DEPT OF DESIGN & CONSTRUCTION,PEDESTRIAN RAMP CONSTRUCTION,300,BROOKLYN,HW-0200,17211,45,8558,8559,0,0,0,0,17162,45,8558,8559,0,0,0,0,17162,90,17116,17118,0,0,0,0,34324,PROJECT DELAYED DUE TO BUDGETARY CONSTRAINTS,PEDESTRIAN RAMP REHABILITATION - BROOKLYN,PEDESTRIAN RAMP REHABILITATION - BROOKLYN,cpd11-20bk.pdf
HWPR20KC,Non-Standard Upgrades Ped Ramp - Brooklyn,850,DEPT OF DESIGN & CONSTRUCTION,PEDESTRIAN RAMP CONSTRUCTION,300,BROOKLYN,HW-0200,6348,250,0,5899,0,0,0,0,6149,250,0,5899,0,0,0,0,6149,500,0,11798,0,0,0,0,12298,PROJECT DELAYED DUE TO BUDGETARY CONSTRAINTS,COMPLEX UPGRADES PED RAMP - BROOKLYN,COMPLEX UPGRADES PED RAMP - BROOKLYN,cpd11-20bk.pdf
HWPR21K1,Rehabilitation of Standard Ped Ramps - Brooklyn,850,DEPT OF DESIGN & CONSTRUCTION,PEDESTRIAN RAMP CONSTRUCTION,300,BROOKLYN,HW-0200,16626,200,0,7990,7992,0,0,0,16182,200,0,7990,7992,0,0,0,16182,400,0,15980,15984,0,0,0,32364,,,REHABILITATION OF STANDARD PED RAMPS - BROOKLYN,cpd11-20bk.pdf
HWS2009K,PRIOR NOTICE SIDEWALKS - BROOKLYN(SIM),850,DEPT OF DESIGN & CONSTRUCTION,SIDEWALK RECONSTRUCTION,300,BROOKLYN,HW-0200,3274,3211,0,0,0,0,0,226,3437,3211,0,0,0,0,0,226,3437,6422,0,0,0,0,0,452,6874,PROJECT DELAYED DUE TO UNFORESEEN SITE/FIELD CONDITION,PRIOR NOTICE SIDEWALKS - BROOKLYN,PRIOR NOTICE SIDEWALKS - BROOKLYN,cpd11-20bk.pdf
HWS2020K1,Prior Notice Sidewalks- Brooklyn,850,DEPT OF DESIGN & CONSTRUCTION,SIDEWALK RECONSTRUCTION,300,BROOKLYN,HW-0200 P-1018,8000,128,6877,443,0,0,0,0,7448,128,6877,443,0,0,0,0,7448,256,13754,886,0,0,0,0,14896,PROJECT DELAYED DUE TO BUDGETARY CONSTRAINTS,PRIOR NOTICE SIDEWALKS- BROOKLYN,PRIOR NOTICE SIDEWALKS- BROOKLYN,cpd11-20bk.pdf
HWS2020K2,Prior Notice Sidewalks- Brooklyn,850,DEPT OF DESIGN & CONSTRUCTION,SIDEWALK RECONSTRUCTION,300,BROOKLYN,HW-0200 P-1018,8000,100,6754,436,0,0,0,0,7290,100,6754,436,0,0,0,0,7290,200,13508,872,0,0,0,0,14580,PROJECT DELAYED DUE TO BUDGETARY CONSTRAINTS,PRIOR NOTICE SIDEWALKS- BROOKLYN,PRIOR NOTICE SIDEWALKS- BROOKLYN,cpd11-20bk.pdf
HWSRT200E,Safe Routes to Transit,850,DEPT OF DESIGN & CONSTRUCTION,PRIMARY STREET RECONSTRUCTION,300,BROOKLYN,HW-0001K HW-0200 HW-0988,500,1870,680,0,0,9110,0,0,11660,1870,680,0,0,9110,0,0,11660,3740,1360,0,0,18220,0,0,23320,,SAFE ROUTES TO TRANSIT,SAFE ROUTES TO TRANSIT,cpd11-20bk.pdf
HWTRK1,Trench Restoration - Brooklyn,850,DEPT OF DESIGN & CONSTRUCTION,PRIMARY STREET RECONSTRUCTION,300,BROOKLYN,HW-D101 HW-0001K HW-K005,25278,2264,450,22708,0,0,0,0,25422,2264,450,22708,0,0,0,0,25422,4528,900,45416,0,0,0,0,50844,,,TRENCH RESTORATION - BROOKLYN,cpd11-20bk.pdf
HWTRK883,"Trench Restoration -- Bay Parkway, Brooklyn, SE-883",850,DEPT OF DESIGN & CONSTRUCTION,PRIMARY STREET RECONSTRUCTION,300,BROOKLYN,HW-0001K,5129,200,0,0,5129,0,0,0,5329,200,0,0,5129,0,0,0,5329,400,0,0,10258,0,0,0,10658,,"TRENCH RESTORATION -- BAY PARKWAY, BROOKLYN","TRENCH RESTORATION -- BAY PARKWAY, BROOKLYN",cpd11-20bk.pdf
LB-104KEN,KENSINGTON - Replacement Facility,850,DEPT OF DESIGN & CONSTRUCTION,REHABILITATION AND RELOCATION OF BRANCH LIBRARIES,312,BROOKLYN,LB-K001,12788,16532,0,53,0,0,0,1,16586,16532,0,53,0,0,0,1,16586,33064,0,106,0,0,0,2,33172,PROJECT DELAYED DUE TO CHANGES IN SCOPE/DESIGN,BROOKLYN,THIS PROJECT CONSISTS OF THE DESIGN AND CONSTRUCTION OF THE NEW KENSINGTON BRANCH,cpd11-20bk.pdf
LBC10CDHC,CLARENDON HVAC Replacement,850,DEPT OF DESIGN & CONSTRUCTION,ESSENTIAL RECONSTRUCTION OF FACILITIES,317,BROOKLYN,LB-D104 LB-0104,775,1001,0,2066,0,0,0,0,3067,1001,0,2066,0,0,0,0,3067,2002,0,4132,0,0,0,0,6134,PROJECT DELAYED DUE TO CHANGES IN SCOPE/DESIGN,,BOILER REPLACEMENT,cpd11-20bk.pdf
LBC12STHC,SARATOGA BOILER AND HVAC REPLACEMENT,850,DEPT OF DESIGN & CONSTRUCTION,ESSENTIAL RECONSTRUCTION OF FACILITIES,316,BROOKLYN,LB-0104 LB-D104,790,2193,1066,487,0,0,0,0,3746,2193,1066,487,0,0,0,0,3746,4386,2132,974,0,0,0,0,7492,PROJECT DELAYED DUE TO CHANGES IN SCOPE/DESIGN,,SARATOGA HVAC REPLACEMENT,cpd11-20bk.pdf
LBC13BPRF,BOROUGH PARK INTERIOR AND EXTERIOR REHABILITATION,850,DEPT OF DESIGN & CONSTRUCTION,ESSENTIAL RECONSTRUCTION OF FACILITIES,310,BROOKLYN,LB-0104 LB-D104,3177,1843,0,33,0,16742,0,0,18618,1843,0,33,0,16742,0,0,18618,3686,0,66,0,33484,0,0,37236,PROJECT DELAYED DUE TO CHANGES IN SCOPE/DESIGN,,ROOF RENOVATION,cpd11-20bk.pdf
LBC14CYHC,CYPRESS HILLS HVAC REPLACEMENT,850,DEPT OF DESIGN & CONSTRUCTION,ESSENTIAL RECONSTRUCTION OF FACILITIES,305,BROOKLYN,LB-0104,1018,322,0,0,0,0,182,0,504,322,0,0,0,0,182,0,504,644,0,0,0,0,364,0,1008,PROJECT DELAYED DUE TO CHANGES IN SCOPE/DESIGN,,CYPRESS HILLS HVAC REPLACEMENT,cpd11-20bk.pdf
LBC14LDRF,LEONARD ROOF REPLACEMENT,850,DEPT OF DESIGN & CONSTRUCTION,ESSENTIAL RECONSTRUCTION OF FACILITIES,301,BROOKLYN,LB-D104 LB-0104,975,337,0,766,0,0,0,0,1103,337,0,766,0,0,0,0,1103,674,0,1532,0,0,0,0,2206,PROJECT DELAYED DUE TO CHANGES IN SCOPE/DESIGN,,LEONARD ROOF REPAIR,cpd11-20bk.pdf
LBC15BWHC,Bushwick Heating & Cooling,850,DEPT OF DESIGN & CONSTRUCTION,ESSENTIAL RECONSTRUCTION OF FACILITIES,301,BROOKLYN,LB-D104 LB-0104,750,583,0,2736,0,0,0,0,3319,583,0,2736,0,0,0,0,3319,1166,0,5472,0,0,0,0,6638,PROJECT DELAYED DUE TO CHANGES IN SCOPE/DESIGN,,BUSHWICK HEATING & COOLING,cpd11-20bk.pdf
LBC15FLRF,Flatlands Envelope Rehabilitation,850,DEPT OF DESIGN & CONSTRUCTION,ESSENTIAL RECONSTRUCTION OF FACILITIES,318,BROOKLYN,LB-D104 LB-0104,750,522,1773,0,0,0,0,0,2295,522,1773,0,0,0,0,0,2295,1044,3546,0,0,0,0,0,4590,PROJECT DELAYED DUE TO CHANGES IN SCOPE/DESIGN,,FLATLANDS ENVELOPE REHABILITATION,cpd11-20bk.pdf
LBC16MD2F,MIDWOOD 2ND FLOOR RENOVATIONS,850,DEPT OF DESIGN & CONSTRUCTION,ESSENTIAL RECONSTRUCTION OF FACILITIES,314,BROOKLYN,LB-D104 LB-0104,1030,1273,0,0,0,1052,5645,0,7970,1273,0,0,0,1052,5645,0,7970,2546,0,0,0,2104,11290,0,15940,PROJECT DELAYED DUE TO CHANGES IN SCOPE/DESIGN,,MIDWOOD 2ND FLOOR RENOVATION,cpd11-20bk.pdf
LBC16MPHC,MAPLETON HVAC REPLACEMENT,850,DEPT OF DESIGN & CONSTRUCTION,ESSENTIAL RECONSTRUCTION OF FACILITIES,312,BROOKLYN,LB-D104 LB-0104,750,489,0,2821,0,0,0,0,3310,489,0,2821,0,0,0,0,3310,978,0,5642,0,0,0,0,6620,PROJECT DELAYED DUE TO CHANGES IN SCOPE/DESIGN,,MAPLETON HVAC REPLACEMENT,cpd11-20bk.pdf
LBC17CDOP,CLARENDON OUTDOOR PLAZA,850,DEPT OF DESIGN & CONSTRUCTION,ESSENTIAL RECONSTRUCTION OF FACILITIES,317,BROOKLYN,LB-D104 LB-0104,218,269,0,708,0,0,0,0,977,269,0,708,0,0,0,0,977,538,0,1416,0,0,0,0,1954,,,CLARENDON OUTDOOR PLAZA,cpd11-20bk.pdf
LBC17MPGD,MAPLETON GARDEN RENOVATION,850,DEPT OF DESIGN & CONSTRUCTION,ESSENTIAL RECONSTRUCTION OF FACILITIES,312,BROOKLYN,LB-D104,1000,161,21,767,0,0,0,0,949,161,21,767,0,0,0,0,949,322,42,1534,0,0,0,0,1898,PROJECT DELAYED DUE TO CHANGES IN SCOPE/DESIGN,,MAPLETON GARDEN RENOVATION,cpd11-20bk.pdf
LBC17MRAD,MARCY AUDITORIUM REHABILITATION,850,DEPT OF DESIGN & CONSTRUCTION,ESSENTIAL RECONSTRUCTION OF FACILITIES,303,BROOKLYN,LB-D104 LB-0104,422,120,419,0,0,0,0,0,539,120,419,0,0,0,0,0,539,240,838,0,0,0,0,0,1078,PROJECT DELAYED DUE TO BUDGETARY CONSTRAINTS,,MARCY AUDITORIUM REHABILITATION,cpd11-20bk.pdf
LBC17PCFS,PACIFIC LIFE & FIRE SAFETY,850,DEPT OF DESIGN & CONSTRUCTION,ESSENTIAL RECONSTRUCTION OF FACILITIES,306,BROOKLYN,LB-D104 LB-0104,638,602,0,0,331,0,0,0,933,602,0,0,331,0,0,0,933,1204,0,0,662,0,0,0,1866,PROJECT DELAYED DUE TO CHANGES IN SCOPE/DESIGN,,PACIFIC LIFE & FIRE SAFETY,cpd11-20bk.pdf
LBCA06SPK,SUNSET PARK - Partial Interior Renovation,850,DEPT OF DESIGN & CONSTRUCTION,ESSENTIAL RECONSTRUCTION OF FACILITIES,301,BROOKLYN,LB-D104,1435,579,0,0,0,329,0,0,908,579,0,0,0,329,0,0,908,1158,0,0,0,658,0,0,1816,PROJECT DELAYED DUE TO CHANGES IN SCOPE/DESIGN,,INTERIOR MODIFICATIONS,cpd11-20bk.pdf
LBCA07FBH,FLATBUSH - Roof and Boiler Replacement,850,DEPT OF DESIGN & CONSTRUCTION,ESSENTIAL RECONSTRUCTION OF FACILITIES,314,BROOKLYN,LB-0104,800,1867,0,249,0,0,0,0,2116,1867,0,249,0,0,0,0,2116,3734,0,498,0,0,0,0,4232,PROJECT DELAYED DUE TO BUDGETARY CONSTRAINTS,,NEW ROOF AND BOILER,cpd11-20bk.pdf
LBK13EFBR,EAST FLATBUSH - BRANCH RENOVATION,850,DEPT OF DESIGN & CONSTRUCTION,RECONSTRUCTION NECESSARY TO MAINTAIN FACILITIES,,BROOKLYN,LB-0104,3325,12772,269,0,0,0,29,0,13070,12772,269,0,0,0,29,0,13070,25544,538,0,0,0,58,0,26140,PROJECT DELAYED DUE TO BUDGETARY CONSTRAINTS,,EAST FLATBUSH TECHNOLOGY CENTER,cpd11-20bk.pdf
LBK15BDHC,BEDFORD HEATING & COOLING REPLACEMENT,850,DEPT OF DESIGN & CONSTRUCTION,ESSENTIAL RECONSTRUCTION OF FACILITIES,303,BROOKLYN,LB-K001 LB-D104 LB-0104,1070,796,2771,0,0,0,0,0,3567,796,2771,0,0,0,0,0,3567,1592,5542,0,0,0,0,0,7134,PROJECT DELAYED DUE TO CHANGES IN SCOPE/DESIGN,,HEATING AND COOLING,cpd11-20bk.pdf
LBK15BRRF,BAY RIDGE ENVELOPE REHAB,850,DEPT OF DESIGN & CONSTRUCTION,ESSENTIAL RECONSTRUCTION OF FACILITIES,310,BROOKLYN,LB-K001 LB-D104 LB-0104,930,1117,0,249,0,0,0,0,1366,1117,0,249,0,0,0,0,1366,2234,0,498,0,0,0,0,2732,PROJECT DELAYED DUE TO CHANGES IN SCOPE/DESIGN,,BAY RIDGE ENVELOPE REHAB,cpd11-20bk.pdf
LBK15WTHC,WINDSOR TERRACE HEATING & COOLING REPLACEMENT,850,DEPT OF DESIGN & CONSTRUCTION,ESSENTIAL RECONSTRUCTION OF FACILITIES,307,BROOKLYN,LB-K001 LB-0104,750,3248,717,0,0,0,0,0,3965,3248,717,0,0,0,0,0,3965,6496,1434,0,0,0,0,0,7930,PROJECT DELAYED DUE TO CHANGES IN SCOPE/DESIGN,,WINDSOR TERRACE HEATING & COOLING REPLACEMENT,cpd11-20bk.pdf
LBK16CIBR,Coney Island - 2nd Floor Renovation,850,DEPT OF DESIGN & CONSTRUCTION,ESSENTIAL RECONSTRUCTION OF FACILITIES,313,BROOKLYN,LB-D104 LB-0104,1070,1701,0,0,0,83,0,467,2251,1701,0,0,0,83,0,467,2251,3402,0,0,0,166,0,934,4502,PROJECT DELAYED DUE TO CHANGES IN SCOPE/DESIGN,,BRANCH RENO,cpd11-20bk.pdf
LBK16STRF,SARATOGA ENVELOPE REHABILITATION,850,DEPT OF DESIGN & CONSTRUCTION,ESSENTIAL RECONSTRUCTION OF FACILITIES,316,BROOKLYN,LB-K001 LB-D104 LB-0104,1260,494,0,996,0,0,0,0,1490,494,0,996,0,0,0,0,1490,988,0,1992,0,0,0,0,2980,,,SARATOGA ROOF REPLACEMENT,cpd11-20bk.pdf
LBKA05RUG,Rugby - Branch Renovation,850,DEPT OF DESIGN & CONSTRUCTION,ESSENTIAL RECONSTRUCTION OF FACILITIES,317,BROOKLYN,LB-D001 LB-0104 LB-D104,1140,11359,2974,0,0,582,0,0,14915,11359,2974,0,0,582,0,0,14915,22718,5948,0,0,1164,0,0,29830,PROJECT DELAYED DUE TO BUDGETARY CONSTRAINTS,,PARTIAL INTERIOR /PUBLIC SERVICE ENHANCEMENTS,cpd11-20bk.pdf
LBM08WBRF,WILLIAMSBURG - Roof Replacment,850,DEPT OF DESIGN & CONSTRUCTION,ESSENTIAL RECONSTRUCTION OF FACILITIES,301,BROOKLYN,LB-0104,1114,1308,0,362,0,0,0,0,1670,1308,0,362,0,0,0,0,1670,2616,0,724,0,0,0,0,3340,PROJECT DELAYED DUE TO CHANGES IN SCOPE/DESIGN,,ROOF REPLACEMENT AT WILLIAMSBURG,cpd11-20bk.pdf
LBM13CGHC,CARROLL GARDENS HVAC REPLACEMENT,850,DEPT OF DESIGN & CONSTRUCTION,ESSENTIAL RECONSTRUCTION OF FACILITIES,306,BROOKLYN,LB-0104 LB-D104,1105,1019,0,3028,0,0,0,0,4047,1019,0,3028,0,0,0,0,4047,2038,0,6056,0,0,0,0,8094,PROJECT DELAYED DUE TO CHANGES IN SCOPE/DESIGN,,CARROLL GARDENS HVAC REPLACEMENT,cpd11-20bk.pdf
LBM13FLHC,"FLATLANDS BOILER , HVAC, BMS, FIRE SAFETY REPLACEMENT",850,DEPT OF DESIGN & CONSTRUCTION,ESSENTIAL RECONSTRUCTION OF FACILITIES,318,BROOKLYN,LB-D104,1942,508,0,0,52,0,0,0,560,508,0,0,52,0,0,0,560,1016,0,0,104,0,0,0,1120,PROJECT DELAYED DUE TO CHANGES IN SCOPE/DESIGN,,FLATLANDS BOILER REPLACEMENT,cpd11-20bk.pdf
LBM13LDHC,LEONARD HVAC REPLACEMENT,850,DEPT OF DESIGN & CONSTRUCTION,ESSENTIAL RECONSTRUCTION OF FACILITIES,301,BROOKLYN,LB-0104 LB-D104,965,782,0,2283,0,0,0,0,3065,782,0,2283,0,0,0,0,3065,1564,0,4566,0,0,0,0,6130,PROJECT DELAYED DUE TO CHANGES IN SCOPE/DESIGN,,LEONARD HVAC REPLACEMENT,cpd11-20bk.pdf
LBM14BWRF,BUSHWICK ROOF REPLACEMENT,850,DEPT OF DESIGN & CONSTRUCTION,ESSENTIAL RECONSTRUCTION OF FACILITIES,301,BROOKLYN,LB-0104 LB-D104,1072,324,0,1116,0,0,0,0,1440,324,0,1116,0,0,0,0,1440,648,0,2232,0,0,0,0,2880,PROJECT DELAYED DUE TO CHANGES IN SCOPE/DESIGN,,BUSHWICK ROOF REPLACEMENT,cpd11-20bk.pdf
LBM14WTRF,WINDSOR TERRACE ROOF REPLACEMENT,850,DEPT OF DESIGN & CONSTRUCTION,ESSENTIAL RECONSTRUCTION OF FACILITIES,307,BROOKLYN,WP-0169,932,1046,0,65,0,0,0,0,1111,1046,0,65,0,0,0,0,1111,2092,0,130,0,0,0,0,2222,PROJECT DELAYED DUE TO CHANGES IN SCOPE/DESIGN,,WINDSOR TERRACE ROOF REPLACEMENT,cpd11-20bk.pdf
LBM14WWRF,WALT WHITMAN ROOF REPLACEMENT,850,DEPT OF DESIGN & CONSTRUCTION,ESSENTIAL RECONSTRUCTION OF FACILITIES,302,BROOKLYN,LB-0104,1077,1396,0,0,0,412,0,0,1808,1396,0,0,0,412,0,0,1808,2792,0,0,0,824,0,0,3616,PROJECT DELAYED DUE TO CHANGES IN SCOPE/DESIGN,,WALT WHITMAN ROOF REPLACEMENT,cpd11-20bk.pdf
LBM15GBRF,GERRITSEN BEACH ENVELOPE REHAB,850,DEPT OF DESIGN & CONSTRUCTION,ESSENTIAL RECONSTRUCTION OF FACILITIES,315,BROOKLYN,LB-0104,827,371,0,1256,0,0,0,0,1627,371,0,1256,0,0,0,0,1627,742,0,2512,0,0,0,0,3254,PROJECT DELAYED DUE TO CHANGES IN SCOPE/DESIGN,,BUILDING ENVELOPE REHAB,cpd11-20bk.pdf
LBM15MPRF,Mapleton Envelope Rehabilitation,850,DEPT OF DESIGN & CONSTRUCTION,ESSENTIAL RECONSTRUCTION OF FACILITIES,312,BROOKLYN,LB-0104 LB-D104,870,525,0,2878,0,0,0,0,3403,525,0,2878,0,0,0,0,3403,1050,0,5756,0,0,0,0,6806,PROJECT DELAYED DUE TO CHANGES IN SCOPE/DESIGN,,MAPLETON ENVELOPE REHABILITATION,cpd11-20bk.pdf
LBM15RDHC,Ryder Heating & Cooling,850,DEPT OF DESIGN & CONSTRUCTION,ESSENTIAL RECONSTRUCTION OF FACILITIES,312,BROOKLYN,LB-0104 LB-D104,827,581,0,2562,0,0,0,0,3143,581,0,2562,0,0,0,0,3143,1162,0,5124,0,0,0,0,6286,PROJECT DELAYED DUE TO CHANGES IN SCOPE/DESIGN,,RYDER HEATING & COOLING,cpd11-20bk.pdf
LBM15RDRF,Ryder Envelope Rehabilitation,850,DEPT OF DESIGN & CONSTRUCTION,ESSENTIAL RECONSTRUCTION OF FACILITIES,312,BROOKLYN,LB-0104 LB-D104,873,336,0,1578,0,0,0,0,1914,336,0,1578,0,0,0,0,1914,672,0,3156,0,0,0,0,3828,PROJECT DELAYED DUE TO CHANGES IN SCOPE/DESIGN,,RYDER ENVELOPE REHABILITATION,cpd11-20bk.pdf
LBM16GSFC,GRAVESEND FACADE REHAB,850,DEPT OF DESIGN & CONSTRUCTION,ESSENTIAL RECONSTRUCTION OF FACILITIES,315,BROOKLYN,LB-D104 LB-0104,637,393,0,250,0,0,1330,0,1973,393,0,250,0,0,1330,0,1973,786,0,500,0,0,2660,0,3946,PROJECT DELAYED DUE TO CHANGES IN SCOPE/DESIGN,,GRAVESEND FACADE REHAB,cpd11-20bk.pdf
LBM17ARBR,ARLINGTON BRANCH RENOVATION,850,DEPT OF DESIGN & CONSTRUCTION,ESSENTIAL RECONSTRUCTION OF FACILITIES,305,BROOKLYN,LB-0104 LB-D104,9175,1321,0,99,7106,0,0,0,8526,1321,0,99,7106,0,0,0,8526,2642,0,198,14212,0,0,0,17052,,,ARLINGTON BRANCH RENOVATION,cpd11-20bk.pdf
LBM17NUOH,NEW UTRECHT BRANCH OVERHAUL,850,DEPT OF DESIGN & CONSTRUCTION,ESSENTIAL RECONSTRUCTION OF FACILITIES,311,BROOKLYN,LB-0104 LB-D104,26333,780,0,1965,22008,0,0,0,24753,780,0,1965,22008,0,0,0,24753,1560,0,3930,44016,0,0,0,49506,,,NEW UTRECHT BRANCH OVERHAUL,cpd11-20bk.pdf
LBM18BVOH,BROWNSVILLE BRANCH OVERHAUL,850,DEPT OF DESIGN & CONSTRUCTION,ESSENTIAL RECONSTRUCTION OF FACILITIES,316,BROOKLYN,LB-0104 LB-D104,23742,2883,0,721,19742,0,0,0,23346,2883,0,721,19742,0,0,0,23346,5766,0,1442,39484,0,0,0,46692,,,BROWNSVILLE BRANCH OVERHAUL,cpd11-20bk.pdf
LBM18EPOH,EASTERN PARKWAY BRANCH OVERHAUL,850,DEPT OF DESIGN & CONSTRUCTION,ESSENTIAL RECONSTRUCTION OF FACILITIES,309,BROOKLYN,LB-0104 LB-D104,22000,2636,0,1740,0,17000,0,0,21376,2636,0,1740,0,17000,0,0,21376,5272,0,3480,0,34000,0,0,42752,PROJECT DELAYED DUE TO BUDGETARY CONSTRAINTS,,EASTERN PARKWAY BRANCH OVERHAUL,cpd11-20bk.pdf
LBP18WIBR,WASHINGTON IRVING BRANCH RENOVATION,850,DEPT OF DESIGN & CONSTRUCTION,ESSENTIAL RECONSTRUCTION OF FACILITIES,304,BROOKLYN,LB-0101 LB-D104 LB-0108,10753,30,0,1987,0,494,7540,0,10051,30,0,1987,0,494,7540,0,10051,60,0,3974,0,988,15080,0,20102,,,WASHINGTON IRVING BRANCH RENOVATION,cpd11-20bk.pdf
LBP18WWBR,WALT WHITMAN BRANCH RENOVATION,850,DEPT OF DESIGN & CONSTRUCTION,ESSENTIAL RECONSTRUCTION OF FACILITIES,302,BROOKLYN,LB-0101 LB-0108 LB-D104,7470,33,0,625,0,6375,0,0,7033,33,0,625,0,6375,0,0,7033,66,0,1250,0,12750,0,0,14066,,,WALT WHITMAN BRANCH RENOVATION,cpd11-20bk.pdf
NC-61,NEWTOWN CREEK NATURE WALK PHASE 2,850,DEPT OF DESIGN & CONSTRUCTION,CONSENT DECREE UPGRADING AND CONSTRUCTION,300,BROOKLYN,WP-0283,18700,13344,408,0,0,0,0,0,13752,13344,408,0,0,0,0,0,13752,26688,816,0,0,0,0,0,27504,PROJECT DELAYED DUE TO UNFORESEEN SITE/FIELD CONDITION,,PHASE 2 REQUIRES DRIVING DRIVING PILES TO SUPPORT THE WALK OVER THE WATER IN WHALE,cpd11-20bk.pdf
NC-61A,NEWTON CREEK NATURE WALK - PHSE 3,850,DEPT OF DESIGN & CONSTRUCTION,CONSENT DECREE UPGRADING AND CONSTRUCTION,300,BROOKLYN,WP-0283,10810,12739,852,0,0,0,0,0,13591,12739,852,0,0,0,0,0,13591,25478,1704,0,0,0,0,0,27182,PROJECT DELAYED DUE TO UNFORESEEN SITE/FIELD CONDITION,NEWTON CREEK NATURE WALK,CONSTRUCTION OF NEWTON CREEK NATURE WALK,cpd11-20bk.pdf
NDF-ATLBB,NDF - Atlantic Avenue Broadband Conduit (HWD10105),850,DEPT OF DESIGN & CONSTRUCTION,NEIGHBORHOOD REVITALIZATION,300,BROOKLYN,ED-0384,1700,0,1700,0,0,0,0,0,1700,0,1700,0,0,0,0,0,1700,0,3400,0,0,0,0,0,3400,PROJECT DELAYED DUE TO CHANGES IN SCOPE/DESIGN,,NDF - ATLANTIC AVENUE BROADBAND CONDUIT,cpd11-20bk.pdf
NDF-IBZ,NDF - ENY IBZ Improvements,850,DEPT OF DESIGN & CONSTRUCTION,NEIGHBORHOOD REVITALIZATION,300,BROOKLYN,ED-0384,8200,1439,0,33,7197,0,0,0,8669,1439,0,33,7197,0,0,0,8669,2878,0,66,14394,0,0,0,17338,PROJECT DELAYED DUE TO CHANGES IN SCOPE/DESIGN,,IBZ STREET IMPROVEMENTS AND BROADBAND SERVICE,cpd11-20bk.pdf
P-213CNTR,Asser Levy Park Reconstruction,850,DEPT OF DESIGN & CONSTRUCTION,"LARGE, MAJOR AND REGIONAL PARK RECONSTRUCTION",313,BROOKLYN,P-K707 ED-0075,34711,5077,0,0,0,0,5822,0,10899,5077,0,0,0,0,5822,0,10899,10154,0,0,0,0,11644,0,21798,PROJECT DELAYED PENDING RESOLUTION OF LEGAL ISSUES,CONEY ISLAND CENTER (BROOKLYN),CONEY ISLAND CENTER,cpd11-20bk.pdf
P-2CIB1HQ,Coney Island Beach Operations HQ at West 25th Street,850,DEPT OF DESIGN & CONSTRUCTION,BEACHES AND BOARDWALKS,300,BROOKLYN,P-0704,56807,200,4805,3350,0,39184,0,0,47539,200,4805,3350,0,39184,0,0,47539,400,9610,6700,0,78368,0,0,95078,,,CONEY ISLAND BEACH OPERATIONS HQ AT WEST 25TH STREET,cpd11-20bk.pdf
PO79-77AX,77TH PRECINCT ANNEX RENOVATION,850,DEPT OF DESIGN & CONSTRUCTION,POLICE FACILITIES,300 308,BROOKLYN,PO-0079,800,1679,50,0,0,0,0,0,1729,1679,50,0,0,0,0,0,1729,3358,100,0,0,0,0,0,3458,PROJECT DELAYED DUE TO UNFORESEEN SITE/FIELD CONDITION,,77 ANNEX RENOVATION,cpd11-20bk.pdf
PO79-77FA,77TH PRECINCT FIRE ALARM SYSTEM,850,DEPT OF DESIGN & CONSTRUCTION,POLICE FACILITIES,300 308,BROOKLYN,PO-0079,835,481,1596,0,0,0,0,0,2077,481,1596,0,0,0,0,0,2077,962,3192,0,0,0,0,0,4154,PROJECT DELAYED DUE TO BUDGETARY CONSTRAINTS,,77TH PRECINCT FIRE ALARM SYSTEM,cpd11-20bk.pdf
PO79SHOPR,SERVICE SHOP #6 ROOF RENOVATION,850,DEPT OF DESIGN & CONSTRUCTION,POLICE FACILITIES,300,BROOKLYN,PO-0079,4727,570,384,8089,0,0,0,0,9043,570,384,8089,0,0,0,0,9043,1140,768,16178,0,0,0,0,18086,PROJECT DELAYED DUE TO UNFORESEEN SITE/FIELD CONDITION,SERVICE SHOP #3 AND # 6,SHOP # 3 AND # 6 ROOF RENOVATIONS,cpd11-20bk.pdf
PV235BDEV,BMA - Brooklyn Museum - Building Envelope Renovation,850,DEPT OF DESIGN & CONSTRUCTION,ESSENTIAL RECONSTRUCTION OF FACILITIES,309,BROOKLYN,PV-0235 PV-K235 PV-D235,8600,0,0,5350,3555,0,0,0,8905,0,0,5350,3555,0,0,0,8905,0,0,10700,7110,0,0,0,17810,,,BMA - BROOKLYN MUSEUM - BUILDING ENVELOPE REHAB,cpd11-20bk.pdf
PV236SGD2,BBG - Brooklyn Botanic Garden - South Garden Dev. Phase 2,850,DEPT OF DESIGN & CONSTRUCTION,ESSENTIAL RECONSTRUCTION OF FACILITIES,,BROOKLYN,PV-0236 PV-K236,6050,5964,0,0,0,0,0,50,6014,5964,0,0,0,0,0,50,6014,11928,0,0,0,0,0,100,12028,PROJECT DELAYED PENDING RESOLUTION OF LEGAL ISSUES,,BBG WATER GARDEN LANDSCAPING AND EARTHWORK,cpd11-20bk.pdf
PV262-AUD,Brooklyn Children's Museum Auditorium,850,DEPT OF DESIGN & CONSTRUCTION,ESSENTIAL RECONSTRUCTION OF FACILITIES,308,BROOKLYN,PV-0262 PV-D262,1000,8255,1312,0,0,0,0,0,9567,8255,1312,0,0,0,0,0,9567,16510,2624,0,0,0,0,0,19134,PROJECT DELAYED PENDING RESOLUTION OF LEGAL ISSUES,,MAIN AUDITORIUM FITOUT.,cpd11-20bk.pdf
PV262-RTW,BCM - Brooklyn Children's Museum Retaining Wall,850,DEPT OF DESIGN & CONSTRUCTION,ESSENTIAL RECONSTRUCTION OF FACILITIES,308,BROOKLYN,PV-K262 PV-D262 PV-0262 PV-0467,5856,1254,2616,6318,0,0,0,0,10188,1254,2616,6318,0,0,0,0,10188,2508,5232,12636,0,0,0,0,20376,,,BROOKLYN CHILDREN'S MUSEUM,cpd11-20bk.pdf
PW322X7,345 ADAMS ST. - LL 11 CYCLE 7 FACADE REPAIRS,850,DEPT OF DESIGN & CONSTRUCTION,REHABILITATION OF CITY-OWNED OFFICE SPACE,302,BROOKLYN,PW-0322,1089,0,0,0,0,1189,0,0,1189,0,0,0,0,1189,0,0,1189,0,0,0,0,2378,0,0,2378,PROJECT DELAYED DUE TO BUDGETARY CONSTRAINTS,,FACADE REPAIRS AS PER LL 11/98 INSPECTIONS FOR 345 ADAMS STREET,cpd11-20bk.pdf
PW77DCA,245 MESEROLE ST. - DCA TEST STATION REHABILITATION,850,DEPT OF DESIGN & CONSTRUCTION,REHABILITATION OF CITY-OWNED OFFICE SPACE,301,BROOKLYN,PU-0025 PW-0077,249,4268,366,10,0,0,0,0,4644,4268,366,10,0,0,0,0,4644,8536,732,20,0,0,0,0,9288,PROJECT DELAYED DUE TO CHANGES IN SCOPE/DESIGN,,REHABILITATION OF CRITICAL LIFE AND SAFETY SYSTEMS,cpd11-20bk.pdf
PW77DCA2,245 MESEROLE ST. - DCA STORM SEWER REHAB,850,DEPT OF DESIGN & CONSTRUCTION,REHABILITATION OF CITY-OWNED OFFICE SPACE,301,BROOKLYN,PW-0077,1164,1587,131,0,0,0,0,0,1718,1587,131,0,0,0,0,0,1718,3174,262,0,0,0,0,0,3436,PROJECT DELAYED DUE TO UNFORESEEN SITE/FIELD CONDITION,,STORM SEWER UPGRADE,cpd11-20bk.pdf
PW77GOWAN,GOWANUS CANAL 1 ST TURNING BASIN,850,DEPT OF DESIGN & CONSTRUCTION,MISCELLANEOUS CONSTRUCTION,306,BROOKLYN,PW-0077,4800,3856,0,444,0,0,0,0,4300,3856,0,444,0,0,0,0,4300,7712,0,888,0,0,0,0,8600,PROJECT DELAYED DUE TO UNFORESEEN SITE/FIELD CONDITION,,GOWANUS CANAL 1ST STREET TURNING BASIN ENVIRONMENTAL REMEDIATION DESIGN,cpd11-20bk.pdf
PW77OEMS2,165 CADMAN PLAZA - CATWALK 3RD FLOOR,850,DEPT OF DESIGN & CONSTRUCTION,REHABILITATION OF CITY-OWNED OFFICE SPACE,301,BROOKLYN,PW-0077,196,0,0,587,0,0,0,0,587,0,0,587,0,0,0,0,587,0,0,1174,0,0,0,0,1174,PROJECT DELAYED DUE TO BUDGETARY CONSTRAINTS,,165 CADMAN PLAZA - CATWALK 3RD FLOOR,cpd11-20bk.pdf
PWD308JCI,JCC OF GREATER CONEY ISLAND,850,DEPT OF DESIGN & CONSTRUCTION,RENOVATION OF OTHER CITY-OWNED FACILITIES,313,BROOKLYN,PW-D308,1635,126,0,0,0,1060,0,0,1186,126,0,0,0,1060,0,0,1186,252,0,0,0,2120,0,0,2372,PROJECT DELAYED DUE TO BUDGETARY CONSTRAINTS,"RESCIND $414,207 IN 8/12.",JCC CONEY ISLAND,cpd11-20bk.pdf
PWKBEFORD,BEDFORD ATLANTIC ARMORY - NENOVATIONS BEDFORD ATLANTIC ARMOR,850,DEPT OF DESIGN & CONSTRUCTION,MISCELLANEOUS CONSTRUCTION,,BROOKLYN,PW-K077,1060,180,0,0,0,0,0,1975,2155,180,0,0,0,0,0,1975,2155,360,0,0,0,0,0,3950,4310,PROJECT DELAYED DUE TO CHANGES IN SCOPE/DESIGN,,RENOVATIONS OF BEDFORD ATLANTIC ARMORY DRILL SHED AND OTHER SPACES INTO A,cpd11-20bk.pdf
REMPIV,Remsen Yard Reconstruction Phase IV,850,DEPT OF DESIGN & CONSTRUCTION,FACILITY PURCHASES AND RECONSTRUCTION,318,BROOKLYN,EP-0006,1300,0,2932,0,0,0,0,0,2932,0,2932,0,0,0,0,0,2932,0,5864,0,0,0,0,0,5864,,,REMSEN YARD RECONSTRUCTION PHASE 4,cpd11-20bk.pdf
S136-383N,Brooklyn 17/18 HVAC and Roof Replacement,850,DEPT OF DESIGN & CONSTRUCTION,GARAGES AND FACILITIES,317 318,BROOKLYN,S-0136,7500,3245,0,24895,0,0,0,0,28140,3245,0,24895,0,0,0,0,28140,6490,0,49790,0,0,0,0,56280,PROJECT DELAYED DUE TO UNFORESEEN SITE/FIELD CONDITION,,REPLACE ROOF TOP HVAC INCLUDING INSTALLATION OF BUILDING MAINTENCE SYSTEM AND FIRE,cpd11-20bk.pdf
S136-436,Brooklyn 6 Garage Rehabilitation,850,DEPT OF DESIGN & CONSTRUCTION,GARAGES AND FACILITIES,306,BROOKLYN,S-0136,100,2693,700,13731,0,0,0,0,17124,2693,700,13731,0,0,0,0,17124,5386,1400,27462,0,0,0,0,34248,,,REHAB,cpd11-20bk.pdf
SAND1048,BWG - Sunset Park North,850,DEPT OF DESIGN & CONSTRUCTION,PRIMARY STREET RECONSTRUCTION,300,BROOKLYN,HW-0001K HW-0200 HW-0944 TF-0002 TF-0502,5795,146,0,9961,0,0,0,0,10107,146,0,9961,0,0,0,0,10107,292,0,19922,0,0,0,0,20214,,BWG - IMPROVED PROJECT,BWG - IMPROVED PROJECT,cpd11-20bk.pdf
SANDBRIGH,SANDY - NEW BRIGHTON COMFORT STATION RECONSTRUCTION,850,DEPT OF DESIGN & CONSTRUCTION,MAJOR RECREATIONAL FACILITIES AND FACILITY RECONSTRUCTION,300,BROOKLYN,P-1018,5453,719,2,0,0,0,0,1276,1997,719,2,0,0,0,0,1276,1997,1438,4,0,0,0,0,2552,3994,PROJECT DELAYED DUE TO UNFORESEEN SITE/FIELD CONDITION,,NEW BRIGHTON COMFORT STATION RECONSTRUCTION,cpd11-20bk.pdf
SANDELEC4,60TH PRECINCT ELECTRICAL SYSTEM REPLACEMENT( SANDY),850,DEPT OF DESIGN & CONSTRUCTION,POLICE FACILITIES,313,BROOKLYN,PO-0079,4409,1164,308,0,0,0,0,0,1472,1164,308,0,0,0,0,0,1472,2328,616,0,0,0,0,0,2944,PROJECT DELAYED DUE TO CHANGES IN SCOPE/DESIGN,,60TH PRECINCT ELECTRICAL SYSTEM REPLACEMENT( SANDY),cpd11-20bk.pdf
SANDELEC7,AVIATION ELECTRICAL (SANDY),850,DEPT OF DESIGN & CONSTRUCTION,POLICE FACILITIES,300,BROOKLYN,PO-0079,1005,770,0,0,0,0,0,0,770,770,0,0,0,0,0,0,770,1540,0,0,0,0,0,0,1540,PROJECT DELAYED DUE TO UNFORESEEN SITE/FIELD CONDITION,,ELECTRICAL SYSTEM REPLACEMENT,cpd11-20bk.pdf
SANDELEC8,ERIE BASIN TOW POUND ELECTRICAL (SANDY),850,DEPT OF DESIGN & CONSTRUCTION,POLICE FACILITIES,300 306,BROOKLYN,PO-0079,1990,36,21,157,0,0,0,0,214,36,21,157,0,0,0,0,214,72,42,314,0,0,0,0,428,PROJECT DELAYED DUE TO UNFORESEEN SITE/FIELD CONDITION,,ELECTRICAL SYSTEM REPLACEMENT,cpd11-20bk.pdf
SANDHW19,Reconstruction of Downtown Brooklyn - Hurricane Sandy,850,DEPT OF DESIGN & CONSTRUCTION,PRIMARY STREET RECONSTRUCTION,300,BROOKLYN,HW-0001K,1607,5,0,0,0,0,0,126,131,5,0,0,0,0,0,126,131,10,0,0,0,0,0,252,262,PROJECT DELAYED DUE TO BUDGETARY CONSTRAINTS,RECONSTRUCTION OF DOWNTOWN BROOKLYN - HURRICANE SANDY,RECONSTRUCTION OF DOWNTOWN BROOKLYN - HURRICANE SANDY,cpd11-20bk.pdf
SANDR03,Jamaica Bay Greenway - Canarsie Pier Connector,850,DEPT OF DESIGN & CONSTRUCTION,PRIMARY STREET RECONSTRUCTION,300,BROOKLYN,HW-0001K,2000,811,1440,0,0,0,0,0,2251,811,1440,0,0,0,0,0,2251,1622,2880,0,0,0,0,0,4502,,CANARSIE PIER,CANARSIE PIER ACCESS IMPROVEMENTS,cpd11-20bk.pdf
SANDRDHK,Red Hook HMGP,850,DEPT OF DESIGN & CONSTRUCTION,MISCELLANEOUS,300,BROOKLYN,PU-0100,100000,0,0,0,50000,0,0,0,50000,0,0,0,50000,0,0,0,50000,0,0,0,100000,0,0,0,100000,PROJECT DELAYED DUE TO CHANGES IN SCOPE/DESIGN,,RED HOOK HMGP PROJECT,cpd11-20bk.pdf
SE-851,"HLSS , STRM, SAN & COMB SWERS & WM IN FRESH CREEK BASIN AREA",850,DEPT OF DESIGN & CONSTRUCTION,PROGRAMMATIC RESPONSE TO REGULATORY MANDATES,318,BROOKLYN,SE-0004,32855,67054,423,0,0,0,0,0,67477,67054,423,0,0,0,0,0,67477,134108,846,0,0,0,0,0,134954,PROJECT DELAYED DUE TO UNFORESEEN SITE/FIELD CONDITION,,"HLSS , STRM, SAN & COMB SWERS & WM IN FRESH CREEK BASIN AREA",cpd11-20bk.pdf
SE-853,"HLSS, Strm, San & Comb Swrs, & WM Fresh Creek Basin, Ph 2A",850,DEPT OF DESIGN & CONSTRUCTION,PROGRAMMATIC RESPONSE TO REGULATORY MANDATES,318 305,BROOKLYN,SE-0002K SE-0004,16356,52128,3063,2456,1456,0,0,0,59103,52128,3063,2456,1456,0,0,0,59103,104256,6126,4912,2912,0,0,0,118206,,,"HLSS , STRM, SAN & COMB SWERS & WM IN FRESH CREEK BASIN AREA",cpd11-20bk.pdf
SE-855,"HLSS, Strm, San & Comb Swrs, & WM Fresh Creek Basin, Ph 2B",850,DEPT OF DESIGN & CONSTRUCTION,PROGRAMMATIC RESPONSE TO REGULATORY MANDATES,318 305,BROOKLYN,SE-0004 SE-0002K WM-0001 SE-0200K HW-0200,46639,45345,3591,626,0,0,0,0,49562,45345,3591,626,0,0,0,0,49562,90690,7182,1252,0,0,0,0,99124,PROJECT DELAYED DUE TO UNFORESEEN SITE/FIELD CONDITION,,"HLSS , STRM, SAN & COMB SWERS & WM IN FRESH CREEK BASIN AREA",cpd11-20bk.pdf
SE-856,"HLSS, Strm, San & Comb Swrs, & WM Fresh Creek Basin ,Ph 3A",850,DEPT OF DESIGN & CONSTRUCTION,PROGRAMMATIC RESPONSE TO REGULATORY MANDATES,305,BROOKLYN,SE-0004 SE-0200K SE-0002K WM-0001,19643,1732,3,21606,0,0,0,0,23341,1732,3,21606,0,0,0,0,23341,3464,6,43212,0,0,0,0,46682,,,(CS-FC-SEW) PHASE 3A,cpd11-20bk.pdf
SE-857,"HLSS, Strm, San & Comb Swrs, & WM Fresh Creek Basin ,Ph 3B",850,DEPT OF DESIGN & CONSTRUCTION,PROGRAMMATIC RESPONSE TO REGULATORY MANDATES,305 318,BROOKLYN,SE-0004 SE-0200K SE-0002K WM-0001,44952,1616,0,42970,0,0,0,0,44586,1616,0,42970,0,0,0,0,44586,3232,0,85940,0,0,0,0,89172,PROJECT DELAYED DUE TO UNFORESEEN SITE/FIELD CONDITION,(CS-FC-SEW) PHASE 3B,(CS-FC-SEW) PHASE 3B,cpd11-20bk.pdf
SE-858,"HLSS Installation, Combined Sewer Replmnt (HWK1048A)",850,DEPT OF DESIGN & CONSTRUCTION,REPLACEMENT OF CHRONICALLY FAILING COMPONENTS,301,BROOKLYN,SE-0004 SE-0002K WM-0001,18792,31606,1556,0,0,0,0,0,33162,31606,1556,0,0,0,0,0,33162,63212,3112,0,0,0,0,0,66324,PROJECT DELAYED DUE TO UNFORESEEN SITE/FIELD CONDITION,,"HIGH LEVEL STORM SEWER INSTALLATION, COMBINED SEWER REPLACEMENT AND WATER MAIN",cpd11-20bk.pdf
SEK002351,Rehab of Comb swrs &w/m in Wycoff Av bet Cooper &Flushing Av,850,DEPT OF DESIGN & CONSTRUCTION,REPLACEMENT OF CHRONICALLY FAILING COMPONENTS,304,BROOKLYN,SE-0002K WM-0001 EP-0007,6020,234,0,0,0,0,27652,0,27886,234,0,0,0,0,27652,0,27886,468,0,0,0,0,55304,0,55772,PROJECT DELAYED DUE TO CHANGES IN SCOPE/DESIGN,,REHAB OF COMB SWRS &W/M IN WYCOFF AV BET COOPER &FLUSHING AV,cpd11-20bk.pdf
SEK002354,SAN SWRS-GATEWAY ESTATES - PHASE D (HD-161D/SEK20057),850,DEPT OF DESIGN & CONSTRUCTION,EXTENSIONS TO ACCOMMODATE NEW DEVELOPMENT,305,BROOKLYN,SE-0002K,6300,15349,0,0,0,0,2120,0,17469,15349,0,0,0,0,2120,0,17469,30698,0,0,0,0,4240,0,34938,PROJECT DELAYED DUE TO UNFORESEEN SITE/FIELD CONDITION,SANITARY SEWERS IN GATEWAY ESTATES - PHASE D,SANITARY SEWERS IN GATEWAY ESTATES - PHASE D,cpd11-20bk.pdf
SEK002376,COMB SWR REPLCMNT & WM WORK IN PRESIDENT ST,850,DEPT OF DESIGN & CONSTRUCTION,TRUNK AND DISTRIBUTION MAIN REPLACEMENT,309,BROOKLYN,SE-0002K WM-0001,3824,300,0,3477,0,0,0,0,3777,300,0,3477,0,0,0,0,3777,600,0,6954,0,0,0,0,7554,PROJECT DELAYED DUE TO CHANGES IN SCOPE/DESIGN,,"COMB SWR REPLCMNT & WM WORK IN PRESIDENT ST, B/T KINGSTON AV & ALBANYAV",cpd11-20bk.pdf
SEK002377,Santy sewer & WM replmnt in E 72nd St btwn Ave L & Royce Pl,850,DEPT OF DESIGN & CONSTRUCTION,REPLACEMENT OR AUGMENTATION OF EXISTING SYSTEMS,318,BROOKLYN,SE-0002K WM-0001,2148,50,0,0,0,3680,0,0,3730,50,0,0,0,3680,0,0,3730,100,0,0,0,7360,0,0,7460,PROJECT DELAYED DUE TO UNFORESEEN SITE/FIELD CONDITION,,SANITARY SEWER & WM REPLACEMENT IN EAST 72ND STREET BETWEEN AVE L & ROYCE PLACE,cpd11-20bk.pdf
SEK002380,"Combined relief sewer & WM replac. at 7ST B/T 3 & 4 AV, BKL",850,DEPT OF DESIGN & CONSTRUCTION,REPLACEMENT OR AUGMENTATION OF EXISTING SYSTEMS,306,BROOKLYN,EP-0007 HW-0200 SE-1000 SE-0200K SE-0944 TF-0002 TF-0502 WM-0001,2946,3389,9093,0,0,0,0,0,12482,3389,9093,0,0,0,0,0,12482,6778,18186,0,0,0,0,0,24964,PROJECT DELAYED DUE TO BUDGETARY CONSTRAINTS,,COMBINED RELIEF SEWER & CHAMBERS & WATER MAIN REPLACEMENT AT 7TH STREET B/T 3 & 4,cpd11-20bk.pdf
SEK002383,Combined SE installation & WM replacement in Dean Street,850,DEPT OF DESIGN & CONSTRUCTION,REPLACEMENT OR AUGMENTATION OF EXISTING SYSTEMS,308,BROOKLYN,SE-0002K,11721,600,0,0,11721,0,0,0,12321,600,0,0,11721,0,0,0,12321,1200,0,0,23442,0,0,0,24642,PROJECT DELAYED DUE TO CHANGES IN SCOPE/DESIGN,,"COMBINED SEWER INSTALLATION & WATER MAIN REPLACEMENT IN DEAN STREET, BTW 6TH AVE &",cpd11-20bk.pdf
SEK002384,Combined SE rplcmt & dist WM install on Van Sinderen Ave BK,850,DEPT OF DESIGN & CONSTRUCTION,REPLACEMENT OR AUGMENTATION OF EXISTING SYSTEMS,305 316,BROOKLYN,SE-0002K WM-0001,13454,0,0,0,11959,0,0,0,11959,0,0,0,11959,0,0,0,11959,0,0,0,23918,0,0,0,23918,,,COMBINED SEWER REPLACEMENT AND DISTRIBUTION WATER MAIN INSTALLATION IN VAN SINDEREN,cpd11-20bk.pdf
SEK002386,"Replace combined sewer & WM work,Park Pl & Underhill Ave, BK",850,DEPT OF DESIGN & CONSTRUCTION,REPLACEMENT OR AUGMENTATION OF EXISTING SYSTEMS,308,BROOKLYN,EP-0007 SE-0002K SE-0944 WM-0001 WM-0006,8478,2833,8594,0,0,0,0,0,11427,2833,8594,0,0,0,0,0,11427,5666,17188,0,0,0,0,0,22854,PROJECT DELAYED DUE TO BUDGETARY CONSTRAINTS,,"REPLACEMENT OF COMBINED SEWER, BULKHEADING OF EXISTING SEWERS & WATERMAIN WORK,",cpd11-20bk.pdf
SEK20056,STORM SEWERS-GATEWAY ESTATES - PHASE C (HD-161C),850,DEPT OF DESIGN & CONSTRUCTION,EXTENSIONS TO ACCOMMODATE NEW DEVELOPMENT,305,BROOKLYN,SE-0200K SE-0002K WM-0001,4899,11739,1028,0,0,0,0,0,12767,11739,1028,0,0,0,0,0,12767,23478,2056,0,0,0,0,0,25534,PROJECT DELAYED DUE TO CHANGES IN SCOPE/DESIGN,STORM SEWERS IN GATEWAY ESTATES - PHASE C,STORM SEWERS IN GATEWAY ESTATES - PHASE C,cpd11-20bk.pdf
SEK20065,High level storm sewer Gowanus Canal Area,850,DEPT OF DESIGN & CONSTRUCTION,EXTENSIONS TO ACCOMMODATE NEW DEVELOPMENT,306,BROOKLYN,SE-0004,9400,34807,0,0,92,0,0,0,34899,34807,0,0,92,0,0,0,34899,69614,0,0,184,0,0,0,69798,PROJECT DELAYED DUE TO UNFORESEEN SITE/FIELD CONDITION,,DRAINAGE PLAN HIGH LEVEL STORM SEWER INSTALLATION AND WM-1 REPLACEMENT IN GOWANUS,cpd11-20bk.pdf
SEK20067,High level storm sewer Gowanus Canal Area. Phase 2.,850,DEPT OF DESIGN & CONSTRUCTION,EXTENSIONS TO ACCOMMODATE NEW DEVELOPMENT,306,BROOKLYN,SE-0004 SE-0944,9600,25976,2828,820,820,0,0,0,30444,25976,2828,820,820,0,0,0,30444,51952,5656,1640,1640,0,0,0,60888,PROJECT DELAYED DUE TO BUDGETARY CONSTRAINTS,,DRAINAGE PLAN HIGH LEVEL STORM SEWER INSTALLATION AND WM-1 REPLACEMENT IN GOWANUS,cpd11-20bk.pdf
SEK20070,Guniting & exterior repair of the 25th Ave outfall sewer,850,DEPT OF DESIGN & CONSTRUCTION,REPLACEMENT OR AUGMENTATION OF EXISTING SYSTEMS,311,BROOKLYN,SE-0200K,1013,2410,5532,0,0,0,0,0,7942,2410,5532,0,0,0,0,0,7942,4820,11064,0,0,0,0,0,15884,,,"GUNITING & EXTERIOR OUTFALL REPAIR OF THE 25TH AVE OUTFALL SEWER AT GRAVESEND BAY,",cpd11-20bk.pdf
SEK20076,Replace deficient combined sewers and WM in East 80 St,850,DEPT OF DESIGN & CONSTRUCTION,AUGMENTATION OF WATER SUPPLY SYSTEMS,300,BROOKLYN,SE-0002K WM-0001,5456,0,0,0,4847,0,0,0,4847,0,0,0,4847,0,0,0,4847,0,0,0,9694,0,0,0,9694,,,REPLACE DEFICIENT COMBINED SEWERS IN EAST 80TH STREET AND OTHER LOCATIONS. UPGRADE,cpd11-20bk.pdf
SEKBS8,"Reconstruction of Existing Sewers, South Brooklyn",850,DEPT OF DESIGN & CONSTRUCTION,REPLACEMENT OR AUGMENTATION OF EXISTING SYSTEMS,300,BROOKLYN,SE-0002K EP-0007,7125,107,7500,0,0,0,0,0,7607,107,7500,0,0,0,0,0,7607,214,15000,0,0,0,0,0,15214,PROJECT DELAYED DUE TO UNFORESEEN SITE/FIELD CONDITION,,"RECONSTRUCTION OF EXISTING SEWERS, SOUTH BROOKLYN",cpd11-20bk.pdf
SOLARDOS1,Brooklyn 17/18 HVAC AND ROOF REPLACEMENT,850,DEPT OF DESIGN & CONSTRUCTION,"BUILDING CONSTRUCTION, RECONSTRUCTION OR RETROFIT",301,BROOKLYN,PU-0025,3793,736,0,6579,0,0,0,0,7315,736,0,6579,0,0,0,0,7315,1472,0,13158,0,0,0,0,14630,PROJECT DELAYED DUE TO UNFORESEEN SITE/FIELD CONDITION,,,cpd11-20bk.pdf
ACEBPL901,BPL - AHU Replacement at New Brower Park Branch,856,DEPT OF CITYWIDE ADMIN SERVS,"BUILDING CONSTRUCTION, RECONSTRUCTION OR RETROFIT",301,BROOKLYN,PU-0025,234,0,0,234,0,0,0,0,234,0,0,234,0,0,0,0,234,0,0,468,0,0,0,0,468,PROJECT DELAYED DUE TO BUDGETARY CONSTRAINTS,,AHU REPLACEMENT AT NEW BROWER PARK BRANCH,cpd11-20bk.pdf
ACEDEP901,DEP - Gravity Belt Thickener (GBT) at Newtown Creek WRRF,856,DEPT OF CITYWIDE ADMIN SERVS,"BUILDING CONSTRUCTION, RECONSTRUCTION OR RETROFIT",301,BROOKLYN,PU-0025,36101,0,14101,0,22000,0,0,0,36101,0,14101,0,22000,0,0,0,36101,0,28202,0,44000,0,0,0,72202,PROJECT DELAYED DUE TO BUDGETARY CONSTRAINTS,,GRAVITY BELT THICKENER (GBT) AT NEWTOWN CREEK WRRF,cpd11-20bk.pdf
ACEDOE607,DOE - LIGHTING UPGRADES,856,DEPT OF CITYWIDE ADMIN SERVS,"BUILDING CONSTRUCTION, RECONSTRUCTION OR RETROFIT",304,BROOKLYN,PU-0025,1224,1018,0,92,0,0,0,0,1110,1018,0,92,0,0,0,0,1110,2036,0,184,0,0,0,0,2220,PROJECT DELAYED DUE TO BUDGETARY CONSTRAINTS,,UNIT,cpd11-20bk.pdf
ACEDOE702,DOE - VACANCY SENSORS,856,DEPT OF CITYWIDE ADMIN SERVS,"BUILDING CONSTRUCTION, RECONSTRUCTION OR RETROFIT",301,BROOKLYN,PU-0025,441,0,0,441,0,0,0,0,441,0,0,441,0,0,0,0,441,0,0,882,0,0,0,0,882,,,DOE - VACANCY SENSORS,cpd11-20bk.pdf
BKLYNMTC,Consolidation of four Bklyn DCP offices into one at 12 MTC,856,DEPT OF CITYWIDE ADMIN SERVS,CHILD WELFARE FACILITIES,302,BROOKLYN,CS-0003,12953,0,5010,0,0,0,0,0,5010,0,5010,0,0,0,0,0,5010,0,10020,0,0,0,0,0,10020,,,TBD,cpd11-20bk.pdf
CO264BKCV,210 JORALEMON ST. OCA RELOCATION,856,DEPT OF CITYWIDE ADMIN SERVS,RECONSTRUCTION/RENOVATION OF COURT FACILITIES,301,BROOKLYN,CO-0264,251438,11181,205437,18599,14645,0,0,0,249862,11181,205437,18599,14645,0,0,0,249862,22362,410874,37198,29290,0,0,0,499724,,,OCA- RELOCATION FROM 141 LIVINGSTON ST. TO 210 JORALEMON,cpd11-20bk.pdf
CO272BLR,45 MONROE PL - BOILER PLANT UPGRADE,856,DEPT OF CITYWIDE ADMIN SERVS,RECONSTRUCTION/RENOVATION OF COURT FACILITIES,301,BROOKLYN,CO-0272,4624,0,0,0,0,0,0,0,0,0,0,0,0,0,0,0,0,0,0,0,0,0,0,0,0,,,SQ FT,cpd11-20bk.pdf
CO272CHIL,45 MONROE PL CHILLER REPLACEMENT,856,DEPT OF CITYWIDE ADMIN SERVS,RECONSTRUCTION/RENOVATION OF COURT FACILITIES,301,BROOKLYN,CO-0272,1958,0,0,0,0,0,0,0,0,0,0,0,0,0,0,0,0,0,0,0,0,0,0,0,0,,,SQ FT,cpd11-20bk.pdf
CO272DW2,45 MONROE PL- DRIVEWAY PLACEMENT,856,DEPT OF CITYWIDE ADMIN SERVS,RECONSTRUCTION/RENOVATION OF COURT FACILITIES,301,BROOKLYN,CO-0272,1436,0,0,0,0,0,0,0,0,0,0,0,0,0,0,0,0,0,0,0,0,0,0,0,0,,,IA/SQ,cpd11-20bk.pdf
CO278ADA1,360 ADAMS ST - ADA IMPROVEMENTS,856,DEPT OF CITYWIDE ADMIN SERVS,RECONSTRUCTION/RENOVATION OF COURT FACILITIES,301,BROOKLYN,CO-0278,13238,0,0,926,0,0,11108,0,12034,0,0,926,0,0,11108,0,12034,0,0,1852,0,0,22216,0,24068,PROJECT DELAYED DUE TO BUDGETARY CONSTRAINTS,,IA/SQ,cpd11-20bk.pdf
CO278ELV,360 ADAMS ST.- ELEVATOR MODERNIZATION,856,DEPT OF CITYWIDE ADMIN SERVS,RECONSTRUCTION/RENOVATION OF COURT FACILITIES,302,BROOKLYN,CO-0278,23963,0,0,1000,0,0,22963,0,23963,0,0,1000,0,0,22963,0,23963,0,0,2000,0,0,45926,0,47926,,,360 ADAMS ST - ELEVATOR MODERNIZATION,cpd11-20bk.pdf
CO278RF,360 ADAMS STREET - ROOF,856,DEPT OF CITYWIDE ADMIN SERVS,RECONSTRUCTION/RENOVATION OF COURT FACILITIES,301,BROOKLYN,CO-0278,521,0,0,43,0,0,430,0,473,0,0,43,0,0,430,0,473,0,0,86,0,0,860,0,946,,,360 ADAMS STREET - ROOF,cpd11-20bk.pdf
CO278TOIL,360 ADAMS ST. - CODE COMPLIANT TOILET UPGRADE,856,DEPT OF CITYWIDE ADMIN SERVS,RECONSTRUCTION/RENOVATION OF COURT FACILITIES,302,BROOKLYN,CO-0278,3350,0,0,350,0,0,0,3000,3350,0,0,350,0,0,0,3000,3350,0,0,700,0,0,0,6000,6700,PROJECT DELAYED DUE TO BUDGETARY CONSTRAINTS,,360 ADAMS ST. - CODE COMPLIANT TOILET UPGRADE,cpd11-20bk.pdf
E09-00030,NYPD - 09-064; 69th Precinct; 9720 Foster Avenue,856,DEPT OF CITYWIDE ADMIN SERVS,"BUILDING CONSTRUCTION, RECONSTRUCTION OR RETROFIT",308,BROOKLYN,PO-0079,552,1114,47,0,0,0,0,0,1161,1114,47,0,0,0,0,0,1161,2228,94,0,0,0,0,0,2322,PROJECT DELAYED DUE TO CHANGES IN SCOPE/DESIGN,,ENERGY EFFICIENCY UPGRADE AT 69TH PRECINCT; 9720 FOSTER AVENUE,cpd11-20bk.pdf
EO26-0020,NYPD - 71st Precinct,856,DEPT OF CITYWIDE ADMIN SERVS,"BUILDING CONSTRUCTION, RECONSTRUCTION OR RETROFIT",301,BROOKLYN,PU-0025,350,0,287,0,0,0,0,0,287,0,287,0,0,0,0,0,287,0,574,0,0,0,0,0,574,,,NYPD - 71ST PRECINCT,cpd11-20bk.pdf
EO26-0057,NYPD - 62nd Precinct,856,DEPT OF CITYWIDE ADMIN SERVS,"BUILDING CONSTRUCTION, RECONSTRUCTION OR RETROFIT",301,BROOKLYN,PU-0025,300,0,131,0,0,0,0,0,131,0,131,0,0,0,0,0,131,0,262,0,0,0,0,0,262,PROJECT DELAYED DUE TO CHANGES IN SCOPE/DESIGN,,62ND PRECINCT,cpd11-20bk.pdf
EO26-0058,NYPD - 63rd Precinct,856,DEPT OF CITYWIDE ADMIN SERVS,"BUILDING CONSTRUCTION, RECONSTRUCTION OR RETROFIT",301,BROOKLYN,PU-0025,300,0,120,0,0,0,0,0,120,0,120,0,0,0,0,0,120,0,240,0,0,0,0,0,240,PROJECT DELAYED DUE TO CHANGES IN SCOPE/DESIGN,,63RD PRECINCT,cpd11-20bk.pdf
EO26-0059,NYPD - 66th Precinct,856,DEPT OF CITYWIDE ADMIN SERVS,"BUILDING CONSTRUCTION, RECONSTRUCTION OR RETROFIT",301,BROOKLYN,PU-0025,300,0,99,0,0,0,0,0,99,0,99,0,0,0,0,0,99,0,198,0,0,0,0,0,198,PROJECT DELAYED DUE TO CHANGES IN SCOPE/DESIGN,,66TH PRECINCT,cpd11-20bk.pdf
EO26-0060,NYPD - 70th Precinct,856,DEPT OF CITYWIDE ADMIN SERVS,"BUILDING CONSTRUCTION, RECONSTRUCTION OR RETROFIT",301,BROOKLYN,PU-0025,300,0,0,136,0,0,0,0,136,0,0,136,0,0,0,0,136,0,0,272,0,0,0,0,272,PROJECT DELAYED DUE TO CHANGES IN SCOPE/DESIGN,,70TH PRECINCT,cpd11-20bk.pdf
EO26-0061,NYPD - 88th Precinct,856,DEPT OF CITYWIDE ADMIN SERVS,"BUILDING CONSTRUCTION, RECONSTRUCTION OR RETROFIT",301,BROOKLYN,PU-0025,300,0,0,132,0,0,0,0,132,0,0,132,0,0,0,0,132,0,0,264,0,0,0,0,264,PROJECT DELAYED DUE TO CHANGES IN SCOPE/DESIGN,,88TH PRECINCT,cpd11-20bk.pdf
EO26-0062,NYPD - 94th Precinct,856,DEPT OF CITYWIDE ADMIN SERVS,"BUILDING CONSTRUCTION, RECONSTRUCTION OR RETROFIT",301,BROOKLYN,PU-0025,300,0,0,209,0,0,0,0,209,0,0,209,0,0,0,0,209,0,0,418,0,0,0,0,418,PROJECT DELAYED DUE TO CHANGES IN SCOPE/DESIGN,,94TH PRECINCT,cpd11-20bk.pdf
EO26-0073,NYPD - 77TH PRECINCT ANNEX,856,DEPT OF CITYWIDE ADMIN SERVS,"BUILDING CONSTRUCTION, RECONSTRUCTION OR RETROFIT",301,BROOKLYN,PU-0025,300,0,0,300,0,0,0,0,300,0,0,300,0,0,0,0,300,0,0,600,0,0,0,0,600,PROJECT DELAYED DUE TO CHANGES IN SCOPE/DESIGN,,IA/SQ,cpd11-20bk.pdf
EO26-0074,NYPD - HARBOR UNIT CHARLIE,856,DEPT OF CITYWIDE ADMIN SERVS,"BUILDING CONSTRUCTION, RECONSTRUCTION OR RETROFIT",301,BROOKLYN,PU-0025,300,0,0,297,0,0,0,0,297,0,0,297,0,0,0,0,297,0,0,594,0,0,0,0,594,PROJECT DELAYED DUE TO CHANGES IN SCOPE/DESIGN,,IA/SQ,cpd11-20bk.pdf
EO26-0077,NYPD - 75TH PRECINCT,856,DEPT OF CITYWIDE ADMIN SERVS,"BUILDING CONSTRUCTION, RECONSTRUCTION OR RETROFIT",301,BROOKLYN,PU-0025,300,0,0,198,0,0,0,0,198,0,0,198,0,0,0,0,198,0,0,396,0,0,0,0,396,PROJECT DELAYED DUE TO CHANGES IN SCOPE/DESIGN,,IA/SQ,cpd11-20bk.pdf
EO26-0079,HHC/DHS - AUBURN FAMILY RESIDENCE (CUMBERLAND DIAGNOSTIC),856,DEPT OF CITYWIDE ADMIN SERVS,"BUILDING CONSTRUCTION, RECONSTRUCTION OR RETROFIT",301,BROOKLYN,PU-0025,500,0,0,500,0,0,0,0,500,0,0,500,0,0,0,0,500,0,0,1000,0,0,0,0,1000,PROJECT DELAYED DUE TO CHANGES IN SCOPE/DESIGN,,IA/SQ,cpd11-20bk.pdf
EO26-0082,DHS - FANNIE BARNES (URBAN TRANSITIONAL HOUSING),856,DEPT OF CITYWIDE ADMIN SERVS,"BUILDING CONSTRUCTION, RECONSTRUCTION OR RETROFIT",301,BROOKLYN,PU-0025,500,0,0,64,0,0,0,0,64,0,0,64,0,0,0,0,64,0,0,128,0,0,0,0,128,PROJECT DELAYED DUE TO CHANGES IN SCOPE/DESIGN,,IA/SQ,cpd11-20bk.pdf
EO26-0083,DHS - PARK SLOPE ARMORY SHELTER,856,DEPT OF CITYWIDE ADMIN SERVS,"BUILDING CONSTRUCTION, RECONSTRUCTION OR RETROFIT",301,BROOKLYN,PU-0025,500,0,275,0,0,0,0,0,275,0,275,0,0,0,0,0,275,0,550,0,0,0,0,0,550,PROJECT DELAYED DUE TO BUDGETARY CONSTRAINTS,,IA/SQ,cpd11-20bk.pdf
EO26-0084,DHS - ROSE McCARTHY FAMILY RESIDENCE CAMPUS (1),856,DEPT OF CITYWIDE ADMIN SERVS,"BUILDING CONSTRUCTION, RECONSTRUCTION OR RETROFIT",301,BROOKLYN,PU-0025,400,0,71,0,0,0,0,0,71,0,71,0,0,0,0,0,71,0,142,0,0,0,0,0,142,PROJECT DELAYED DUE TO CHANGES IN SCOPE/DESIGN,,IA/SQ,cpd11-20bk.pdf
EO26-0085,DHS - ROSE McCARTHY FAMILY RESIDENCE CAMPUS (2),856,DEPT OF CITYWIDE ADMIN SERVS,"BUILDING CONSTRUCTION, RECONSTRUCTION OR RETROFIT",301,BROOKLYN,PU-0025,400,0,111,0,0,0,0,0,111,0,111,0,0,0,0,0,111,0,222,0,0,0,0,0,222,PROJECT DELAYED DUE TO BUDGETARY CONSTRAINTS,,IA/SQ,cpd11-20bk.pdf
EO26-0086,HRA - BUSHWICK JOB CENTER (FLSUHING) (LEASED IN),856,DEPT OF CITYWIDE ADMIN SERVS,"BUILDING CONSTRUCTION, RECONSTRUCTION OR RETROFIT",301,BROOKLYN,PU-0025,400,0,0,400,0,0,0,0,400,0,0,400,0,0,0,0,400,0,0,800,0,0,0,0,800,PROJECT DELAYED DUE TO CHANGES IN SCOPE/DESIGN,,IA/SQ,cpd11-20bk.pdf
EO26-0088,DPR - McCARREN PARK RECREATION CENTER,856,DEPT OF CITYWIDE ADMIN SERVS,"BUILDING CONSTRUCTION, RECONSTRUCTION OR RETROFIT",301,BROOKLYN,PU-0025,400,0,0,400,0,0,0,0,400,0,0,400,0,0,0,0,400,0,0,800,0,0,0,0,800,PROJECT DELAYED DUE TO CHANGES IN SCOPE/DESIGN,,IA/SQ,cpd11-20bk.pdf
EO26-0096,BPL - RED HOOK,856,DEPT OF CITYWIDE ADMIN SERVS,"BUILDING CONSTRUCTION, RECONSTRUCTION OR RETROFIT",301,BROOKLYN,PU-0025,1256,0,0,2200,0,0,0,0,2200,0,0,2200,0,0,0,0,2200,0,0,4400,0,0,0,0,4400,PROJECT DELAYED DUE TO BUDGETARY CONSTRAINTS,,IA/SQ,cpd11-20bk.pdf
PO79540K,RELOCATION FROM 540 KINGSLAND AVE,856,DEPT OF CITYWIDE ADMIN SERVS,POLICE FACILITIES,300,BROOKLYN,PO-0079,1528,944,584,0,0,0,0,0,1528,944,584,0,0,0,0,0,1528,1888,1168,0,0,0,0,0,3056,,,RELOCATION FROM 540 KINGSLAND AVE,cpd11-20bk.pdf
PW291EV,209 JORALEMON ST.- ELEVATOR UPGRADE,856,DEPT OF CITYWIDE ADMIN SERVS,REHABILITATION OF CITY-OWNED OFFICE SPACE,301,BROOKLYN,PW-0291,5007,0,417,0,4198,0,0,0,4615,0,417,0,4198,0,0,0,4615,0,834,0,8396,0,0,0,9230,,,PER UNIT,cpd11-20bk.pdf
PW322PLAN,345 ADAMS RESTACKING PLAN,856,DEPT OF CITYWIDE ADMIN SERVS,REHABILITATION OF CITY-OWNED OFFICE SPACE,302,BROOKLYN,PW-0322,107049,113027,13132,0,0,0,0,0,126159,113027,13132,0,0,0,0,0,126159,226054,26264,0,0,0,0,0,252318,,,"345 ADAMS, RESTACKING OF AGENCIES",cpd11-20bk.pdf
PW325ELC3,210 JORALEMON ST. ELECTRICAL UPGRADE AND EMERGENCY GENERATOR,856,DEPT OF CITYWIDE ADMIN SERVS,REHABILITATION OF CITY-OWNED OFFICE SPACE,301,BROOKLYN,PW-0325,33358,29370,1000,3357,0,0,0,0,33727,29370,1000,3357,0,0,0,0,33727,58740,2000,6714,0,0,0,0,67454,,,ELECTRICAL UPGRADE AND EMERGENCY GENERATOR,cpd11-20bk.pdf
PW325STA3,210 JORALEMON STREET STABILIZATION,856,DEPT OF CITYWIDE ADMIN SERVS,LEGAL MANDATES AND CORRECTION OF UNSAFE CONDITIONS,300 302,BROOKLYN,PW-0325,3672,3300,453,160,0,0,0,0,3913,3300,453,160,0,0,0,0,3913,6600,906,320,0,0,0,0,7826,,,"INSPECTION, PROBING CORE DRILLING AND STABILIZATION REAR OF BUILDING TO DDC",cpd11-20bk.pdf
PW326DCPK,DCP - 16 COURT ST RENOVATION,856,DEPT OF CITYWIDE ADMIN SERVS,RENOVATION OF LEASED SPACE,301,BROOKLYN,PW-0326,920,0,920,0,0,0,0,0,920,0,920,0,0,0,0,0,920,0,1840,0,0,0,0,0,1840,PROJECT DELAYED DUE TO CHANGES IN SCOPE/DESIGN,,SQ/IA,cpd11-20bk.pdf
PW326LAW7,LAW - 167 41ST - LAW DEPT CONSOLIDATION,856,DEPT OF CITYWIDE ADMIN SERVS,RENOVATION OF LEASED SPACE,301,BROOKLYN,PW-0326,13182,0,0,13182,0,0,0,0,13182,0,0,13182,0,0,0,0,13182,0,0,26364,0,0,0,0,26364,PROJECT DELAYED DUE TO CHANGES IN SCOPE/DESIGN,,167 41ST - LAW DEPT CONSOLIDATION,cpd11-20bk.pdf
PW326OEM3,OEM Expansion of Leased Space 930 Flushing Avenue,856,DEPT OF CITYWIDE ADMIN SERVS,RENOVATION OF LEASED SPACE,302,BROOKLYN,PW-0326,85000,0,0,0,0,19000,8000,58000,85000,0,0,0,0,19000,8000,58000,85000,0,0,0,0,38000,16000,116000,170000,,,OEM EXPANSION FOR WAREHOUSE,cpd11-20bk.pdf
PW326RAK,LAW DEPT - RAISE THE AGE - BROOKLYN,856,DEPT OF CITYWIDE ADMIN SERVS,RENOVATION OF LEASED SPACE,301,BROOKLYN,PW-0326,5499,0,5499,0,0,0,0,0,5499,0,5499,0,0,0,0,0,5499,0,10998,0,0,0,0,0,10998,,,LAW DEPT - RAISE THE AGE - BROOKLYN,cpd11-20bk.pdf
PW340BOE,BOE - 345 ADAMS ST.- BATHROOMS RENOVATION,856,DEPT OF CITYWIDE ADMIN SERVS,BOARD OF ELECTIONS MODERNIZATION,302,BROOKLYN,PW-0340,260,0,0,260,0,0,0,0,260,0,0,260,0,0,0,0,260,0,0,520,0,0,0,0,520,,,BOE - 345 ADAMS ST.- BATHROOMS RENOVATION,cpd11-20bk.pdf
PW340KEXP,"BOE - 5112 2nd AVE, BROOKLYN EXPANSION",856,DEPT OF CITYWIDE ADMIN SERVS,RENOVATION OF LEASED SPACE,301,BROOKLYN,PW-0340,801,0,801,0,0,0,0,0,801,0,801,0,0,0,0,0,801,0,1602,0,0,0,0,0,1602,,,IA/SQ,cpd11-20bk.pdf
PW77BHCAM,209 JORALEMON STREET - CCTV,856,DEPT OF CITYWIDE ADMIN SERVS,EQUIPMENT AND INTERAGENCY SERVICES,301,BROOKLYN,PW-0077,1026,904,98,0,0,0,0,0,1002,904,98,0,0,0,0,0,1002,1808,196,0,0,0,0,0,2004,,,,cpd11-20bk.pdf
PW77ZK07,BROOKLYN COMMUNITY BOARD 7- 4201 4TH AVENUE,856,DEPT OF CITYWIDE ADMIN SERVS,REHABILITATION OF CITY-OWNED OFFICE SPACE,300,BROOKLYN,PW-0077,473,0,0,0,0,473,0,0,473,0,0,0,0,473,0,0,473,0,0,0,0,946,0,0,946,PROJECT DELAYED DUE TO BUDGETARY CONSTRAINTS,,BROOKLYN CB 7 RENOVATIONS,cpd11-20bk.pdf
PWD007HPD,HPD - CONSTRUCTION AND RENOVATION OF NORTHSIDE TOWN HALL,856,DEPT OF CITYWIDE ADMIN SERVS,MISCELLANEOUS CONSTRUCTION,301,BROOKLYN,PW-D007,3150,0,0,0,0,550,0,0,550,0,0,0,0,550,0,0,550,0,0,0,0,1100,0,0,1100,,,134 WYTHE AVE,cpd11-20bk.pdf
PWD30BENC,BENJAMIN BANNEKER ACADEMY FOR COMMUNITY DEVELOPMENT,856,DEPT OF CITYWIDE ADMIN SERVS,EQUIPMENT AND INTERAGENCY SERVICES,,BROOKLYN,PW-D308,100,0,0,100,0,0,0,0,100,0,0,100,0,0,0,0,100,0,0,200,0,0,0,0,200,PROJECT DELAYED DUE TO BUDGETARY CONSTRAINTS,,BENJAMIN BANNEKER ACADEMY FOR COMMUNITY DEVELOPMENT--TECHNOLOGY UPGRADES,cpd11-20bk.pdf
PWD78BLL,360 ADAMS STREET- BROOKLYN SUPREME COURT LAW LIBRARY,856,DEPT OF CITYWIDE ADMIN SERVS,REHABILITATION OF CITY-OWNED OFFICE SPACE,301,BROOKLYN,PW-D078,300,0,0,0,0,300,0,0,300,0,0,0,0,300,0,0,300,0,0,0,0,600,0,0,600,,,DCAS - BROOKLYN SUPREME COURT LAW LIBRARY,cpd11-20bk.pdf
PWD78SSCT,360 ADAMS ST.- HVAC STATE SUPREME COURT,856,DEPT OF CITYWIDE ADMIN SERVS,RENOVATION OF OTHER CITY-OWNED FACILITIES,301,BROOKLYN,PW-D078,230,0,0,0,0,0,0,200,200,0,0,0,0,0,0,200,200,0,0,0,0,0,0,400,400,PROJECT DELAYED DUE TO BUDGETARY CONSTRAINTS,,STATE SUPREME COURT 360 ADAMS HVAC,cpd11-20bk.pdf
PWK2LEED,Brooklyn Borough Hall - LEED- Funding for LEED,856,DEPT OF CITYWIDE ADMIN SERVS,REHABILITATION OF CITY-OWNED OFFICE SPACE,302,BROOKLYN,PW-K002,200,0,0,200,0,0,0,0,200,0,0,200,0,0,0,0,200,0,0,400,0,0,0,0,400,,,BROOKLYN BOROUGH HALL - LEED- FUNDING FOR LEED,cpd11-20bk.pdf
PWK2MEDIA,209 JORALEMON ST.- BKLYN BORO HALL MEDIA ROOM,856,DEPT OF CITYWIDE ADMIN SERVS,REHABILITATION OF CITY-OWNED OFFICE SPACE,302,BROOKLYN,PW-K002,1627,1450,0,0,0,398,0,0,1848,1450,0,0,0,398,0,0,1848,2900,0,0,0,796,0,0,3696,PROJECT DELAYED DUE TO CHANGES IN SCOPE/DESIGN,,BROOKLYN BORO HALL MEDIA ROOM,cpd11-20bk.pdf
RE25LL,LOTTS LANE REPAIRING,856,DEPT OF CITYWIDE ADMIN SERVS,REHABILITATION OF NON-WATERFRONT PROPERTIES,301,BROOKLYN,RE-0025,1438,0,0,0,364,0,1042,0,1406,0,0,0,364,0,1042,0,1406,0,0,0,728,0,2084,0,2812,PROJECT DELAYED DUE TO BUDGETARY CONSTRAINTS,,SQ/IA,cpd11-20bk.pdf
RE25QR,QUENTIN ROAD BROOKLYN STREET RECONSTRUCTION,856,DEPT OF CITYWIDE ADMIN SERVS,REHABILITATION OF NON-WATERFRONT PROPERTIES,301,BROOKLYN,RE-0025,1585,0,0,0,462,0,1110,0,1572,0,0,0,462,0,1110,0,1572,0,0,0,924,0,2220,0,3144,PROJECT DELAYED DUE TO BUDGETARY CONSTRAINTS,,IA/SQ,cpd11-20bk.pdf
SCACIP05,K061 - SYSTEM REPLACEMENT,856,DEPT OF CITYWIDE ADMIN SERVS,"BUILDING CONSTRUCTION, RECONSTRUCTION OR RETROFIT",301,BROOKLYN,PU-0025,500,0,0,500,0,0,0,0,500,0,0,500,0,0,0,0,500,0,0,1000,0,0,0,0,1000,,,K061 - SYSTEM REPLACEMENT,cpd11-20bk.pdf
SOLARGR20,NYPA - Capital 02 Rooftop Solar PV,856,DEPT OF CITYWIDE ADMIN SERVS,DISTRIBUTED GENERATION,,BROOKLYN,PU-0025,12100,0,0,12000,0,0,0,0,12000,0,0,12000,0,0,0,0,12000,0,0,24000,0,0,0,0,24000,,,NYPA - CAPITAL 02 ROOFTOP SOLAR PV,cpd11-20bk.pdf
WD77STAR,STAR ENGINEERING LAB,856,DEPT OF CITYWIDE ADMIN SERVS,MISCELLANEOUS CONSTRUCTION,314,BROOKLYN,PW-D077,350,0,0,0,0,350,0,0,350,0,0,0,0,350,0,0,350,0,0,0,0,700,0,0,700,PROJECT DELAYED DUE TO BUDGETARY CONSTRAINTS,,TO CONVERT A CLASSROOM AT THE SCIENCE TECHNOLOGY AND REASEARCH EARLYCOLLEGE,cpd11-20bk.pdf
LN18ALRFW,Allerton - New Roof and Windows,037,NEW YORK PUBLIC LIBRARY,ESSENTIAL RECONSTRUCTION OF FACILITIES,211,BRONX,LN-X001,1000,0,0,0,0,0,0,1000,1000,0,0,0,0,0,0,1000,1000,0,0,0,0,0,0,2000,2000,,,NYPL ALLERTON BRANCH--NEW ROOF AND WINDOWS 2740 BARNES AVENUE.,cpd11-20bx.pdf
LN18BEADA,BELMONT- ADA-compliant Restrooms,037,NEW YORK PUBLIC LIBRARY,ESSENTIAL RECONSTRUCTION OF FACILITIES,206,BRONX,LN-D008,500,0,0,0,0,500,0,0,500,0,0,0,0,500,0,0,500,0,0,0,0,1000,0,0,1000,,,BELMONT BRANCH--UPGRADE RESTROOMS TO BECOME ADA COMPLIANT,cpd11-20bx.pdf
LN18CPBOI,CLASON'S POINT - New Boiler,037,NEW YORK PUBLIC LIBRARY,ESSENTIAL RECONSTRUCTION OF FACILITIES,209,BRONX,LN-0008,500,0,0,0,0,0,0,500,500,0,0,0,0,0,0,500,500,0,0,0,0,0,0,1000,1000,,,NEW BOILER,cpd11-20bx.pdf
LN18DYBHV,SPUYTEN DUYVIL - Boiler and HVAC Replacement,037,NEW YORK PUBLIC LIBRARY,ESSENTIAL RECONSTRUCTION OF FACILITIES,208,BRONX,LN-0008,725,0,0,0,0,0,73,652,725,0,0,0,0,0,73,652,725,0,0,0,0,0,146,1304,1450,,,SPUYTEN DUYVIL - BOILER AND HVAC,cpd11-20bx.pdf
LN18MRBOI,Morrisania - Boiler Replacement,037,NEW YORK PUBLIC LIBRARY,ESSENTIAL RECONSTRUCTION OF FACILITIES,203,BRONX,LN-D008,3015,0,0,343,2401,0,0,0,2744,0,0,343,2401,0,0,0,2744,0,0,686,4802,0,0,0,5488,,,NEW BOILER AT MORRISANIA BRANCH LIBRARY,cpd11-20bx.pdf
LN18RDADA,Riverdale - ADA-compliant Bathroom Renovation,037,NEW YORK PUBLIC LIBRARY,ESSENTIAL RECONSTRUCTION OF FACILITIES,208,BRONX,LN-D008,500,0,0,0,0,500,0,0,500,0,0,0,0,500,0,0,500,0,0,0,0,1000,0,0,1000,,,BATHROOM RENOVATION AT THE RIVERDALE BRANCH LIBRARY (ADA COMPLIANCE),cpd11-20bx.pdf
LNBEREXRE,Belmont - Exterior Renovation,037,NEW YORK PUBLIC LIBRARY,ESSENTIAL RECONSTRUCTION OF FACILITIES,,BRONX,LN-D008,1000,0,0,0,0,1000,0,0,1000,0,0,0,0,1000,0,0,1000,0,0,0,0,2000,0,0,2000,,,BELMONT PUBLIC LIBRARY - EXTERIOR RENOVATION -- BUILDING ENVELOPE/FACILITY PRESERVATION.,cpd11-20bx.pdf
LNBERHVAC,Belmont - HVAC /Mechnical Systems Upgrade,037,NEW YORK PUBLIC LIBRARY,ESSENTIAL RECONSTRUCTION OF FACILITIES,,BRONX,LN-D008,1500,0,0,0,0,1500,0,0,1500,0,0,0,0,1500,0,0,1500,0,0,0,0,3000,0,0,3000,,,BELMONT PUBLIC LIBRARY - HVAC UPGRADE -- HVAC/MECHANICAL SYSTEMS UPGRADE. FY19 ADP,cpd11-20bx.pdf
LNCA16SDW,Sedgwick - New Roof,037,NEW YORK PUBLIC LIBRARY,ESSENTIAL RECONSTRUCTION OF FACILITIES,200,BRONX,LN-D008,300,0,0,30,270,0,0,0,300,0,0,30,270,0,0,0,300,0,0,60,540,0,0,0,600,,,NEW ROOF,cpd11-20bx.pdf
LNCA17PBY,"PELHAM BAY - ADA Restrooms, New Roof",037,NEW YORK PUBLIC LIBRARY,ESSENTIAL RECONSTRUCTION OF FACILITIES,200,BRONX,LN-D008,1300,0,0,0,0,1178,0,0,1178,0,0,0,0,1178,0,0,1178,0,0,0,0,2356,0,0,2356,,,PELHAM BAY,cpd11-20bx.pdf
LNGDEXTRO,"Grand Concourse - New Roof, Building Envelope",037,NEW YORK PUBLIC LIBRARY,ESSENTIAL RECONSTRUCTION OF FACILITIES,,BRONX,LN-0008 LN-D008,2078,0,0,278,1620,0,0,0,1898,0,0,278,1620,0,0,0,1898,0,0,556,3240,0,0,0,3796,,,GRAND CONCOURSE PUBLIC LIBRARY - NEW ROOF -- BUILDING ENVELOPE/FACILITY PRESERVATION,cpd11-20bx.pdf
LNMPADA01,Morris Park - ADA-compliant Entrance,037,NEW YORK PUBLIC LIBRARY,ESSENTIAL RECONSTRUCTION OF FACILITIES,,BRONX,LN-D008,500,0,0,0,0,500,0,0,500,0,0,0,0,500,0,0,500,0,0,0,0,1000,0,0,1000,,,NYPL,cpd11-20bx.pdf
LNVNADABA,Pelham Pkwy/Van Nest - ADA-compliant Bathroom,037,NEW YORK PUBLIC LIBRARY,ESSENTIAL RECONSTRUCTION OF FACILITIES,,BRONX,LN-D008,500,0,0,0,0,500,0,0,500,0,0,0,0,500,0,0,500,0,0,0,0,1000,0,0,1000,,,NYPL,cpd11-20bx.pdf
LNXA20WKF,Wakefield - Infrastructure and ADA Upgrades,037,NEW YORK PUBLIC LIBRARY,ESSENTIAL RECONSTRUCTION OF FACILITIES,,BRONX,LN-X001 LN-0008 LN-D008,3443,0,0,0,3121,0,0,0,3121,0,0,0,3121,0,0,0,3121,0,0,0,6242,0,0,0,6242,,,WAKEFIELD - INFRASTRUCTURE AND ADA UPGRADES,cpd11-20bx.pdf
ACECUN901,CUNY - BMS Upgrade at 4 Hostos College Buildings,042,CITY UNIVERSITY,"BUILDING CONSTRUCTION, RECONSTRUCTION OR RETROFIT",201,BRONX,PU-0025,5108,0,5108,0,0,0,0,0,5108,0,5108,0,0,0,0,0,5108,0,10216,0,0,0,0,0,10216,,,CUNY - BMS UPGRADE AT 4 HOSTOS COLLEGE BUILDINGS,cpd11-20bx.pdf
BX001-021,Roscoe Brown Memorial,042,CITY UNIVERSITY,MISCELLANEOUS RECONSTRUCTION,200,BRONX,HN-D004,350,0,350,0,0,0,0,0,350,0,350,0,0,0,0,0,350,0,700,0,0,0,0,0,700,,,ROSCOE BROWN MEMORIAL,cpd11-20bx.pdf
BX022-009,Gould Memorial Lib Rotunda Staircase Installation,042,CITY UNIVERSITY,MISCELLANEOUS RECONSTRUCTION,200 205,BRONX,HN-D002,1093,958,0,0,0,134,0,0,1092,958,0,0,0,134,0,0,1092,1916,0,0,0,268,0,0,2184,PROJECT DELAYED DUE TO BUDGETARY CONSTRAINTS,,INSTALLATION OF STAIRCASES FOR GOULD MEMORIAL LIB ROTUNDA,cpd11-20bx.pdf
BX024-019,Gould Memorial Library Reconstruction,042,CITY UNIVERSITY,MISCELLANEOUS RECONSTRUCTION,200,BRONX,HN-0206,1500,0,0,0,0,0,695,0,695,0,0,0,0,0,695,0,695,0,0,0,0,0,1390,0,1390,PROJECT DELAYED DUE TO CHANGES IN SCOPE/DESIGN,,GOULD MEMORIAL LIBRARY RECONSTRUCTION,cpd11-20bx.pdf
BX026-013,ADA Entrance Ramps,042,CITY UNIVERSITY,MISCELLANEOUS RECONSTRUCTION,200 205,BRONX,HN-X002,300,44,0,0,0,0,256,0,300,44,0,0,0,0,256,0,300,88,0,0,0,0,512,0,600,PROJECT DELAYED DUE TO CHANGES IN SCOPE/DESIGN,,ADA ENTRANCE RAMPS,cpd11-20bx.pdf
BX027-015,Ohio Track & Field Restoration,042,CITY UNIVERSITY,MISCELLANEOUS RECONSTRUCTION,200,BRONX,HN-X002,375,75,0,0,425,0,0,0,500,75,0,0,425,0,0,0,500,150,0,0,850,0,0,0,1000,PROJECT DELAYED DUE TO CHANGES IN SCOPE/DESIGN,,OHIO TRACK & FIELD RESTORATION,cpd11-20bx.pdf
BX032-015,Monument Hills Restoration,042,CITY UNIVERSITY,MISCELLANEOUS RECONSTRUCTION,200,BRONX,HN-D002 HN-0206,200,210,0,0,0,24,116,0,350,210,0,0,0,24,116,0,350,420,0,0,0,48,232,0,700,PROJECT DELAYED DUE TO BUDGETARY CONSTRAINTS,,MONUMENT HILLS RESTORATION,cpd11-20bx.pdf
BX034-015,Bliss Hall ADA Accessibility Improvements,042,CITY UNIVERSITY,MISCELLANEOUS RECONSTRUCTION,200,BRONX,HN-D002,300,0,0,300,0,0,0,0,300,0,0,300,0,0,0,0,300,0,0,600,0,0,0,0,600,PROJECT DELAYED DUE TO CHANGES IN SCOPE/DESIGN,,BLISS HAAL ACCESSIBILITY IMPROVEMENTS,cpd11-20bx.pdf
BX038-016,Lowe Hall ADA Accessibility Improvements,042,CITY UNIVERSITY,MISCELLANEOUS RECONSTRUCTION,200,BRONX,HN-D002,250,0,0,250,0,0,0,0,250,0,0,250,0,0,0,0,250,0,0,500,0,0,0,0,500,PROJECT DELAYED DUE TO CHANGES IN SCOPE/DESIGN,,LOWE HALL ADA ACCESSIBILITY IMPROVEMENTS,cpd11-20bx.pdf
BX039-016,Alumni Gym Locker Room Accessibility Improvements,042,CITY UNIVERSITY,MISCELLANEOUS RECONSTRUCTION,200,BRONX,HN-D005,250,0,0,250,0,0,0,0,250,0,0,250,0,0,0,0,250,0,0,500,0,0,0,0,500,PROJECT DELAYED DUE TO BUDGETARY CONSTRAINTS,,ALUMNI GYM ADA IMPROVEMENTS,cpd11-20bx.pdf
BX040-017,Bronx Express,042,CITY UNIVERSITY,MISCELLANEOUS RECONSTRUCTION,200,BRONX,HN-0206 HN-X002 HN-D002 HN-D003,4500,763,6272,0,0,0,0,0,7035,763,6272,0,0,0,0,0,7035,1526,12544,0,0,0,0,0,14070,PROJECT DELAYED DUE TO CHANGES IN SCOPE/DESIGN,,STUDENT SUCCESS CENTER,cpd11-20bx.pdf
BX041-017,STEM Resourse Center,042,CITY UNIVERSITY,MISCELLANEOUS RECONSTRUCTION,200,BRONX,HN-D002 HN-D004,150,28,0,0,0,122,0,0,150,28,0,0,0,122,0,0,150,56,0,0,0,244,0,0,300,PROJECT DELAYED DUE TO CHANGES IN SCOPE/DESIGN,,STEM RESOURSE CENTER,cpd11-20bx.pdf
BX042-018,Renovate Roscoe Brown Student Center,042,CITY UNIVERSITY,MISCELLANEOUS RECONSTRUCTION,207,BRONX,HN-X002,500,0,0,0,0,0,500,0,500,0,0,0,0,0,500,0,500,0,0,0,0,0,1000,0,1000,PROJECT DELAYED DUE TO CHANGES IN SCOPE/DESIGN,,RENOVATE ROSCOE BROWN STUDENT CENTER,cpd11-20bx.pdf
BX044-018,Community Hall First Floor Renovation,042,CITY UNIVERSITY,MISCELLANEOUS RECONSTRUCTION,200,BRONX,HN-D004,500,0,0,0,0,500,0,0,500,0,0,0,0,500,0,0,500,0,0,0,0,1000,0,0,1000,PROJECT DELAYED DUE TO CHANGES IN SCOPE/DESIGN,,COMMUNITY HALL FIRST FLOOR RENOVATION,cpd11-20bx.pdf
BX045-018,ADA Accessibility for Roscoe C Brown Student Center,042,CITY UNIVERSITY,MISCELLANEOUS RECONSTRUCTION,200,BRONX,HN-D004,400,0,0,0,0,400,0,0,400,0,0,0,0,400,0,0,400,0,0,0,0,800,0,0,800,PROJECT DELAYED DUE TO CHANGES IN SCOPE/DESIGN,,ADA ACCESSIBILITY FOR ROSCOE C BROWN STUDENT CENTER,cpd11-20bx.pdf
BX046-019,Alumni Gym HVAC & ADA Improvements,042,CITY UNIVERSITY,MISCELLANEOUS RECONSTRUCTION,205,BRONX,HN-D002 HN-X002,3000,0,0,250,500,2250,0,0,3000,0,0,250,500,2250,0,0,3000,0,0,500,1000,4500,0,0,6000,PROJECT DELAYED DUE TO CHANGES IN SCOPE/DESIGN,,ALUMNI GYM HVAV& ADA UPGRADES,cpd11-20bx.pdf
BX047-020,Ohio Track & Field Upgrade,042,CITY UNIVERSITY,MISCELLANEOUS RECONSTRUCTION,205,BRONX,HN-X002,500,0,0,0,500,0,0,0,500,0,0,0,500,0,0,0,500,0,0,0,1000,0,0,0,1000,,,OHIO TRACK & FIELD UPGRADE,cpd11-20bx.pdf
BX048-020,ELEVATOR UPGRADES,042,CITY UNIVERSITY,MISCELLANEOUS RECONSTRUCTION,200,BRONX,HN-D002,1008,0,0,125,0,883,0,0,1008,0,0,125,0,883,0,0,1008,0,0,250,0,1766,0,0,2016,PROJECT DELAYED DUE TO CHANGES IN SCOPE/DESIGN,,ELEVATOR UPGRADES,cpd11-20bx.pdf
BX049-020,Carl Polowczyk Hall Upgrades,042,CITY UNIVERSITY,MISCELLANEOUS RECONSTRUCTION,200,BRONX,HN-D002,3000,0,0,250,0,2750,0,0,3000,0,0,250,0,2750,0,0,3000,0,0,500,0,5500,0,0,6000,PROJECT DELAYED DUE TO CHANGES IN SCOPE/DESIGN,,CARL POLOWCZYK HALL UPGRADES,cpd11-20bx.pdf
BX050-021,Elevator Installation Gould Memorial Library,042,CITY UNIVERSITY,MISCELLANEOUS RECONSTRUCTION,200,BRONX,HN-X002 HN-D004,750,0,750,0,0,0,0,0,750,0,750,0,0,0,0,0,750,0,1500,0,0,0,0,0,1500,,,ELEVATOR INSTALLATION GOULD MEMORIAL LIBRARY,cpd11-20bx.pdf
CA034HS13,500 Grand Concourse 3rd Floor Renovation,042,CITY UNIVERSITY,MISCELLANEOUS RECONSTRUCTION,200,BRONX,HN-0206,6950,5875,1075,0,0,0,0,0,6950,5875,1075,0,0,0,0,0,6950,11750,2150,0,0,0,0,0,13900,PROJECT DELAYED DUE TO CHANGES IN SCOPE/DESIGN,,500 GRAND CONCOURSE THIRD FLOOR RENOVATION,cpd11-20bx.pdf
CA036-014,Hostos CC,042,CITY UNIVERSITY,MISCELLANEOUS RECONSTRUCTION,200 201,BRONX,HN-X002,2003,0,0,0,0,0,2003,0,2003,0,0,0,0,0,2003,0,2003,0,0,0,0,0,4006,0,4006,PROJECT DELAYED DUE TO BUDGETARY CONSTRAINTS,,COMMUNITY COLLEGE IMPROVEMENTS,cpd11-20bx.pdf
CA091HS96,Hostos Retaining Wall Project,042,CITY UNIVERSITY,MISCELLANEOUS RECONSTRUCTION,200,BRONX,HN-0206,1500,1000,0,500,0,0,0,0,1500,1000,0,500,0,0,0,0,1500,2000,0,1000,0,0,0,0,3000,PROJECT DELAYED DUE TO CHANGES IN SCOPE/DESIGN,,HOSTOS RETAINING WALL PROJECT,cpd11-20bx.pdf
CA202HS04,ADA Improvements,042,CITY UNIVERSITY,MISCELLANEOUS RECONSTRUCTION,205,BRONX,HN-D002 HN-0206,750,770,0,0,0,137,630,0,1537,770,0,0,0,137,630,0,1537,1540,0,0,0,274,1260,0,3074,PROJECT DELAYED DUE TO UNAVAILABILITY OF PRODUCT,,ADA IMPROVEMENTS,cpd11-20bx.pdf
CA92BX019,Colston Emergency Heating Restoration,042,CITY UNIVERSITY,MISCELLANEOUS RECONSTRUCTION,200,BRONX,HN-0206,309,234,0,0,0,0,75,0,309,234,0,0,0,0,75,0,309,468,0,0,0,0,150,0,618,PROJECT DELAYED DUE TO CHANGES IN SCOPE/DESIGN,,COLSTON EMERGENCY HEATING RESTORATION,cpd11-20bx.pdf
HS007-010,PEDESTRIAN BRIDGE ROOF REPLACEMENT,042,CITY UNIVERSITY,MISCELLANEOUS RECONSTRUCTION,200 201,BRONX,HN-D004,323,150,0,0,0,173,0,0,323,150,0,0,0,173,0,0,323,300,0,0,0,346,0,0,646,PROJECT DELAYED DUE TO CHANGES IN SCOPE/DESIGN,,ROOF REPLACEMENT,cpd11-20bx.pdf
HS033-007,Natural Science Lab Renovation,042,CITY UNIVERSITY,MISCELLANEOUS RECONSTRUCTION,200 201,BRONX,HN-X002,2000,0,0,0,0,0,2000,0,2000,0,0,0,0,0,2000,0,2000,0,0,0,0,0,4000,0,4000,PROJECT DELAYED DUE TO BUDGETARY CONSTRAINTS,,NATURAL SCIENCE LAB RENOVATION,cpd11-20bx.pdf
HS034-007,450 Grand Concourse Theater Improvements,042,CITY UNIVERSITY,MISCELLANEOUS RECONSTRUCTION,200,BRONX,HN-D004,250,0,0,0,0,250,0,0,250,0,0,0,0,250,0,0,250,0,0,0,0,500,0,0,500,PROJECT DELAYED DUE TO CHANGES IN SCOPE/DESIGN,,450 GRAND CONCOURSE THEATER IMPROVEMENTS,cpd11-20bx.pdf
HS041-011,500 Grand Concourse 4th Floor and Emerg. Generator,042,CITY UNIVERSITY,MISCELLANEOUS RECONSTRUCTION,200 201,BRONX,HN-X002 HN-0206,778,5808,0,0,0,38,0,0,5846,5808,0,0,0,38,0,0,5846,11616,0,0,0,76,0,0,11692,PROJECT DELAYED DUE TO CHANGES IN SCOPE/DESIGN,,EMERGENCY GENERATOR,cpd11-20bx.pdf
HS043-011,Hostos CC - 500 Grand Concourse Renovations,042,CITY UNIVERSITY,MISCELLANEOUS RECONSTRUCTION,200 201,BRONX,HN-0206,3970,0,0,0,0,0,535,0,535,0,0,0,0,0,535,0,535,0,0,0,0,0,1070,0,1070,PROJECT DELAYED DUE TO CHANGES IN SCOPE/DESIGN,,500 GRAND CONCOURSE RENOVATIONS,cpd11-20bx.pdf
HS045-012,500 Grand Concourse Renovations,042,CITY UNIVERSITY,MISCELLANEOUS RECONSTRUCTION,200 201,BRONX,HN-D002 HN-0206,3000,2580,0,344,0,0,75,0,2999,2580,0,344,0,0,75,0,2999,5160,0,688,0,0,150,0,5998,PROJECT DELAYED DUE TO CHANGES IN SCOPE/DESIGN,,THIRD FLOOR RENOVATIONS AT 500 GRAND CONCOURSE,cpd11-20bx.pdf
HS047-013,Savoy Building Roof Replacement,042,CITY UNIVERSITY,MISCELLANEOUS RECONSTRUCTION,200 201,BRONX,HN-D002,600,900,0,0,0,50,0,0,950,900,0,0,0,50,0,0,950,1800,0,0,0,100,0,0,1900,PROJECT DELAYED DUE TO CHANGES IN SCOPE/DESIGN,,SAVOY BLDG. ROOF REPLACEMENT,cpd11-20bx.pdf
HS048-013,Renovation and HVAC Upgrade,042,CITY UNIVERSITY,MISCELLANEOUS RECONSTRUCTION,200 201,BRONX,HN-D002,200,2623,0,77,0,0,0,0,2700,2623,0,77,0,0,0,0,2700,5246,0,154,0,0,0,0,5400,PROJECT DELAYED DUE TO CHANGES IN SCOPE/DESIGN,,RENOVATION AND HVAC UPGRADE,cpd11-20bx.pdf
HS050-014,Allied Health and Sciences Building,042,CITY UNIVERSITY,MISCELLANEOUS RECONSTRUCTION,200 201,BRONX,HN-D005,2500,0,0,0,0,2500,0,0,2500,0,0,0,0,2500,0,0,2500,0,0,0,0,5000,0,0,5000,PROJECT DELAYED DUE TO CHANGES IN SCOPE/DESIGN,,ALLIED HEALTH AND SCIENCES BUILDING,cpd11-20bx.pdf
HS054-017,Create one Stop Center,042,CITY UNIVERSITY,MISCELLANEOUS RECONSTRUCTION,200,BRONX,HN-D002 HN-X002,3850,0,0,0,3000,850,0,0,3850,0,0,0,3000,850,0,0,3850,0,0,0,6000,1700,0,0,7700,PROJECT DELAYED DUE TO CHANGES IN SCOPE/DESIGN,,CREATE ONE STOP CENTER,cpd11-20bx.pdf
HS055-018,Lighting Electrical Upgrade,042,CITY UNIVERSITY,MISCELLANEOUS RECONSTRUCTION,205,BRONX,HN-X002,375,0,0,375,0,0,0,0,375,0,0,375,0,0,0,0,375,0,0,750,0,0,0,0,750,PROJECT DELAYED DUE TO CHANGES IN SCOPE/DESIGN,,LIGHTING ELECTRICAL UPGRADE,cpd11-20bx.pdf
HS057-019,Smart Classroom Conversion,042,CITY UNIVERSITY,MISCELLANEOUS RECONSTRUCTION,200,BRONX,HN-X002 HN-D002,1500,0,0,0,0,1500,0,0,1500,0,0,0,0,1500,0,0,1500,0,0,0,0,3000,0,0,3000,PROJECT DELAYED DUE TO CHANGES IN SCOPE/DESIGN,,SMART CLASSROOM CONVERSION,cpd11-20bx.pdf
HS058-019,Basement Renovations at 500 Grand Concourse,042,CITY UNIVERSITY,MISCELLANEOUS RECONSTRUCTION,200,BRONX,HN-D002,2000,0,0,0,0,2000,0,0,2000,0,0,0,0,2000,0,0,2000,0,0,0,0,4000,0,0,4000,PROJECT DELAYED DUE TO CHANGES IN SCOPE/DESIGN,,BASEMENT RENOVATIONS AT 500 GRAND CONCOURSE,cpd11-20bx.pdf
HS058-020,2nd Floor & Basement Renovation/Final Phase (500 GC),042,CITY UNIVERSITY,MISCELLANEOUS RECONSTRUCTION,205,BRONX,HN-D002 HN-X002,2500,0,0,0,0,1500,1000,0,2500,0,0,0,0,1500,1000,0,2500,0,0,0,0,3000,2000,0,5000,PROJECT DELAYED DUE TO CHANGES IN SCOPE/DESIGN,,2ND FLOOR & BASEMENT RENOVATION/FINAL PHASE,cpd11-20bx.pdf
HS059-021,Video Pojection,042,CITY UNIVERSITY,DATA PROCESSING AND OTHER EQUIPMENT,200,BRONX,HN-X002,500,0,500,0,0,0,0,0,500,0,500,0,0,0,0,0,500,0,1000,0,0,0,0,0,1000,,,,cpd11-20bx.pdf
LM002-021,Teaching and Learning Innovation Space - Art,042,CITY UNIVERSITY,MISCELLANEOUS RECONSTRUCTION,200,BRONX,HN-D300,950,0,0,950,0,0,0,0,950,0,0,950,0,0,0,0,950,0,0,1900,0,0,0,0,1900,,,TEACHING AND LEARNING COMMONS,cpd11-20bx.pdf
LM019-011,Concert Hall Lighting Upgrade / Acoustics Upgrade,042,CITY UNIVERSITY,MISCELLANEOUS RECONSTRUCTION,200 207,BRONX,HN-X005,850,810,0,0,0,0,39,0,849,810,0,0,0,0,39,0,849,1620,0,0,0,0,78,0,1698,PROJECT DELAYED DUE TO UNAVAILABILITY OF PRODUCT,,LOCKER ROOM LOCKER REPLACEMENT,cpd11-20bx.pdf
LM021-012,Teaching and Learning Commons,042,CITY UNIVERSITY,MISCELLANEOUS RECONSTRUCTION,200,BRONX,HN-X300,1300,1300,0,0,1000,0,0,0,2300,1300,0,0,1000,0,0,0,2300,2600,0,0,2000,0,0,0,4600,PROJECT DELAYED DUE TO CHANGES IN SCOPE/DESIGN,,TEACHING AND LEARNING COMMONS,cpd11-20bx.pdf
LM029016,Upgrade and Convert Carman Hall,042,CITY UNIVERSITY,MISCELLANEOUS RECONSTRUCTION,207,BRONX,HN-X005,550,0,0,550,0,0,0,0,550,0,0,550,0,0,0,0,550,0,0,1100,0,0,0,0,1100,PROJECT DELAYED DUE TO CHANGES IN SCOPE/DESIGN,,UPGRADE AND CONVERT CARMAN HALL,cpd11-20bx.pdf
LM032-017,Gillet Auditorium Renovation,042,CITY UNIVERSITY,MISCELLANEOUS RECONSTRUCTION,200,BRONX,HN-D300,1700,0,0,1700,0,0,0,0,1700,0,0,1700,0,0,0,0,1700,0,0,3400,0,0,0,0,3400,PROJECT DELAYED DUE TO BUDGETARY CONSTRAINTS,,GILLET AUDITORIUM RENOVATION,cpd11-20bx.pdf
LM034-018,Convert classrooms into NetworkSmart Rooms,042,CITY UNIVERSITY,MISCELLANEOUS RECONSTRUCTION,,BRONX,HN-X300,368,0,0,0,368,0,0,0,368,0,0,0,368,0,0,0,368,0,0,0,736,0,0,0,736,PROJECT DELAYED DUE TO CHANGES IN SCOPE/DESIGN,,CONVERT CLASSROOMS INTO NETWORKSMART ROOMS,cpd11-20bx.pdf
LM035-018,Gillet Auditorium Renovation,042,CITY UNIVERSITY,MISCELLANEOUS RECONSTRUCTION,200,BRONX,HN-D300,1866,0,0,1866,0,0,0,0,1866,0,0,1866,0,0,0,0,1866,0,0,3732,0,0,0,0,3732,PROJECT DELAYED DUE TO BUDGETARY CONSTRAINTS,,GILLET AUDITORIUM RENOVATION,cpd11-20bx.pdf
LM041-020,Studio Theatre Lighting & Dimming System,042,CITY UNIVERSITY,MISCELLANEOUS RECONSTRUCTION,205,BRONX,HN-X300 HN-D300,700,0,0,700,0,0,0,0,700,0,0,700,0,0,0,0,700,0,0,1400,0,0,0,0,1400,,,STUDIO THEATRE LIGHTING & DIMMING SYSTEM,cpd11-20bx.pdf
LM042-020,"Nursing Facility Construction, Furniture and Equipment",042,CITY UNIVERSITY,MISCELLANEOUS RECONSTRUCTION,200,BRONX,HN-D300,3000,0,0,0,3000,0,0,0,3000,0,0,0,3000,0,0,0,3000,0,0,0,6000,0,0,0,6000,,,"NURSING FACILITY CONSTRUCTION, FURNITURE AND EQUIPMENT",cpd11-20bx.pdf
LM043-021,Social Work Deppartment Expansion,042,CITY UNIVERSITY,MISCELLANEOUS RECONSTRUCTION,200,BRONX,HN-X300 HN-D300,1050,0,0,1050,0,0,0,0,1050,0,0,1050,0,0,0,0,1050,0,0,2100,0,0,0,0,2100,,,SOCIAL WORK DEPPARTMENT EXPANSION,cpd11-20bx.pdf
PO79-52P,52ND PRECINCT RENOVATION,056,POLICE DEPARTMENT,POLICE FACILITIES,200,BRONX,PO-0079,20618,0,100,0,0,3400,17118,0,20618,0,100,0,0,3400,17118,0,20618,0,200,0,0,6800,34236,0,41236,,,ESTIMATE,cpd11-20bx.pdf
PO79BMAJX,46th PRECINCT ADA RAMP,056,POLICE DEPARTMENT,POLICE FACILITIES,200,BRONX,PO-0079,325,58,267,0,0,0,0,0,325,58,267,0,0,0,0,0,325,116,534,0,0,0,0,0,650,,,46TH ADA RAMP,cpd11-20bx.pdf
PO79BMAKD,RODMAN'S NECK BATHROOM TRAILERS,056,POLICE DEPARTMENT,POLICE FACILITIES,200,BRONX,PO-0079,116,0,116,0,0,0,0,0,116,0,116,0,0,0,0,0,116,0,232,0,0,0,0,0,232,,,ESTIAMTE,cpd11-20bx.pdf
PO79BMAKK,REHABILITATION OF 48TH PCT ELEVATOR,056,POLICE DEPARTMENT,POLICE FACILITIES,200,BRONX,PO-0079,1500,0,0,1500,0,0,0,0,1500,0,0,1500,0,0,0,0,1500,0,0,3000,0,0,0,0,3000,,,ESTIMATE,cpd11-20bx.pdf
PO79BMAKO,ROOF REPLACEMENT AT 49TH PCT,056,POLICE DEPARTMENT,POLICE FACILITIES,200,BRONX,PO-0079,2300,0,500,1800,0,0,0,0,2300,0,500,1800,0,0,0,0,2300,0,1000,3600,0,0,0,0,4600,,,ESTIMATE,cpd11-20bx.pdf
PO79BMAKU,49TH PCT ROOF REPLACEMENT,056,POLICE DEPARTMENT,POLICE FACILITIES,200,BRONX,PO-0079,560,0,560,0,0,0,0,0,560,0,560,0,0,0,0,0,560,0,1120,0,0,0,0,0,1120,,,ESTIMATE,cpd11-20bx.pdf
PO79BMAKV,41ST PCT ROOF REPLACEMENT,056,POLICE DEPARTMENT,POLICE FACILITIES,200,BRONX,PO-0079,800,0,0,0,0,800,0,0,800,0,0,0,0,800,0,0,800,0,0,0,0,1600,0,0,1600,,,ESTIMATE,cpd11-20bx.pdf
POD47RENO,Renovate/Upgrade 47th Precinct.,056,POLICE DEPARTMENT,POLICE FACILITIES,200,BRONX,PO-D079,1000,64,936,0,0,0,0,0,1000,64,936,0,0,0,0,0,1000,128,1872,0,0,0,0,0,2000,,,RENOVATION,cpd11-20bx.pdf
POD49PARK,49th Precinct Parking Lot Renovation Upgrade,056,POLICE DEPARTMENT,POLICE FACILITIES,200,BRONX,PO-D079,0,0,150,0,0,0,0,0,150,0,150,0,0,0,0,0,150,0,300,0,0,0,0,0,300,,,ESTIMATE,cpd11-20bx.pdf
POD49RENO,49TH PCT - RENOVATION,056,POLICE DEPARTMENT,POLICE FACILITIES,200 211,BRONX,PO-0079,250,566,85,0,0,0,0,0,651,566,85,0,0,0,0,0,651,1132,170,0,0,0,0,0,1302,PROJECT DELAYED DUE TO CHANGES IN SCOPE/DESIGN,"2121 EASTCHESTER ROAD, BRONX",RENOVATION,cpd11-20bx.pdf
POD50ELGE,50TH PCT REPLACE ELEVATORS AND GENERATORS,056,POLICE DEPARTMENT,POLICE FACILITIES,208,BRONX,PO-D001 PO-0079,325,60,600,0,0,0,0,0,660,60,600,0,0,0,0,0,660,120,1200,0,0,0,0,0,1320,PROJECT DELAYED DUE TO UNFORESEEN SITE/FIELD CONDITION,3450 KINGSBRIDGE AV. BRONX,DUE TO A FIRE IN THE ELEVATOR SHAFT IT BECAME NECESSARY TO PROCEED WITH THE ELEVATOR,cpd11-20bx.pdf
POD52PARK,52nd Precinct Parking Lot Renovation Upgrade,056,POLICE DEPARTMENT,POLICE FACILITIES,200,BRONX,PO-D079,425,0,425,0,0,0,0,0,425,0,425,0,0,0,0,0,425,0,850,0,0,0,0,0,850,,,ESTIMATE,cpd11-20bx.pdf
F175KIT42,KITCHEN REPLACEMENT - EC42,057,FIRE DEPARTMENT,NEW FACILITIES AND RENOVATIONS,205,BRONX,F-0175,961,179,0,0,1171,0,0,0,1350,179,0,0,1171,0,0,0,1350,358,0,0,2342,0,0,0,2700,PROJECT DELAYED DUE TO BUDGETARY CONSTRAINTS,,KITCHEN REPLACEMENT,cpd11-20bx.pdf
F175RFW20,Roof and Windows - EMS 20,057,FIRE DEPARTMENT,NEW FACILITIES AND RENOVATIONS,211,BRONX,F-0175,1430,24,0,1406,0,0,0,0,1430,24,0,1406,0,0,0,0,1430,48,0,2812,0,0,0,0,2860,,,ROOF AND WINDOWS - EMS 20,cpd11-20bx.pdf
F175XIN82,Exterior and Interior Renovations - EC 82,057,FIRE DEPARTMENT,NEW FACILITIES AND RENOVATIONS,203,BRONX,F-0175,4270,3144,4546,0,0,0,0,0,7690,3144,4546,0,0,0,0,0,7690,6288,9092,0,0,0,0,0,15380,PROJECT DELAYED DUE TO BUDGETARY CONSTRAINTS,,EXTERIOR AND INTERIOR RENOVATIONS - EC 82,cpd11-20bx.pdf
F1TELMPS2,PSACII Telemetry,057,FIRE DEPARTMENT,COMMUNICATIONS,211,BRONX,F-0001,6264,685,4174,0,0,0,0,0,4859,685,4174,0,0,0,0,0,4859,1370,8348,0,0,0,0,0,9718,,,,cpd11-20bx.pdf
FX175GE42,Generator - EC42,057,FIRE DEPARTMENT,NEW FACILITIES AND RENOVATIONS,,BRONX,F-0175 F-X175,375,89,759,0,0,0,0,0,848,89,759,0,0,0,0,0,848,178,1518,0,0,0,0,0,1696,,,GENERATOR REPLACEMENT AT EC42.,cpd11-20bx.pdf
FX175WN46,Window Replacement - EC46,057,FIRE DEPARTMENT,NEW FACILITIES AND RENOVATIONS,,BRONX,F-X175,375,0,375,0,0,0,0,0,375,0,375,0,0,0,0,0,375,0,750,0,0,0,0,0,750,,,WINDOW REPLACEMENT AT EC46.,cpd11-20bx.pdf
FX175WN48,Window Replacement EC48,057,FIRE DEPARTMENT,NEW FACILITIES AND RENOVATIONS,205,BRONX,F-X175,250,171,0,0,0,0,0,77,248,171,0,0,0,0,0,77,248,342,0,0,0,0,0,154,496,PROJECT DELAYED DUE TO BUDGETARY CONSTRAINTS,,WINDOW REPLACEMENT AT ENGINE COMPANY 48,cpd11-20bx.pdf
BEACH REP,Replacement Site for Beach Non-Secure Detention Site,068,ADMIN FOR CHILDREN'S SERVICES,SOCIAL SERVICE BUILDINGS,,BRONX,CS-0005,6000,0,6000,0,0,0,0,0,6000,0,6000,0,0,0,0,0,6000,0,12000,0,0,0,0,0,12000,PROJECT DELAYED DUE TO CHANGES IN SCOPE/DESIGN,,,cpd11-20bx.pdf
BXELEVFAR,1250 E229th Street Elevator and Fire Alarm Replacement,068,ADMIN FOR CHILDREN'S SERVICES,CHILD WELFARE FACILITIES,212,BRONX,CS-0005,358,0,358,0,0,0,0,0,358,0,358,0,0,0,0,0,358,0,716,0,0,0,0,0,716,PROJECT DELAYED DUE TO CHANGES IN SCOPE/DESIGN,,1250 E229TH STREET ELEVATOR AND FIRE ALARM REPLACEMENT.,cpd11-20bx.pdf
JJCONS,Adolescent Facility,068,ADMIN FOR CHILDREN'S SERVICES,CHILD WELFARE FACILITIES,201,BRONX,CS-0005,170000,0,5534,38968,26704,19077,16690,66757,173730,0,5534,38968,26704,19077,16690,66757,173730,0,11068,77936,53408,38154,33380,133514,347460,,TBD,TBD,cpd11-20bx.pdf
HH112FAFC,FRANKLIN'S WOMEN'S SHELTER - FACADE REHABILITATION,071,DEPT OF HOMELESS SERVICES,SHELTERS FOR HOMELESS INDIVIDUALS,203,BRONX,HH-0112,1693,0,0,135,0,1558,0,0,1693,0,0,135,0,1558,0,0,1693,0,0,270,0,3116,0,0,3386,,,FRANKLIN'S WOMEN'S SHELTER - FACADE REHABILITATION,cpd11-20bx.pdf
HH115JEXT,UNIVERSITY AVENUE FAMILY FACAD,071,DEPT OF HOMELESS SERVICES,SHELTERS FOR HOMELESS FAMILIES,,BRONX,HH-0112,3600,0,0,0,300,0,3300,0,3600,0,0,0,300,0,3300,0,3600,0,0,0,600,0,6600,0,7200,,,FACADE AND WINDOWS,cpd11-20bx.pdf
HH115NLBR,JAMAICA'S WOMENN'S SHELTER - BATHROOM RECONSTRUCTION,071,DEPT OF HOMELESS SERVICES,SHELTERS FOR HOMELESS FAMILIES,,BRONX,HH-0115,3562,0,0,281,0,3281,0,0,3562,0,0,281,0,3281,0,0,3562,0,0,562,0,6562,0,0,7124,,,JAMAICA WOMEN'S SHELTER - BATHROOM RECONSTRUCTION,cpd11-20bx.pdf
HH115SNRF,SENECA HOUSES - ROOF REPLACEMENT AND FACADE REHABILITATION,071,DEPT OF HOMELESS SERVICES,SHELTERS FOR HOMELESS FAMILIES,202,BRONX,HH-0115,730,58,0,0,672,0,0,0,730,58,0,0,672,0,0,0,730,116,0,0,1344,0,0,0,1460,,,SENECA HOUSES - ROOF REPLACEMENT AND FACADE REHABILITATION,cpd11-20bx.pdf
HH115UNBT,UNIVERSITY FAMILY KITCHEN BATHROOMS AND VENTILATION,071,DEPT OF HOMELESS SERVICES,SHELTERS FOR HOMELESS FAMILIES,204,BRONX,HH-0115,2130,0,0,0,330,0,1800,0,2130,0,0,0,330,0,1800,0,2130,0,0,0,660,0,3600,0,4260,,,RECONSTRUCT KITCHENS BATHROOMS AND ASSOCIATED INTERNAL VENTILATION,cpd11-20bx.pdf
HH115UNEU,UNIVERSITY FAMILY RESIDENCE ROOF REPLACEMENT,071,DEPT OF HOMELESS SERVICES,SHELTERS FOR HOMELESS FAMILIES,204,BRONX,HH-0115,1356,947,0,0,150,0,1200,0,2297,947,0,0,150,0,1200,0,2297,1894,0,0,300,0,2400,0,4594,PROJECT DELAYED DUE TO BUDGETARY CONSTRAINTS,,RESTORATION OF ROOF AND FACADE AT THE UNIVERSITY AVENUE FAMILY RESIDENCE,cpd11-20bx.pdf
HH115UNFL,UNIVERSITY AVENUE FOUNDATION RECONSTRUCTION,071,DEPT OF HOMELESS SERVICES,SHELTERS FOR HOMELESS FAMILIES,,BRONX,HH-0112,360,0,0,30,0,330,0,0,360,0,0,30,0,330,0,0,360,0,0,60,0,660,0,0,720,,,RECONSTRUCT BUILDING FOUNDATION,cpd11-20bx.pdf
HHNC001,NEW ERA VETERANS SRO- KITCHEN RENOVATION,071,DEPT OF HOMELESS SERVICES,SHELTERS FOR HOMELESS INDIVIDUALS,,BRONX,HH-D025,400,0,0,400,0,0,0,0,400,0,0,400,0,0,0,0,400,0,0,800,0,0,0,0,800,PROJECT DELAYED DUE TO CHANGES IN SCOPE/DESIGN,,NEW ERA VETERANS SRO- KITCHEN RENOVATION,cpd11-20bx.pdf
C-101WEST,RI WEST PERIMETER EXTERIOR FENCING REPLACEMENT,072,DEPARTMENT OF CORRECTION,BUILDING SYSTEMS AND INFRASTRUCTURE,200,BRONX,C-0075,11147,15578,0,1973,0,0,3000,0,20551,15578,0,1973,0,0,3000,0,20551,31156,0,3946,0,0,6000,0,41102,PROJECT DELAYED DUE TO BUDGETARY CONSTRAINTS,,REPLACE WEST PERIMETER FENCING,cpd11-20bx.pdf
C130PANEL,REPLACEMENT OF ELECTRICAL DISTRIBUTION PANELS- RI POWERHOUSE,072,DEPARTMENT OF CORRECTION,BUILDING SYSTEMS AND INFRASTRUCTURE,200,BRONX,C-0130,715,57,0,1332,0,0,0,0,1389,57,0,1332,0,0,0,0,1389,114,0,2664,0,0,0,0,2778,PROJECT DELAYED DUE TO BUDGETARY CONSTRAINTS,,REPLACEMENT OF ELECTRICAL DISTRIBUTION PANELS AT RI POWERHOUSE,cpd11-20bx.pdf
C138FEDER,NIC Power Feder Replacement,072,DEPARTMENT OF CORRECTION,BUILDING SYSTEMS AND INFRASTRUCTURE,200,BRONX,C-0138,1000,98,0,1593,0,0,0,0,1691,98,0,1593,0,0,0,0,1691,196,0,3186,0,0,0,0,3382,PROJECT DELAYED DUE TO BUDGETARY CONSTRAINTS,,NIC POWER FEEDER REPLACEMENT.,cpd11-20bx.pdf
C138FSPH2,Fire Life Safety Phase II,072,DEPARTMENT OF CORRECTION,BUILDING SYSTEMS AND INFRASTRUCTURE,200,BRONX,C-0138,80849,0,0,21355,0,31075,0,0,52430,0,0,21355,0,31075,0,0,52430,0,0,42710,0,62150,0,0,104860,PROJECT DELAYED DUE TO BUDGETARY CONSTRAINTS,,FIRE LIFE SAFETY PHASE II AT ALL DOC RIKERS AND BOROUGH FACILITIES,cpd11-20bx.pdf
C138FSYS,FIRE SAFETY SYSTEM CONSTRUCTION,072,DEPARTMENT OF CORRECTION,BUILDING SYSTEMS AND INFRASTRUCTURE,200,BRONX,C-0138,24000,25960,0,802,0,0,0,0,26762,25960,0,802,0,0,0,0,26762,51920,0,1604,0,0,0,0,53524,PROJECT DELAYED DUE TO BUDGETARY CONSTRAINTS,,FABRICATE AND INTEGRATE FIRE SAFETY SYSTEMS,cpd11-20bx.pdf
C138GRFS2,GRVC - Fire Life Safety Phase II,072,DEPARTMENT OF CORRECTION,BUILDING SYSTEMS AND INFRASTRUCTURE,200,BRONX,C-0138,20469,2568,54714,0,0,0,0,0,57282,2568,54714,0,0,0,0,0,57282,5136,109428,0,0,0,0,0,114564,,,GRVC FIRE LIFE SAFETY PHASE II,cpd11-20bx.pdf
C138NCFS2,Fire Life Safety Phase II for NIC Annex,072,DEPARTMENT OF CORRECTION,BUILDING SYSTEMS AND INFRASTRUCTURE,200,BRONX,C-0138,11872,750,31562,0,0,0,0,0,32312,750,31562,0,0,0,0,0,32312,1500,63124,0,0,0,0,0,64624,,,FIRE LIFE SAFETY PHASE II FOR NIC ANNEX,cpd11-20bx.pdf
C138PURGR,POST FIRE PURGE SYSTEM AT GRVC,072,DEPARTMENT OF CORRECTION,BUILDING SYSTEMS AND INFRASTRUCTURE,200,BRONX,C-0138,1800,234,0,1680,0,0,0,0,1914,234,0,1680,0,0,0,0,1914,468,0,3360,0,0,0,0,3828,PROJECT DELAYED DUE TO BUDGETARY CONSTRAINTS,,POST FORE PURGE SYSTEM FOR 200 AND 300 BED ADDITIONS GRVC,cpd11-20bx.pdf
C138PWRHS,DESIGN AND INSTALL FIRE ALARM SYSTEM AT EXISTING POWERHOUSE,072,DEPARTMENT OF CORRECTION,BUILDING SYSTEMS AND INFRASTRUCTURE,200,BRONX,C-0138,2240,250,0,6000,0,0,0,0,6250,250,0,6000,0,0,0,0,6250,500,0,12000,0,0,0,0,12500,PROJECT DELAYED DUE TO BUDGETARY CONSTRAINTS,,DESIGN AND INSTALL FIRE ALARM SYSTEM AT EXISTING POWERHOUSE,cpd11-20bx.pdf
C138RMFS2,RMSC - Fire Life Safety Phase II,072,DEPARTMENT OF CORRECTION,BUILDING SYSTEMS AND INFRASTRUCTURE,200,BRONX,C-0138,3570,200,11091,0,0,0,0,0,11291,200,11091,0,0,0,0,0,11291,400,22182,0,0,0,0,0,22582,,,AFTER COMPLETING THE FIRE ALARM SYSTEMS THE DEPARTMENT WILL NEED TO UPGRADE FIRE,cpd11-20bx.pdf
C138TRANS,DESIGN AND INSTALL FIRE ALARM SYSTEM AT TRANSPORTATION DIV,072,DEPARTMENT OF CORRECTION,BUILDING SYSTEMS AND INFRASTRUCTURE,,BRONX,C-0138,4380,262,0,4568,0,0,0,0,4830,262,0,4568,0,0,0,0,4830,524,0,9136,0,0,0,0,9660,PROJECT DELAYED DUE TO BUDGETARY CONSTRAINTS,,DESIGN AND INSTALL FIRE ALARM SYSTEM AT TRANSPORTATION DIVISION,cpd11-20bx.pdf
C75ADACOM,"ADA COMPLIANCE FOR NIC, CENTRAL VISITS, FACILITY VISIT AREAS",072,DEPARTMENT OF CORRECTION,BUILDING SYSTEMS AND INFRASTRUCTURE,200,BRONX,C-0075,33738,0,0,1280,0,0,0,0,1280,0,0,1280,0,0,0,0,1280,0,0,2560,0,0,0,0,2560,,,"ADA COMPLIANCE FOR NIC, CENTRAL VISITS, AND FACILITY VISIT AREAS",cpd11-20bx.pdf
C75ADACVT,ADA Compliance for Central Visits,072,DEPARTMENT OF CORRECTION,BUILDING SYSTEMS AND INFRASTRUCTURE,200,BRONX,C-0075,10326,861,8638,0,0,0,0,0,9499,861,8638,0,0,0,0,0,9499,1722,17276,0,0,0,0,0,18998,,,ADA COMPLIANCE FOR CENTRAL VISITS,cpd11-20bx.pdf
C75ADAGRV,ADA Compliance for GRVC,072,DEPARTMENT OF CORRECTION,BUILDING SYSTEMS AND INFRASTRUCTURE,200,BRONX,C-0075,5679,439,5821,0,0,0,0,0,6260,439,5821,0,0,0,0,0,6260,878,11642,0,0,0,0,0,12520,,,ADA COMPLIANCE FOR GRVC,cpd11-20bx.pdf
C75ADANIC,NIC SHOWER RECONSTRUCTION DORMS 3/4 TO COMPLY WITH ADA,072,DEPARTMENT OF CORRECTION,BUILDING SYSTEMS AND INFRASTRUCTURE,200,BRONX,C-0075,200,595,8232,0,0,0,0,0,8827,595,8232,0,0,0,0,0,8827,1190,16464,0,0,0,0,0,17654,PROJECT DELAYED DUE TO BUDGETARY CONSTRAINTS,,RECONSTRUCTION OF NIC DORMS 3 &4 TO ENSURE COMPLIANCE WITH THE AMERICANS WITH,cpd11-20bx.pdf
C75ADARMS,ADA Compliance for RMSC,072,DEPARTMENT OF CORRECTION,BUILDING SYSTEMS AND INFRASTRUCTURE,200,BRONX,C-0075,6352,377,6000,0,0,0,0,0,6377,377,6000,0,0,0,0,0,6377,754,12000,0,0,0,0,0,12754,,,ADA COMPLIANCE FOR RMSC,cpd11-20bx.pdf
C75ASBEST,Asbestos Abatement and Air Monitoring - Various Facilities,072,DEPARTMENT OF CORRECTION,BUILDING SYSTEMS AND INFRASTRUCTURE,,BRONX,C-0075,12210,8805,0,1464,0,978,1235,8197,20679,8805,0,1464,0,978,1235,8197,20679,17610,0,2928,0,1956,2470,16394,41358,PROJECT DELAYED DUE TO BUDGETARY CONSTRAINTS,,REMOVAL OF ASBESTOS CONTAINING MATERIALS.,cpd11-20bx.pdf
C75CELLD,Electronic Cell Door Panels at All Facilities,072,DEPARTMENT OF CORRECTION,BUILDING SYSTEMS AND INFRASTRUCTURE,,BRONX,C-0075,6900,0,0,0,0,0,0,6000,6000,0,0,0,0,0,0,6000,6000,0,0,0,0,0,0,12000,12000,,,ELECTRONIC CELL DOOR PANELS AT ALL FACILITIES TO FIX NON-OPERABLE DOORS,cpd11-20bx.pdf
C75-ELEV,ELEVATOR REHAB VARIOUS FACILITIES,072,DEPARTMENT OF CORRECTION,BUILDING SYSTEMS AND INFRASTRUCTURE,200,BRONX,C-0075,4556,3132,0,13500,0,0,0,0,16632,3132,0,13500,0,0,0,0,16632,6264,0,27000,0,0,0,0,33264,PROJECT DELAYED DUE TO BUDGETARY CONSTRAINTS,RIKERS ISLAND          BRONX,RECONSTRUCTION OF PASSENGER/FREIGHT ELEVATOR SERVING 3 FLOORS IN THEADMINISTRATION,cpd11-20bx.pdf
C75ENTGRV,Modification of Facility Entrance-GRVC,072,DEPARTMENT OF CORRECTION,BUILDING SYSTEMS AND INFRASTRUCTURE,200,BRONX,C-0075,7946,570,8761,0,0,0,0,0,9331,570,8761,0,0,0,0,0,9331,1140,17522,0,0,0,0,0,18662,,,MODIFICATION OF FACILITY ENTRANCE-GRVC,cpd11-20bx.pdf
C75ENTNC,Modification for Facility Entries - NIC,072,DEPARTMENT OF CORRECTION,BUILDING SYSTEMS AND INFRASTRUCTURE,200,BRONX,C-0075,4131,376,5063,0,0,0,0,0,5439,376,5063,0,0,0,0,0,5439,752,10126,0,0,0,0,0,10878,,,MODIFICATION FOR FACILITY ENTRIES - NIC,cpd11-20bx.pdf
C75ENTRMS,Modification of Facility Entry at RMSC,072,DEPARTMENT OF CORRECTION,BUILDING SYSTEMS AND INFRASTRUCTURE,200,BRONX,C-0075,8070,481,8926,0,0,0,0,0,9407,481,8926,0,0,0,0,0,9407,962,17852,0,0,0,0,0,18814,,,MODIFICATION OF FACILITY ENTRIES - RMSC,cpd11-20bx.pdf
C75ESUCP,New ESU Compound at Rikers Island,072,DEPARTMENT OF CORRECTION,BUILDING SYSTEMS AND INFRASTRUCTURE,200,BRONX,C-0075,11952,2312,0,0,0,0,8743,0,11055,2312,0,0,0,0,8743,0,11055,4624,0,0,0,0,17486,0,22110,,,NEW ESU COMPOUND AT RIKERS ISLAND,cpd11-20bx.pdf
C75FENCE1,FENCING RECONSTRUCTION,072,DEPARTMENT OF CORRECTION,BUILDING SYSTEMS AND INFRASTRUCTURE,200,BRONX,C-0075,3311,11694,0,2002,2000,0,0,0,15696,11694,0,2002,2000,0,0,0,15696,23388,0,4004,4000,0,0,0,31392,PROJECT DELAYED DUE TO BUDGETARY CONSTRAINTS,,INTERIOR PERIMETER FENCE REPLACEMENT @ VAR. FAC.,cpd11-20bx.pdf
C75-GCELL,GANG CELL DOOR RELEASE,072,DEPARTMENT OF CORRECTION,BUILDING SYSTEMS AND INFRASTRUCTURE,201,BRONX,C-0075,4000,0,0,0,2000,0,0,0,2000,0,0,0,2000,0,0,0,2000,0,0,0,4000,0,0,0,4000,PROJECT DELAYED DUE TO UNFORESEEN SITE/FIELD CONDITION,,RECONSTRUCT GANG DOORS NOT CURRENTLY SERVED BY ELECTRICAL RELEASE SYSTEMS,cpd11-20bx.pdf
C75GPARK,Construction of Parking Lot for GMDC Academy,072,DEPARTMENT OF CORRECTION,BUILDING SYSTEMS AND INFRASTRUCTURE,200,BRONX,C-0075,1250,0,0,0,0,0,1000,0,1000,0,0,0,0,0,1000,0,1000,0,0,0,0,0,2000,0,2000,,,CONSTRUCTION OF PARKING LOT FOR GMDC ACADEMY,cpd11-20bx.pdf
C75GRVCHV,GRVC HVAC Upgrades and Related Housing Area Renovations,072,DEPARTMENT OF CORRECTION,BUILDING SYSTEMS AND INFRASTRUCTURE,200,BRONX,C-0075,16717,1026,21648,0,0,0,0,0,22674,1026,21648,0,0,0,0,0,22674,2052,43296,0,0,0,0,0,45348,PROJECT DELAYED DUE TO BUDGETARY CONSTRAINTS,,"GRVC (GROUP A) HEATING, VENTILATION AND RELATED SYSTEM COMPONENTS AT ALL DOC FACILITIES",cpd11-20bx.pdf
C75GRVRFW,"GRVC Roof Replacement, Exterior Facades, Windows, Court Yard",072,DEPARTMENT OF CORRECTION,BUILDING SYSTEMS AND INFRASTRUCTURE,200,BRONX,C-0075,10800,917,0,16000,0,0,0,0,16917,917,0,16000,0,0,0,0,16917,1834,0,32000,0,0,0,0,33834,,,ALL OF THE DOC FACILITIES ARE 25+ YEARS OLD AND EXTERIOR ENVELOPE SHOWS SIGN OF,cpd11-20bx.pdf
C75K9UNIT,New K 9 Facility at Rikers Island,072,DEPARTMENT OF CORRECTION,SUPPORT SPACE,200,BRONX,C-0075,3650,3831,3542,0,0,0,0,0,7373,3831,3542,0,0,0,0,0,7373,7662,7084,0,0,0,0,0,14746,PROJECT DELAYED DUE TO BUDGETARY CONSTRAINTS,,CONSTRUCT NEW K9 UNIT WITH REQUIRED OFFICES AND SUPPOTY SPACES.,cpd11-20bx.pdf
C75MARINA,Rehabilitation of Existing Marina on RI,072,DEPARTMENT OF CORRECTION,BUILDING SYSTEMS AND INFRASTRUCTURE,200,BRONX,C-0075,4026,0,0,4200,0,0,0,0,4200,0,0,4200,0,0,0,0,4200,0,0,8400,0,0,0,0,8400,,,REHABILITATION OF MARINA,cpd11-20bx.pdf
C75-METH,Methane Detection System Replacement and Central Monitoring,072,DEPARTMENT OF CORRECTION,BUILDING SYSTEMS AND INFRASTRUCTURE,200,BRONX,C-0075,6197,1270,0,18731,0,0,0,0,20001,1270,0,18731,0,0,0,0,20001,2540,0,37462,0,0,0,0,40002,PROJECT DELAYED DUE TO BUDGETARY CONSTRAINTS,,METHANE SYSTEM REPLACEMENT AND CENTRAL MONITORING,cpd11-20bx.pdf
C75NICA/C,NIC Air Conditioning -Benjamin Ventilation Order,072,DEPARTMENT OF CORRECTION,BUILDING SYSTEMS AND INFRASTRUCTURE,200,BRONX,C-0075,5300,8245,0,346,0,0,0,0,8591,8245,0,346,0,0,0,0,8591,16490,0,692,0,0,0,0,17182,PROJECT DELAYED DUE TO UNFORESEEN SITE/FIELD CONDITION,,NIC REQUIRES AIR CONDITIONING,cpd11-20bx.pdf
C75NICADA,NIC Annex Shower-2010 ADA Compliance-Dorm 1& 2B,072,DEPARTMENT OF CORRECTION,BUILDING SYSTEMS AND INFRASTRUCTURE,200,BRONX,C-0075,960,155,1821,0,0,0,0,0,1976,155,1821,0,0,0,0,0,1976,310,3642,0,0,0,0,0,3952,PROJECT DELAYED DUE TO BUDGETARY CONSTRAINTS,,NIC ANNEX SHOWER-2010 ADA COMPLIANCE-DORM 1& 2B,cpd11-20bx.pdf
C75NICFAC,ROOF & FACADE RECONSTRUCTION FOR MAIN AND ANNEX,072,DEPARTMENT OF CORRECTION,BUILDING SYSTEMS AND INFRASTRUCTURE,201,BRONX,C-0075,6248,7903,0,2400,0,0,0,0,10303,7903,0,2400,0,0,0,0,10303,15806,0,4800,0,0,0,0,20606,PROJECT DELAYED DUE TO BUDGETARY CONSTRAINTS,,ROOF & FACADE RESTORATIONS FOR MAIN AND ANNEX,cpd11-20bx.pdf
C75OBDISH,OBCC Installation of Dishwasher,072,DEPARTMENT OF CORRECTION,EQUIPMENT,,BRONX,C-0075,2092,1852,0,175,0,0,0,0,2027,1852,0,175,0,0,0,0,2027,3704,0,350,0,0,0,0,4054,,,OBCC INSTALLATION OF DISHWASHER,cpd11-20bx.pdf
C75PTREAT,Water Treatment for Powerhouse,072,DEPARTMENT OF CORRECTION,BUILDING SYSTEMS AND INFRASTRUCTURE,200,BRONX,C-0075,8203,478,0,12800,0,0,0,0,13278,478,0,12800,0,0,0,0,13278,956,0,25600,0,0,0,0,26556,,,WATER TREATMENT FOR POWERHOUSE,cpd11-20bx.pdf
C75RDSRNG,New Modular Trailers and Classroom Renovation- Rodman's Neck,072,DEPARTMENT OF CORRECTION,BUILDING SYSTEMS AND INFRASTRUCTURE,200,BRONX,C-0075,3116,7747,6063,2000,0,0,0,0,15810,7747,6063,2000,0,0,0,0,15810,15494,12126,4000,0,0,0,0,31620,,,NEW MODULAR TRAILERS AND CLASSROOM RENOVATION,cpd11-20bx.pdf
C75RMPWR,"RMSC Power Upgrades for buildings 1,2,3,4,5,6 & 7",072,DEPARTMENT OF CORRECTION,BUILDING SYSTEMS AND INFRASTRUCTURE,200,BRONX,C-0075,10220,555,18817,0,0,0,0,0,19372,555,18817,0,0,0,0,0,19372,1110,37634,0,0,0,0,0,38744,,,"RMSC POWER UPGRADES FOR BUILDINGS 1,2,3,4,5,6 & 7",cpd11-20bx.pdf
C75RMS-AC,"RMSC A/C Power Upgrades for Bldgs 1,2,3,4,5,6 and 7",072,DEPARTMENT OF CORRECTION,BUILDING SYSTEMS AND INFRASTRUCTURE,200,BRONX,C-0075,23750,1002,22859,0,0,0,0,0,23861,1002,22859,0,0,0,0,0,23861,2004,45718,0,0,0,0,0,47722,,,"A/C AND POWER UPGRADES FOR BUILDINGS 1,2,3,4,5,6 AND 7",cpd11-20bx.pdf
C75RMSCHV,"RMSC AHU,Duct Work,Heating,Ventilation & Cooling Equipment",072,DEPARTMENT OF CORRECTION,BUILDING SYSTEMS AND INFRASTRUCTURE,200,BRONX,C-0075,12336,688,13622,0,0,0,0,0,14310,688,13622,0,0,0,0,0,14310,1376,27244,0,0,0,0,0,28620,,,"RMSC (GROUP A) HEATING, VENTILATION AND RELATED SYSTEM COMPONENTS AT ALL DOC FACILITIES",cpd11-20bx.pdf
C75RMSRFW,"RMSC Roof Replacement, Exterior Facades, Windows, Court Yard",072,DEPARTMENT OF CORRECTION,BUILDING SYSTEMS AND INFRASTRUCTURE,200,BRONX,C-0075,13090,897,0,25688,0,0,0,0,26585,897,0,25688,0,0,0,0,26585,1794,0,51376,0,0,0,0,53170,,,ALL OF THE DOC FACILITIES ARE 25+ YEARS OLD AND EXTERIOR ENVELOPE SHOWS SIGN OF,cpd11-20bx.pdf
C75SEAWLL,Construction of Sea Wall and Raising of Madanici Road,072,DEPARTMENT OF CORRECTION,BUILDING SYSTEMS AND INFRASTRUCTURE,200,BRONX,C-0075,7017,650,0,0,0,0,5850,0,6500,650,0,0,0,0,5850,0,6500,1300,0,0,0,0,11700,0,13000,PROJECT DELAYED DUE TO BUDGETARY CONSTRAINTS,,THE RAISING OF MANDANICI ROAD IS REQUIRED AS THE ROAD OFTEN GETS FLOODED DURING,cpd11-20bx.pdf
C75STDRN,Replace Storm Water Mains and Outfalls,072,DEPARTMENT OF CORRECTION,BUILDING SYSTEMS AND INFRASTRUCTURE,200,BRONX,C-0075,6000,0,0,0,5000,0,0,0,5000,0,0,0,5000,0,0,0,5000,0,0,0,10000,0,0,0,10000,,,"REPLACE STORM WATER DRAINS ,MAINS AND OUTFALLS AT RIKERS ISLAND.",cpd11-20bx.pdf
C75STEAM,Upgrade Steam Lines,072,DEPARTMENT OF CORRECTION,BUILDING SYSTEMS AND INFRASTRUCTURE,200,BRONX,C-0075,6000,467,0,9644,0,0,0,0,10111,467,0,9644,0,0,0,0,10111,934,0,19288,0,0,0,0,20222,PROJECT DELAYED DUE TO BUDGETARY CONSTRAINTS,,STEAM LINES UPGRADE.,cpd11-20bx.pdf
C75SUPFC,Exterior Reconstruction for Support Facilities,072,DEPARTMENT OF CORRECTION,BUILDING SYSTEMS AND INFRASTRUCTURE,200,BRONX,C-0075,5800,0,0,0,0,0,0,2000,2000,0,0,0,0,0,0,2000,2000,0,0,0,0,0,0,4000,4000,PROJECT DELAYED DUE TO BUDGETARY CONSTRAINTS,,ALL SUPPORT FACILITIES ARE 25 + YEARS OLD AND HAVE SIGNIFICANT DETERIORATION TO THE,cpd11-20bx.pdf
C75SWITCH,REPLACEMENT OF ELECTRICAL AUTOMATIC TRANSFER SWITCHES,072,DEPARTMENT OF CORRECTION,BUILDING SYSTEMS AND INFRASTRUCTURE,200,BRONX,C-0075,6600,383,0,6147,0,0,0,0,6530,383,0,6147,0,0,0,0,6530,766,0,12294,0,0,0,0,13060,PROJECT DELAYED DUE TO BUDGETARY CONSTRAINTS,,REPLACEMENT OF ELECTRICAL AUTOMATIC TRANSFER SWITCHES,cpd11-20bx.pdf
C75TMTRLR,Design and Installation of new Teams Modular Building,072,DEPARTMENT OF CORRECTION,SUPPORT SPACE,200,BRONX,C-0075,6532,429,280,0,0,0,7795,0,8504,429,280,0,0,0,7795,0,8504,858,560,0,0,0,15590,0,17008,,,DESIGN AND CONSTRUCTION WORK FOR NEW TEAMS MEETING MODULAR BUILDINGS AT RIKERS,cpd11-20bx.pdf
C75VLAUND,VCBC Laundry System Installation,072,DEPARTMENT OF CORRECTION,BUILDING SYSTEMS AND INFRASTRUCTURE,200,BRONX,C-0075,400,1630,0,281,0,0,0,0,1911,1630,0,281,0,0,0,0,1911,3260,0,562,0,0,0,0,3822,PROJECT DELAYED DUE TO BUDGETARY CONSTRAINTS,,VCBC LAUNDRY SYSTEM INSTALLATION,cpd11-20bx.pdf
SANDAMKC,Hurricane Sandy - AMKC Roof Reconstruction,072,DEPARTMENT OF CORRECTION,BUILDING SYSTEMS AND INFRASTRUCTURE,200,BRONX,C-0075,2375,1641,3,0,0,0,0,0,1644,1641,3,0,0,0,0,0,1644,3282,6,0,0,0,0,0,3288,PROJECT DELAYED DUE TO BUDGETARY CONSTRAINTS,,ROOF RECONSTRUCTION AT AMKC REQUIRED DUE TO DAMAGE FROM HURRICANE SANDY. ROOF,cpd11-20bx.pdf
SANDCONDT,Hurricane Sandy Underground Conduits at VCBC,072,DEPARTMENT OF CORRECTION,BUILDING SYSTEMS AND INFRASTRUCTURE,,BRONX,C-0075,14596,0,1219,0,0,0,0,0,1219,0,1219,0,0,0,0,0,1219,0,2438,0,0,0,0,0,2438,PROJECT DELAYED DUE TO BUDGETARY CONSTRAINTS,,HURRICANE SANDY UNDERGROUND CONDUITS AT VCBC,cpd11-20bx.pdf
SANDHART,Hurricane Sandy-harts island Reconstruct from storm damage,072,DEPARTMENT OF CORRECTION,BUILDING SYSTEMS AND INFRASTRUCTURE,200,BRONX,C-0075,8749,1033,701,0,0,0,0,0,1734,1033,701,0,0,0,0,0,1734,2066,1402,0,0,0,0,0,3468,PROJECT DELAYED DUE TO BUDGETARY CONSTRAINTS,,HURRICANE SANDY-HARTS ISLAND RECONSTRUCT FROM STORM DAMAGE,cpd11-20bx.pdf
SANDRNDC,Hurricane Sandy - RNDC Roof Reconstruction,072,DEPARTMENT OF CORRECTION,BUILDING SYSTEMS AND INFRASTRUCTURE,200,BRONX,C-0075,11396,374,0,0,0,0,0,0,374,374,0,0,0,0,0,0,374,748,0,0,0,0,0,0,748,PROJECT DELAYED DUE TO BUDGETARY CONSTRAINTS,,FUNDING IS REQUIRED TO REPLACE TWO AREAS OF THE ROOF OF RNDC BUILDINGDAMAGED BY,cpd11-20bx.pdf
SANDSHORE,Hurricane Sandy- RI NShoreline Reconstruct from Storm Damage,072,DEPARTMENT OF CORRECTION,BUILDING SYSTEMS AND INFRASTRUCTURE,200,BRONX,C-0075,33492,4074,1268,0,0,0,0,0,5342,4074,1268,0,0,0,0,0,5342,8148,2536,0,0,0,0,0,10684,PROJECT DELAYED DUE TO BUDGETARY CONSTRAINTS,,RECONSTRUCTION OF RI NORTH SHORELINE DUE TO EXTENSIVE DAMAGE FROM HURRICANE SANDY.,cpd11-20bx.pdf
SANDTRLR,Hurricane Sandy-Relocation of RI Trailers - Storm Damage,072,DEPARTMENT OF CORRECTION,SUPPORT SPACE,200,BRONX,C-0075,43579,1380,27,0,0,0,0,0,1407,1380,27,0,0,0,0,0,1407,2760,54,0,0,0,0,0,2814,PROJECT DELAYED DUE TO BUDGETARY CONSTRAINTS,,THE RI TRAILERS HAVE BEEN EXTENSIVELY DAMAGED DUE TO HURRICANE SANDY AND NEED TO BE,cpd11-20bx.pdf
SANDVCBC,Hurricane Sandy - VCBC Reconstruction Due To Storm Damage,072,DEPARTMENT OF CORRECTION,BUILDING SYSTEMS AND INFRASTRUCTURE,200,BRONX,C-0075,2940,69,264,0,0,0,0,0,333,69,264,0,0,0,0,0,333,138,528,0,0,0,0,0,666,PROJECT DELAYED DUE TO BUDGETARY CONSTRAINTS,,ENGINEERING ASSESMENT DESIGN AND RECONSTRUCTION AREAS DAMAGED AT VCBCINCLUDING,cpd11-20bx.pdf
HR25305RC,305 Rider Avenue construction,096,HUMAN RESOURCES ADMINISTRATION,SOCIAL SERVICES BUILDINGS,,BRONX,HR-0025,2368,0,0,515,1046,0,0,0,1561,0,0,515,1046,0,0,0,1561,0,0,1030,2092,0,0,0,3122,,,,cpd11-20bx.pdf
HR25TREMC,555 E Tremont Construction,096,HUMAN RESOURCES ADMINISTRATION,SOCIAL SERVICES BUILDINGS,,BRONX,HR-0025,824,0,0,362,181,0,0,0,543,0,0,362,181,0,0,0,543,0,0,724,362,0,0,0,1086,,,,cpd11-20bx.pdf
AGERMACAV,ERMA -CAVA Senior Center HVAC Upgrade,125,DEPARTMENT FOR THE AGING,DEPARTMENT FOR THE AGING BUILDING RECONSTRUCTION,202,BRONX,AG-D001,0,0,0,0,100,0,0,0,100,0,0,0,100,0,0,0,100,0,0,0,200,0,0,0,200,,,SEPT 18 PLAN 100K HVAC SYSTEM UPGRADE ERMA -CAVA SENIOR CENTER HVAC UPGRADE,cpd11-20bx.pdf
AGHOGAR,HOGAR SENIOR CENTER--HOGAR SENIOR CENTER RENOVATIONS,125,DEPARTMENT FOR THE AGING,LOW TO MODERATE INCOME PUBLIC HOUSING UPGRADE,209,BRONX,AG-D001,0,0,0,0,500,0,0,0,500,0,0,0,500,0,0,0,500,0,0,0,1000,0,0,0,1000,,,SENIOR CENTER RENOVATIONS,cpd11-20bx.pdf
ACEDCA433,DCLA,126,DEPARTMENT OF CULTURAL AFFAIRS,"BUILDING CONSTRUCTION, RECONSTRUCTION OR RETROFIT",207,BRONX,PU-0025,688,0,0,688,0,0,0,0,688,0,0,688,0,0,0,0,688,0,0,1376,0,0,0,0,1376,PROJECT DELAYED DUE TO CHANGES IN SCOPE/DESIGN,,ROOF REPLACEMENT FOR THE AQUATIC BIRD HOUSE BUILDING AT THE BRONX ZOO. NEW ROOF WILL,cpd11-20bx.pdf
PV176-BLR,WCS Bronx Zoo - Boiler Replacement Various Bldgs.,126,DEPARTMENT OF CULTURAL AFFAIRS,ESSENTIAL RECONSTRUCTION OF FACILITIES,206,BRONX,PV-0176 PV-D176,5500,0,0,0,3146,0,0,0,3146,0,0,0,3146,0,0,0,3146,0,0,0,6292,0,0,0,6292,PROJECT DELAYED DUE TO BUDGETARY CONSTRAINTS,"BX ZOO 2300 SOUTHERN BLVD., BRONX NY",REPLACEMENT OF BOILERS IN ZOO BUILDINGS.,cpd11-20bx.pdf
PV176CES2,WCS - Bronx Zoo - Switch Gear Phase 2,126,DEPARTMENT OF CULTURAL AFFAIRS,ESSENTIAL RECONSTRUCTION OF FACILITIES,206 207 211,BRONX,PV-0176 PV-D176,3320,0,0,0,3009,0,0,0,3009,0,0,0,3009,0,0,0,3009,0,0,0,6018,0,0,0,6018,,,CONSTRUCTION,cpd11-20bx.pdf
PV176GELA,WCS - Bronx Zoo - Gelada Exhibit,126,DEPARTMENT OF CULTURAL AFFAIRS,ESSENTIAL RECONSTRUCTION OF FACILITIES,206,BRONX,PV-X176 PV-D176,1500,0,0,0,0,1500,0,0,1500,0,0,0,0,1500,0,0,1500,0,0,0,0,3000,0,0,3000,PROJECT DELAYED DUE TO CHANGES IN SCOPE/DESIGN,,GELADA PROPAGATION ANNEX TO HOUSE A NEW GROUP FO GELADA BABOONS,cpd11-20bx.pdf
PV176-REP,WCS - Bronx Zoo - Reptile House Facade Restoration,126,DEPARTMENT OF CULTURAL AFFAIRS,ESSENTIAL RECONSTRUCTION OF FACILITIES,206,BRONX,PV-X176 PV-D176,1872,0,0,0,0,1575,300,0,1875,0,0,0,0,1575,300,0,1875,0,0,0,0,3150,600,0,3750,PROJECT DELAYED DUE TO CHANGES IN SCOPE/DESIGN,,WCS - BRONX ZOO,cpd11-20bx.pdf
PV176WILD,WCS - Bronx Zoo - Wildlife Exhibit Center,126,DEPARTMENT OF CULTURAL AFFAIRS,ESSENTIAL RECONSTRUCTION OF FACILITIES,,BRONX,PV-D176 PV-X176,5300,0,0,0,0,10100,500,0,10600,0,0,0,0,10100,500,0,10600,0,0,0,0,20200,1000,0,21200,,,WCS BRONX ZOO - WILDLIFE EXHIBIT CENTER,cpd11-20bx.pdf
PV205GLIB,NYBG - Green Library/Energy Reduction Project,126,DEPARTMENT OF CULTURAL AFFAIRS,ESSENTIAL RECONSTRUCTION OF FACILITIES,,BRONX,PV-D205,0,0,0,0,0,1000,0,0,1000,0,0,0,0,1000,0,0,1000,0,0,0,0,2000,0,0,2000,,2900 SOUTHERN BLVD. BRONX NY,"LIBARY GREEN BUILDING IMPROVEMENTS; HVAC, ROOF",cpd11-20bx.pdf
PV205WOC,NYBG - Worker's Operation Center Renovation,126,DEPARTMENT OF CULTURAL AFFAIRS,ESSENTIAL RECONSTRUCTION OF FACILITIES,206,BRONX,PV-D205 PV-0205,5820,0,0,0,0,5049,5320,0,10369,0,0,0,0,5049,5320,0,10369,0,0,0,0,10098,10640,0,20738,PROJECT DELAYED DUE TO BUDGETARY CONSTRAINTS,2300 SOUTHERN BLVD. BRONX NY,CREATION AND REVOVATION OF WORKERS OPERATION CENTER,cpd11-20bx.pdf
PV293-EXT,BCHS - Exterior/Interior Rehab and Tech Upgrade,126,DEPARTMENT OF CULTURAL AFFAIRS,ESSENTIAL RECONSTRUCTION OF FACILITIES,207,BRONX,PV-X293 PV-D467,198,0,0,0,0,198,0,0,198,0,0,0,0,198,0,0,198,0,0,0,0,396,0,0,396,,,BRONX COUNTY HISTORICAL SOCIETY  EXTERIOR/INTERIOR REHAB & TECHNOLOGY,cpd11-20bx.pdf
PV464GLYN,WH - Wave Hill - Glyndor Hse. Boiler/Armor Hall AHU,126,DEPARTMENT OF CULTURAL AFFAIRS,ESSENTIAL RECONSTRUCTION OF FACILITIES,,BRONX,PV-D464 PV-0464 PV-X464,987,0,0,0,0,1167,0,0,1167,0,0,0,0,1167,0,0,1167,0,0,0,0,2334,0,0,2334,PROJECT DELAYED DUE TO CHANGES IN SCOPE/DESIGN,"675 WEST 254TH STREET, BRONX, NY",BOILER REPLACEMENT,cpd11-20bx.pdf
PV464-PAV,WH - Wave Hill - Woodland Pavilion,126,DEPARTMENT OF CULTURAL AFFAIRS,ESSENTIAL RECONSTRUCTION OF FACILITIES,,BRONX,P-D021 PV-D464,1350,0,0,350,0,1000,0,0,1350,0,0,350,0,1000,0,0,1350,0,0,700,0,2000,0,0,2700,,,CONSTRUCTION OF WOODLAND PAVILION.,cpd11-20bx.pdf
PV464SITE,WH - Wave Hill - Sitewide Pathway Replacement,126,DEPARTMENT OF CULTURAL AFFAIRS,ESSENTIAL RECONSTRUCTION OF FACILITIES,208,BRONX,PV-D464 PV-0464,550,0,0,0,0,3199,0,0,3199,0,0,0,0,3199,0,0,3199,0,0,0,0,6398,0,0,6398,PROJECT DELAYED DUE TO CHANGES IN SCOPE/DESIGN,"675 WEST 252ND STREET. BRONX, NY",SITE WIDE PATHWAY REPLACEMENT,cpd11-20bx.pdf
AGDRAIN,FA - Rain Senior Center Renovation,801,DEPT OF SMALL BUSINESS SERVICES,DEPARTMENT FOR THE AGING BUILDING RECONSTRUCTION,212,BRONX,AG-D001,100,0,0,0,100,0,0,0,100,0,0,0,100,0,0,0,100,0,0,0,200,0,0,0,200,PROJECT DELAYED DUE TO CHANGES IN SCOPE/DESIGN,,RAIN SENIOR CENTER RENOVATION,cpd11-20bx.pdf
ALTFUELS,Hunts Point Alternative Fueling Station,801,DEPT OF SMALL BUSINESS SERVICES,MISCELLANEOUS,200,BRONX,ED-0075,1000,5449,0,0,0,0,0,551,6000,5449,0,0,0,0,0,551,6000,10898,0,0,0,0,0,1102,12000,PROJECT DELAYED DUE TO CHANGES IN SCOPE/DESIGN,,HUNTS POINT ALTERNATIVE FUELING STATION,cpd11-20bx.pdf
ARTHURAVE,ARTHUR AVENUE MARKET,801,DEPT OF SMALL BUSINESS SERVICES,MISCELLANEOUS,200,BRONX,ED-0408 ED-D408 ED-X075,1648,215,1379,0,0,0,0,54,1648,215,1379,0,0,0,0,54,1648,430,2758,0,0,0,0,108,3296,PROJECT DELAYED DUE TO CHANGES IN SCOPE/DESIGN,,ARTHUR AVENUE MARKET,cpd11-20bx.pdf
EDXHPGEN,Hunts Point Cooperative Market,801,DEPT OF SMALL BUSINESS SERVICES,MARKET DEVELOPMENT,200,BRONX,ED-D408,3450,2237,500,0,0,0,1712,0,4449,2237,500,0,0,0,1712,0,4449,4474,1000,0,0,0,3424,0,8898,PROJECT DELAYED DUE TO CHANGES IN SCOPE/DESIGN,,HUNTS POINT COOPERATIVE MARKET - TO PURCHASE TWO NEW GENERATORS,cpd11-20bx.pdf
FFMDRAIN,New Fulton Fish Market -- Facility Upgrades,801,DEPT OF SMALL BUSINESS SERVICES,MISCELLANEOUS,200,BRONX,ED-D408,600,0,600,0,0,0,0,0,600,0,600,0,0,0,0,0,600,0,1200,0,0,0,0,0,1200,,,NEW FULTON FISH MARKET -- FACILITY UPGRADES,cpd11-20bx.pdf
FREIGHTHP,Freight NYC - Hunts Point Marine Highway,801,DEPT OF SMALL BUSINESS SERVICES,PORT DEVELOPMENT,200,BRONX,ED-0404,25000,0,0,0,0,0,2500,22500,25000,0,0,0,0,0,2500,22500,25000,0,0,0,0,0,5000,45000,50000,PROJECT DELAYED DUE TO CHANGES IN SCOPE/DESIGN,,FREIGHT NYC - HUNTS POINT MARINE HIGHWAY - 100K JOBS,cpd11-20bx.pdf
GXHP07-02,GI - DSGN & CONS OF ROW BIOSWALES & GREENSTREETS IN HP-007,801,DEPT OF SMALL BUSINESS SERVICES,GREEN INFRASTRUCTURE PROGRAM,212,BRONX,WP-0169,23154,37555,7248,0,0,0,0,0,44803,37555,7248,0,0,0,0,0,44803,75110,14496,0,0,0,0,0,89606,PROJECT DELAYED DUE TO CHANGES IN SCOPE/DESIGN,,GI - DESIGN AND CONSTRUCTION OF RIGHTOF WAY BIOSWALES AND STORMAWATERGREENSTREETS,cpd11-20bx.pdf
GXHP14-01,GI - Green infrastructure in Westchester Creek HP-14,801,DEPT OF SMALL BUSINESS SERVICES,GREEN INFRASTRUCTURE PROGRAM,212,BRONX,WP-0169,41898,19466,7311,0,0,0,0,0,26777,19466,7311,0,0,0,0,0,26777,38932,14622,0,0,0,0,0,53554,PROJECT DELAYED DUE TO CHANGES IN SCOPE/DESIGN,,GI - GREEN INFRASTRUCTURE IN WESTCHESTER CREEK HP-14,cpd11-20bx.pdf
GXHP16-01,GI - Green infrastructure in Westchester Creek HP-12/HP-16,801,DEPT OF SMALL BUSINESS SERVICES,GREEN INFRASTRUCTURE PROGRAM,212,BRONX,WP-0169,12561,11723,838,0,0,0,0,0,12561,11723,838,0,0,0,0,0,12561,23446,1676,0,0,0,0,0,25122,PROJECT DELAYED DUE TO CHANGES IN SCOPE/DESIGN,,GI - GREEN INFRASTRUCTURE IN WESTCHESTER CREEK HP-12/HP-16,cpd11-20bx.pdf
HPBOILER,HUNTS POINT MEAT MARKET (EDC)--BOILER UPDATES,801,DEPT OF SMALL BUSINESS SERVICES,NEIGHBORHOOD REVITALIZATION,200,BRONX,ED-D408,1500,0,0,0,0,0,1500,0,1500,0,0,0,0,0,1500,0,1500,0,0,0,0,0,3000,0,3000,PROJECT DELAYED DUE TO CHANGES IN SCOPE/DESIGN,,HUNTS POINT MEAT MARKET (EDC)--BOILER UPDATES,cpd11-20bx.pdf
HPCMFRIDG,Hunts Point Cooperative Market (Efficient Refrigeration Comp,801,DEPT OF SMALL BUSINESS SERVICES,MISCELLANEOUS,200,BRONX,ED-D408,950,0,450,0,0,0,500,0,950,0,450,0,0,0,500,0,950,0,900,0,0,0,1000,0,1900,PROJECT DELAYED DUE TO CHANGES IN SCOPE/DESIGN,,HUNTS POINT COOPERATIVE MARKET (EFFICIENT REFRIGERATION COMPRESSOR) -,cpd11-20bx.pdf
HPMRKRAIL,Hunts Point Produce Market Raill Imp.,801,DEPT OF SMALL BUSINESS SERVICES,MARKET DEVELOPMENT,200,BRONX,ED-D075 ED-0075,12729,9073,0,0,6,0,0,467,9546,9073,0,0,6,0,0,467,9546,18146,0,0,12,0,0,934,19092,,,HUNTS RAIL,cpd11-20bx.pdf
HPRAILSBG,HUNTS POINT RAIL SPUR,801,DEPT OF SMALL BUSINESS SERVICES,NEIGHBORHOOD REVITALIZATION,200 202,BRONX,ED-0075,0,294,0,5,0,0,0,0,299,294,0,5,0,0,0,0,299,588,0,10,0,0,0,0,598,PROJECT DELAYED DUE TO CHANGES IN SCOPE/DESIGN,,HUNTS POINT RAIL SPUR,cpd11-20bx.pdf
HTPRODUC2,Hunts Point Market,801,DEPT OF SMALL BUSINESS SERVICES,MARKET DEVELOPMENT,202,BRONX,ED-X075 ED-D075,1500,0,1500,0,0,0,6183,0,7683,0,1500,0,0,0,6183,0,7683,0,3000,0,0,0,12366,0,15366,PROJECT DELAYED DUE TO CHANGES IN SCOPE/DESIGN,,HUNTS POINT MARKET,cpd11-20bx.pdf
HUNTMEAT2,Hunts Point Meat Market 2,801,DEPT OF SMALL BUSINESS SERVICES,MARKET DEVELOPMENT,200,BRONX,ED-0408,65000,11935,7554,31,9818,7894,0,0,37232,11935,7554,31,9818,7894,0,0,37232,23870,15108,62,19636,15788,0,0,74464,,,HUNTS POINT - MEAT MARKET. INFRASTRUCTURE REPAIRS,cpd11-20bx.pdf
HUNTSAOU2,Hunts Point AOU-2 and Building G Development,801,DEPT OF SMALL BUSINESS SERVICES,MARKET DEVELOPMENT,200,BRONX,ED-0408,6768,1807,0,0,0,4961,0,0,6768,1807,0,0,0,4961,0,0,6768,3614,0,0,0,9922,0,0,13536,PROJECT DELAYED DUE TO CHANGES IN SCOPE/DESIGN,,HUNTS POINT AOU-2 AND BUILDING G DEVELOPMENT,cpd11-20bx.pdf
HUNTSFISH,Hunts Point Fish Market,801,DEPT OF SMALL BUSINESS SERVICES,MARKET DEVELOPMENT,200,BRONX,ED-0408,10000,2853,0,1767,3000,2379,0,0,9999,2853,0,1767,3000,2379,0,0,9999,5706,0,3534,6000,4758,0,0,19998,,,HUNTS POINT - FISH MARKET,cpd11-20bx.pdf
HUNTSPROD,Hunts Point Produce Market,801,DEPT OF SMALL BUSINESS SERVICES,MARKET DEVELOPMENT,200,BRONX,ED-0408,30000,0,0,0,0,0,30000,0,30000,0,0,0,0,0,30000,0,30000,0,0,0,0,0,60000,0,60000,PROJECT DELAYED DUE TO CHANGES IN SCOPE/DESIGN,,"REDEVELOPMENT PROJECT WITHIN STRATEGIC PLAN FOR MODERNIZATION OF MARKET FACILITIES,",cpd11-20bx.pdf
HUNTSPTR2,Hunts Point Area Wide Improvements,801,DEPT OF SMALL BUSINESS SERVICES,MARKET DEVELOPMENT,200,BRONX,ED-0075,25000,0,0,0,0,0,0,23200,23200,0,0,0,0,0,0,23200,23200,0,0,0,0,0,0,46400,46400,PROJECT DELAYED DUE TO CHANGES IN SCOPE/DESIGN,,HUNTS POINT AREAWIDE IMPROVEMENTS,cpd11-20bx.pdf
HUNTSPTRR,Hunts Point Infrastructure Improvements,801,DEPT OF SMALL BUSINESS SERVICES,MARKET DEVELOPMENT,200,BRONX,ED-0408,15000,14705,0,0,0,0,0,295,15000,14705,0,0,0,0,0,295,15000,29410,0,0,0,0,0,590,30000,,,HUNTS POINT INFRASTRUCTURE IMPROVEMENTS,cpd11-20bx.pdf
HWXP2010,Hunts Point Signage and Streetscape Project,801,DEPT OF SMALL BUSINESS SERVICES,PRIMARY STREET RECONSTRUCTION,202,BRONX,ED-0075 ED-X384,5938,1589,0,54,0,0,0,0,1643,1589,0,54,0,0,0,0,1643,3178,0,108,0,0,0,0,3286,PROJECT DELAYED DUE TO CHANGES IN SCOPE/DESIGN,HUNTS POINT STREET ENHAMENT ON THE HILL BOROUGH BX,HUNTS POINT STREETSCAPE ENHACEMENT ON THE HILL BOROUGH BX,cpd11-20bx.pdf
LAFFAVELT,Laffayette Avenue Street Lighting,801,DEPT OF SMALL BUSINESS SERVICES,MISCELLANEOUS,200,BRONX,ED-0075,1800,939,861,0,0,0,0,0,1800,939,861,0,0,0,0,0,1800,1878,1722,0,0,0,0,0,3600,PROJECT DELAYED DUE TO CHANGES IN SCOPE/DESIGN,,LAFFAYETTE AVENUE STREET LIGHTING,cpd11-20bx.pdf
LNEA16HPT,HUNTS POINT,801,DEPT OF SMALL BUSINESS SERVICES,ESSENTIAL RECONSTRUCTION OF FACILITIES,200,BRONX,LN-0008 LN-D008,20000,0,18875,0,0,0,0,0,18875,0,18875,0,0,0,0,0,18875,0,37750,0,0,0,0,0,37750,PROJECT DELAYED DUE TO CHANGES IN SCOPE/DESIGN,,HUNTS POINT,cpd11-20bx.pdf
LNEA16MLR,Melrose,801,DEPT OF SMALL BUSINESS SERVICES,ESSENTIAL RECONSTRUCTION OF FACILITIES,200,BRONX,LN-0008 LN-D008 LN-X001,20000,0,23928,0,0,0,0,0,23928,0,23928,0,0,0,0,0,23928,0,47856,0,0,0,0,0,47856,PROJECT DELAYED DUE TO CHANGES IN SCOPE/DESIGN,,MELROSE,cpd11-20bx.pdf
NDF-JEROM,Jerome Avenue Safety Improvements NDF Funding,801,DEPT OF SMALL BUSINESS SERVICES,NEIGHBORHOOD REVITALIZATION,200,BRONX,ED-0384,39700,0,0,0,0,0,0,39700,39700,0,0,0,0,0,0,39700,39700,0,0,0,0,0,0,79400,79400,PROJECT DELAYED DUE TO CHANGES IN SCOPE/DESIGN,,JEROME AVENUE SAFETY IMPROVEMENTS NDF FUNDING,cpd11-20bx.pdf
NDF-SCH4D,School Safety 4D NDF Funding,801,DEPT OF SMALL BUSINESS SERVICES,NEIGHBORHOOD REVITALIZATION,200,BRONX,ED-0384,3800,0,0,0,0,0,3800,0,3800,0,0,0,0,0,3800,0,3800,0,0,0,0,0,7600,0,7600,PROJECT DELAYED DUE TO CHANGES IN SCOPE/DESIGN,,SCHOOL SAFETY 4D NDF FUNDING,cpd11-20bx.pdf
NFFMSTORG,NEW FULTON FISH MARKET RENOVATION-- REFRIGERATED STORAGE ARE,801,DEPT OF SMALL BUSINESS SERVICES,MISCELLANEOUS,200,BRONX,ED-D408,1200,0,0,0,0,0,1200,0,1200,0,0,0,0,0,1200,0,1200,0,0,0,0,0,2400,0,2400,PROJECT DELAYED DUE TO CHANGES IN SCOPE/DESIGN,,NEW FULTON FISH MARKET RENOVATION-- REFRIGERATED STORAGE AREA AND DRYSTORAGE AREA,cpd11-20bx.pdf
P-1ORCHPA,Orchard Beach Pavillion & Ancillary Reconstruction,801,DEPT OF SMALL BUSINESS SERVICES,BEACHES AND BOARDWALKS,200,BRONX,P-X245 P-D021 P-0715,10000,6284,0,27623,0,20154,0,0,54061,6284,0,27623,0,20154,0,0,54061,12568,0,55246,0,40308,0,0,108122,,ORCHARD BEACH,ORCHARD BEACH COMPLETE RENOVATION OF PAVILION & ANCILLARY SPACE,cpd11-20bx.pdf
PV471SWA2,BxMA - South Wing Atrium Renovation,801,DEPT OF SMALL BUSINESS SERVICES,ESSENTIAL RECONSTRUCTION OF FACILITIES,204,BRONX,PV-X467 PV-D471 PV-0471 PV-0467 PV-D467 PV-X471,19230,0,260,0,19170,0,0,0,19430,0,260,0,19170,0,0,0,19430,0,520,0,38340,0,0,0,38860,,,BRONX MUSEUM OF THE ARTS  SOUTH WING ATRIUM RENOVATION,cpd11-20bx.pdf
RICONNECT,Randall's Island Connector,801,DEPT OF SMALL BUSINESS SERVICES,MISCELLANEOUS,200,BRONX,ED-0075,3556,4834,0,0,0,0,0,1016,5850,4834,0,0,0,0,0,1016,5850,9668,0,0,0,0,0,2032,11700,PROJECT DELAYED DUE TO CHANGES IN SCOPE/DESIGN,,PEDESTRIAN/BIKE CONNECTOR BETWEEN SOUTH BRONX GREENWAY AND RANDALL'S ISLAND,cpd11-20bx.pdf
SANDHPRXD,Hunts Point Energy Resiliency Pilot - DR,801,DEPT OF SMALL BUSINESS SERVICES,MISCELLANEOUS,200,BRONX,ED-0075,40844,0,0,0,0,26000,0,0,26000,0,0,0,0,26000,0,0,26000,0,0,0,0,52000,0,0,52000,PROJECT DELAYED DUE TO CHANGES IN SCOPE/DESIGN,,HUNTS POINT,cpd11-20bx.pdf
STHBRXGRN,South Bronx Greenway,801,DEPT OF SMALL BUSINESS SERVICES,NEIGHBORHOOD REVITALIZATION,200 202 206 209 211 212,BRONX,ED-0075 WP-0056,0,25190,367,0,0,0,0,0,25557,25190,367,0,0,0,0,0,25557,50380,734,0,0,0,0,0,51114,PROJECT DELAYED DUE TO CHANGES IN SCOPE/DESIGN,,SOUTH BRONX GREENWAY,cpd11-20bx.pdf
SWBXINFRA,Southwest Bronx Infrastructure Improvements,801,DEPT OF SMALL BUSINESS SERVICES,NEIGHBORHOOD REVITALIZATION,200,BRONX,ED-0384,194300,3800,5964,0,15085,21185,0,72596,118630,3800,5964,0,15085,21185,0,72596,118630,7600,11928,0,30170,42370,0,145192,237260,PROJECT DELAYED DUE TO CHANGES IN SCOPE/DESIGN,,SOUTHWEST BRONX INFRASTRUCTURE IMPROVEMENTS,cpd11-20bx.pdf
SWBXLCN,Lower Concourse North,801,DEPT OF SMALL BUSINESS SERVICES,NEIGHBORHOOD REVITALIZATION,200,BRONX,ED-0384,27800,0,0,800,0,0,0,0,800,0,0,800,0,0,0,0,800,0,0,1600,0,0,0,0,1600,,,LOWER CONCOURSE NORTH DEVELOPMENT,cpd11-20bx.pdf
VINCEAVE,Vincent Avenue Seawall Rehabilitation,801,DEPT OF SMALL BUSINESS SERVICES,MISCELLANEOUS,200,BRONX,RE-0025 RE-D024,2600,436,0,0,2164,136,0,0,2736,436,0,0,2164,136,0,0,2736,872,0,0,4328,272,0,0,5472,PROJECT DELAYED DUE TO CHANGES IN SCOPE/DESIGN,,VINCENT AVENUE SEAWALL REHAB,cpd11-20bx.pdf
HAM07PPCR,PELHAM PARKWAY HOUSES - COMMUNITY ROOM UPGRADE,806,HOUSING PRESERVATION AND DEVEL,LOW TO MODERATE INCOME PUBLIC HOUSING UPGRADE,211,BRONX,HA-X001,150,0,50,0,0,0,0,0,50,0,50,0,0,0,0,0,50,0,100,0,0,0,0,0,100,PROJECT DELAYED DUE TO CHANGES IN SCOPE/DESIGN,,COMMUNITY ROOM UPGRADE,cpd11-20bx.pdf
HAM07VYSE,VYSE AVENUE FRONT ENTRANCE DOORS,806,HOUSING PRESERVATION AND DEVEL,LOW TO MODERATE INCOME PUBLIC HOUSING UPGRADE,203,BRONX,HA-D001,1410,2421,1123,0,0,0,0,0,3544,2421,1123,0,0,0,0,0,3544,4842,2246,0,0,0,0,0,7088,PROJECT DELAYED DUE TO CHANGES IN SCOPE/DESIGN,,REPLACE FRONT ENTRANCES,cpd11-20bx.pdf
HAM11CHPY,CASTLE HILL PLAYGROUND AND OUTDOOR AREA,806,HOUSING PRESERVATION AND DEVEL,LOW TO MODERATE INCOME PUBLIC HOUSING UPGRADE,209,BRONX,HA-D001,450,1160,190,0,0,0,0,0,1350,1160,190,0,0,0,0,0,1350,2320,380,0,0,0,0,0,2700,PROJECT DELAYED DUE TO BUDGETARY CONSTRAINTS,,PLAYGROUND AND OUTDOOR AREA IMPROVEMENTS,cpd11-20bx.pdf
HAM11CPGP,CLASON POINT PLAYGROUND AND OUTDOOR AREA IMPROVEMENTS,806,HOUSING PRESERVATION AND DEVEL,LOW TO MODERATE INCOME PUBLIC HOUSING UPGRADE,209,BRONX,HA-D001 HA-0001,50,512,52,0,0,0,0,0,564,512,52,0,0,0,0,0,564,1024,104,0,0,0,0,0,1128,PROJECT DELAYED DUE TO BUDGETARY CONSTRAINTS,,PLAYGROUND AND OUTDOOR AREA IMPROVEMENTS,cpd11-20bx.pdf
HAM11DAVC,DAVIDSON/ SITE 166 RES. ASSN SPORTS DOME AND CULINARY PROG.,806,HOUSING PRESERVATION AND DEVEL,LOW TO MODERATE INCOME PUBLIC HOUSING UPGRADE,203,BRONX,HA-D001,1000,1197,290,0,0,0,0,0,1487,1197,290,0,0,0,0,0,1487,2394,580,0,0,0,0,0,2974,PROJECT DELAYED DUE TO CHANGES IN SCOPE/DESIGN,,CULINARY KITCHEN,cpd11-20bx.pdf
HAM13BRPG,BRONX RIVER HOUSES PLAYGROUND RENOVATION,806,HOUSING PRESERVATION AND DEVEL,LOW TO MODERATE INCOME PUBLIC HOUSING UPGRADE,209,BRONX,HA-0001 HA-D001,250,408,42,0,0,0,0,0,450,408,42,0,0,0,0,0,450,816,84,0,0,0,0,0,900,PROJECT DELAYED DUE TO CHANGES IN SCOPE/DESIGN,,UPGRADE PLAYGROUNDS,cpd11-20bx.pdf
HAM14MKGH,MILLBROOK HOUSES SOLAR POWERED GREENHOUSE,806,HOUSING PRESERVATION AND DEVEL,LOW TO MODERATE INCOME PUBLIC HOUSING UPGRADE,201,BRONX,HA-D001,300,0,150,0,0,0,0,0,150,0,150,0,0,0,0,0,150,0,300,0,0,0,0,0,300,PROJECT DELAYED DUE TO CHANGES IN SCOPE/DESIGN,,CONSTRUCT A SOLAR POWERED GREENHOUSE,cpd11-20bx.pdf
HAM14MLBQ,MILLBROOK HOUSES - TWO BARBEQUE AREAS,806,HOUSING PRESERVATION AND DEVEL,LOW TO MODERATE INCOME PUBLIC HOUSING UPGRADE,201,BRONX,HA-D001,300,868,93,0,0,0,0,0,961,868,93,0,0,0,0,0,961,1736,186,0,0,0,0,0,1922,PROJECT DELAYED DUE TO CHANGES IN SCOPE/DESIGN,,TWO BARBEQUE AREAS,cpd11-20bx.pdf
HAM14MRSR,MONROE HOUSES SENIOR CENTER RENOVATION,806,HOUSING PRESERVATION AND DEVEL,LOW TO MODERATE INCOME PUBLIC HOUSING UPGRADE,209,BRONX,HA-D001,1000,2957,422,0,0,0,0,0,3379,2957,422,0,0,0,0,0,3379,5914,844,0,0,0,0,0,6758,PROJECT DELAYED DUE TO CHANGES IN SCOPE/DESIGN,,RENOVATE SENIOR CENTER,cpd11-20bx.pdf
HAM14SHPL,STEBBINS AVENUE - HEWITT PLACE PLAYGROUND RENOVATION,806,HOUSING PRESERVATION AND DEVEL,LOW TO MODERATE INCOME PUBLIC HOUSING UPGRADE,202,BRONX,HA-D001,600,750,100,0,0,0,0,0,850,750,100,0,0,0,0,0,850,1500,200,0,0,0,0,0,1700,PROJECT DELAYED DUE TO CHANGES IN SCOPE/DESIGN,,PLAYGROUND AREA RENOVATION,cpd11-20bx.pdf
HAM14SMGD,ST. MARY'S PARK PLAYGROUND RENOVATION,806,HOUSING PRESERVATION AND DEVEL,LOW TO MODERATE INCOME PUBLIC HOUSING UPGRADE,201,BRONX,HA-D001,500,324,176,0,0,0,0,0,500,324,176,0,0,0,0,0,500,648,352,0,0,0,0,0,1000,PROJECT DELAYED DUE TO CHANGES IN SCOPE/DESIGN,,UPGRADE TO PLAYGROUNDS,cpd11-20bx.pdf
HAM15FOCC,FOREST HOUSES COMMUNITY CENTER GYM AND LOCKER ROOMS,806,HOUSING PRESERVATION AND DEVEL,LOW TO MODERATE INCOME PUBLIC HOUSING UPGRADE,203,BRONX,HA-D001,400,345,55,0,0,0,0,0,400,345,55,0,0,0,0,0,400,690,110,0,0,0,0,0,800,PROJECT DELAYED DUE TO CHANGES IN SCOPE/DESIGN,,UPGRADE GYM AND LOCKER ROOMS,cpd11-20bx.pdf
HAM15SHGC,STEBBINS AVENUE-HEWITT PLACE INFRASTRUCTURE IMPROVEMENTS,806,HOUSING PRESERVATION AND DEVEL,LOW TO MODERATE INCOME PUBLIC HOUSING UPGRADE,202,BRONX,HA-0001,280,560,863,0,0,0,0,0,1423,560,863,0,0,0,0,0,1423,1120,1726,0,0,0,0,0,2846,PROJECT DELAYED DUE TO CHANGES IN SCOPE/DESIGN,,INFRASTRUCTURE IMPROVEMENTS,cpd11-20bx.pdf
HAM15TWPK,SECURITY SYSTEMS AT TWIN PARKS CONS AND PARKSIDE,806,HOUSING PRESERVATION AND DEVEL,LOW TO MODERATE INCOME PUBLIC HOUSING UPGRADE,200,BRONX,HA-D001,3408,3239,169,0,0,0,0,0,3408,3239,169,0,0,0,0,0,3408,6478,338,0,0,0,0,0,6816,PROJECT DELAYED DUE TO CHANGES IN SCOPE/DESIGN,,"LAYERED ACCESS CONTROLS AT TWIN PARKS CONSOLIDATED, LAYERED ACCESS CONTROLS AND",cpd11-20bx.pdf
HAM16BSGD,BOSTON SECOR PLAYGROUND RENOVATION,806,HOUSING PRESERVATION AND DEVEL,LOW TO MODERATE INCOME PUBLIC HOUSING UPGRADE,212,BRONX,HA-D001,300,470,130,0,0,0,0,0,600,470,130,0,0,0,0,0,600,940,260,0,0,0,0,0,1200,PROJECT DELAYED DUE TO CHANGES IN SCOPE/DESIGN,,UPGRADE PLAYGROUNDS,cpd11-20bx.pdf
HAM16CLGY,CLAREMONT HOUSES GYM RENOVATION FOR CLAREMONT NEIGHBORHOOD,806,HOUSING PRESERVATION AND DEVEL,LOW TO MODERATE INCOME PUBLIC HOUSING UPGRADE,203,BRONX,HA-X001 HA-D001,450,0,1445,0,0,0,0,0,1445,0,1445,0,0,0,0,0,1445,0,2890,0,0,0,0,0,2890,PROJECT DELAYED DUE TO CHANGES IN SCOPE/DESIGN,,CLAREMONT HOUSES GYM RENOVATION FOR CLAREMONT NEIGHBORHOOD CENTER,cpd11-20bx.pdf
HAM16FOSC,INSTALLATION OF SECURITY CAMERAS AT FOREST HOUSES,806,HOUSING PRESERVATION AND DEVEL,LOW TO MODERATE INCOME PUBLIC HOUSING UPGRADE,203,BRONX,HA-D001,400,0,100,0,0,0,0,0,100,0,100,0,0,0,0,0,100,0,200,0,0,0,0,0,200,PROJECT DELAYED DUE TO CHANGES IN SCOPE/DESIGN,,INSTALLATION OF SECURITY CAMERAS,cpd11-20bx.pdf
HAM16MODC,JAMES MONROE HOUSES RENOVATE COMMUNITY CENTER,806,HOUSING PRESERVATION AND DEVEL,LOW TO MODERATE INCOME PUBLIC HOUSING UPGRADE,209,BRONX,HA-D001,1000,0,1000,0,0,0,0,0,1000,0,1000,0,0,0,0,0,1000,0,2000,0,0,0,0,0,2000,PROJECT DELAYED DUE TO CHANGES IN SCOPE/DESIGN,,RENOVATE LOCATION AT 816 SOUNDVIEW AVENUE FOR USE OF DAY CARE,cpd11-20bx.pdf
HAM16VRCA,RECONSTRUCTION OF COMMON AREAS,806,HOUSING PRESERVATION AND DEVEL,LOW TO MODERATE INCOME PUBLIC HOUSING UPGRADE,200,BRONX,HA-D001,750,1200,200,0,0,0,0,0,1400,1200,200,0,0,0,0,0,1400,2400,400,0,0,0,0,0,2800,PROJECT DELAYED DUE TO CHANGES IN SCOPE/DESIGN,,RECONSTRUCTION OF COMMON AREAS,cpd11-20bx.pdf
HAM17CLTV,COLLEGE AVENUE -EAST 165TH STREET SECURITY CAMERAS,806,HOUSING PRESERVATION AND DEVEL,LOW TO MODERATE INCOME PUBLIC HOUSING UPGRADE,204,BRONX,HA-D001,500,342,158,0,0,0,0,0,500,342,158,0,0,0,0,0,500,684,316,0,0,0,0,0,1000,PROJECT DELAYED DUE TO CHANGES IN SCOPE/DESIGN,,INSTALL SECURITY CAMERAS AT 1020 COLLEGE AVENUE,cpd11-20bx.pdf
HAM17FORF,ROOF REPLACEMENT AT FOREST HOUSES,806,HOUSING PRESERVATION AND DEVEL,LOW TO MODERATE INCOME PUBLIC HOUSING UPGRADE,203,BRONX,HA-0001,11110,384,17297,0,0,0,0,0,17681,384,17297,0,0,0,0,0,17681,768,34594,0,0,0,0,0,35362,PROJECT DELAYED DUE TO CHANGES IN SCOPE/DESIGN,,ROOF REPLACEMENT,cpd11-20bx.pdf
HAM17MASC,MORRISANIA SECURITY ENHANCEMENTS,806,HOUSING PRESERVATION AND DEVEL,LOW TO MODERATE INCOME PUBLIC HOUSING UPGRADE,203,BRONX,HA-D001,700,646,55,0,0,0,0,0,701,646,55,0,0,0,0,0,701,1292,110,0,0,0,0,0,1402,,,SECURITY ENHANCEMENTS AT MORRISANIA HOUSES,cpd11-20bx.pdf
HAM17MNTV,MONROE HOUSES SECURITY CAMERAS,806,HOUSING PRESERVATION AND DEVEL,LOW TO MODERATE INCOME PUBLIC HOUSING UPGRADE,209,BRONX,HA-D001,500,412,88,0,0,0,0,0,500,412,88,0,0,0,0,0,500,824,176,0,0,0,0,0,1000,PROJECT DELAYED DUE TO CHANGES IN SCOPE/DESIGN,,INSTALL SECURITY CAMERAS,cpd11-20bx.pdf
HAM17MUGR,MURPHY HOUSES GROUNDS RENOVATION,806,HOUSING PRESERVATION AND DEVEL,LOW TO MODERATE INCOME PUBLIC HOUSING UPGRADE,205,BRONX,HA-D001,300,0,300,0,0,0,0,0,300,0,300,0,0,0,0,0,300,0,600,0,0,0,0,0,600,PROJECT DELAYED DUE TO CHANGES IN SCOPE/DESIGN,,GROUNDS RENOVATION,cpd11-20bx.pdf
HAM17PHCC,PATTERSON HOUSES COMMUNITY CENTER REHAB,806,HOUSING PRESERVATION AND DEVEL,LOW TO MODERATE INCOME PUBLIC HOUSING UPGRADE,200,BRONX,HA-X001,200,0,200,0,0,0,0,0,200,0,200,0,0,0,0,0,200,0,400,0,0,0,0,0,400,PROJECT DELAYED DUE TO CHANGES IN SCOPE/DESIGN,,PATTERSON HOUSES COMMUNITY CENTER REHABILITATION,cpd11-20bx.pdf
HAM18BRCB,BOSTON ROAD SENIOR CENTER ROOF REPLACEMENT,806,HOUSING PRESERVATION AND DEVEL,LOW TO MODERATE INCOME PUBLIC HOUSING UPGRADE,200,BRONX,HA-D001,1000,0,1000,0,0,0,0,0,1000,0,1000,0,0,0,0,0,1000,0,2000,0,0,0,0,0,2000,,,BOSTON ROAD SENIOR CENTER ROOF REPLACEMENT,cpd11-20bx.pdf
HAM18BRCC,Bronx River CC,806,HOUSING PRESERVATION AND DEVEL,LOW TO MODERATE INCOME PUBLIC HOUSING CONSTRUCTION,200,BRONX,HA-X001,55,9,55,0,0,0,0,0,64,9,55,0,0,0,0,0,64,18,110,0,0,0,0,0,128,,,BRONX RIVER CC,cpd11-20bx.pdf
HAM18CCMH,MELROSE HOUSES CCTV AND LAC,806,HOUSING PRESERVATION AND DEVEL,LOW TO MODERATE INCOME PUBLIC HOUSING UPGRADE,201,BRONX,HA-0001,3300,0,3000,0,0,0,0,0,3000,0,3000,0,0,0,0,0,3000,0,6000,0,0,0,0,0,6000,,,INSTALL CCTV AND LAC,cpd11-20bx.pdf
HAM18COSC,SECURITY CAMERA INSTALLATION AT 372 EAST 152ND ST COURTLANDT,806,HOUSING PRESERVATION AND DEVEL,LOW TO MODERATE INCOME PUBLIC HOUSING UPGRADE,201,BRONX,HA-D001,50,0,50,0,0,0,0,0,50,0,50,0,0,0,0,0,50,0,100,0,0,0,0,0,100,,,SECURITY CAMERA INSTALLATION AT 372 EAST 152ND ST COURTLANDT STREET,cpd11-20bx.pdf
HAM18EATR,Renovation of East Tremont Childcare Center Playground,806,HOUSING PRESERVATION AND DEVEL,LOW TO MODERATE INCOME PUBLIC HOUSING CONSTRUCTION,200,BRONX,HA-D001,500,0,250,0,0,0,0,0,250,0,250,0,0,0,0,0,250,0,500,0,0,0,0,0,500,,,RENOVATION OF EAST TREMONT CHILDCARE CENTER,cpd11-20bx.pdf
HAM18FSBO,Boiler Replacements at Pelham Parkway,806,HOUSING PRESERVATION AND DEVEL,LOW TO MODERATE INCOME PUBLIC HOUSING UPGRADE,211,BRONX,HA-0001,29000,0,8628,0,0,0,0,0,8628,0,8628,0,0,0,0,0,8628,0,17256,0,0,0,0,0,17256,,,BOILER REPLACEMENTS AT PELHAM PARKWAY,cpd11-20bx.pdf
HAM18HBLG,EXTERIOR LED LIGHTING AT HIGHBRIDGE GARDENS,806,HOUSING PRESERVATION AND DEVEL,LOW TO MODERATE INCOME PUBLIC HOUSING UPGRADE,204,BRONX,HA-D001,500,450,50,0,0,0,0,0,500,450,50,0,0,0,0,0,500,900,100,0,0,0,0,0,1000,,,EXTERIOR LED LIGHTING AT HIGHBRIDGE GARDENS,cpd11-20bx.pdf
HAM18MBLT,MILL BROOK EXTERIOR LIGHTING,806,HOUSING PRESERVATION AND DEVEL,LOW TO MODERATE INCOME PUBLIC HOUSING UPGRADE,201,BRONX,HA-D001,500,460,40,0,0,0,0,0,500,460,40,0,0,0,0,0,500,920,80,0,0,0,0,0,1000,,,IMPROVE EXTERIOR LIGHTING,cpd11-20bx.pdf
HAM18MBSS,MILL BROOK HOUSES SPRAY SHOWERS,806,HOUSING PRESERVATION AND DEVEL,LOW TO MODERATE INCOME PUBLIC HOUSING UPGRADE,201,BRONX,HA-D001,500,0,500,0,0,0,0,0,500,0,500,0,0,0,0,0,500,0,1000,0,0,0,0,0,1000,,,MILL BROOK HOUSES SPRAY SHOWERS INSTALLATION,cpd11-20bx.pdf
HAM18MRP1,MORRIS I PLAYGROUND RENOVATION IN FRONT OF 3606 THIRD AVE,806,HOUSING PRESERVATION AND DEVEL,LOW TO MODERATE INCOME PUBLIC HOUSING UPGRADE,203,BRONX,HA-X001,500,65,210,0,0,0,0,0,275,65,210,0,0,0,0,0,275,130,420,0,0,0,0,0,550,,,RENOVATION OF A PLAYGROUND IN FRONT OF 3606 THIRD AVENUE,cpd11-20bx.pdf
HAM18MRPG,MORRIS II PLAYGROUND RENOVATION IN FRONT OF 1481 WASHINGTON,806,HOUSING PRESERVATION AND DEVEL,LOW TO MODERATE INCOME PUBLIC HOUSING UPGRADE,203,BRONX,HA-X001,500,65,435,0,0,0,0,0,500,65,435,0,0,0,0,0,500,130,870,0,0,0,0,0,1000,,,MORRIS II HOUSES PLAYGROUND--PLAYGROUND RENOVATION IN FRONT OF 1481 WASHINGTON,cpd11-20bx.pdf
HAM18PCCK,KITCHEN RENOVATION AT PATTERSON HOUSES COMMUNITY CENTER,806,HOUSING PRESERVATION AND DEVEL,LOW TO MODERATE INCOME PUBLIC HOUSING UPGRADE,201,BRONX,HA-X001,800,0,800,0,0,0,0,0,800,0,800,0,0,0,0,0,800,0,1600,0,0,0,0,0,1600,,,RENOVATION OF THE KITCHEN AT PATTERSON HOUSES COMMUNITY CENTER 340 MORRIS AVE,cpd11-20bx.pdf
HAM18PPHL,Pelham Parkway Houses Exterior Lighting Installation,806,HOUSING PRESERVATION AND DEVEL,LOW TO MODERATE INCOME PUBLIC HOUSING CONSTRUCTION,200,BRONX,HA-D001,750,629,121,0,0,0,0,0,750,629,121,0,0,0,0,0,750,1258,242,0,0,0,0,0,1500,,,PELHAM PARKWAY HOUSES EXTERIOR LIGHTING INSTALLATION,cpd11-20bx.pdf
HAM18RBSC,SECURITY CAMERAS AT THROGGS NECK (RANDALL- BALCOLM),806,HOUSING PRESERVATION AND DEVEL,LOW TO MODERATE INCOME PUBLIC HOUSING CONSTRUCTION,210,BRONX,HA-D001,285,446,57,0,0,0,0,0,503,446,57,0,0,0,0,0,503,892,114,0,0,0,0,0,1006,,,INSTALL SECURITY CAMERAS,cpd11-20bx.pdf
HAM18SMTV,SOTOMAYOR SECURITY ENHANCEMENTS AT 1055 ROSEDALE AVENURE,806,HOUSING PRESERVATION AND DEVEL,LOW TO MODERATE INCOME PUBLIC HOUSING CONSTRUCTION,200,BRONX,HA-X001,1000,919,81,0,0,0,0,0,1000,919,81,0,0,0,0,0,1000,1838,162,0,0,0,0,0,2000,,,SOTOMAYOR SECURITY ENHANCEMENTS AT 1055 ROSEDALE AVENURE,cpd11-20bx.pdf
HAM18SOCC,Sotomayor CC Cornerstone Program - Computer Technology,806,HOUSING PRESERVATION AND DEVEL,LOW TO MODERATE INCOME PUBLIC HOUSING CONSTRUCTION,200,BRONX,HA-X001,42,0,42,0,0,0,0,0,42,0,42,0,0,0,0,0,42,0,84,0,0,0,0,0,84,,,SOTOMAYOR CC CORNERSTONE PROGRAM - COMPUTER TECHNOLOGY,cpd11-20bx.pdf
HAM18SOMO,SOTOMAYOR HOUSES/MONTEFIORE BEHAVIOR HC - PSYCH CENTER,806,HOUSING PRESERVATION AND DEVEL,LOW TO MODERATE INCOME PUBLIC HOUSING CONSTRUCTION,200,BRONX,HA-X001 HA-D001,5500,0,5500,0,0,0,0,0,5500,0,5500,0,0,0,0,0,5500,0,11000,0,0,0,0,0,11000,,,SOTOMAYOR HOUSES/MONTEFIORE BEHAVIOR HC - PSYCH CENTER,cpd11-20bx.pdf
HAM18SVCC,Soundview CC Cornerstone Program - Computer Technology,806,HOUSING PRESERVATION AND DEVEL,LOW TO MODERATE INCOME PUBLIC HOUSING CONSTRUCTION,200,BRONX,HA-X001,42,0,42,0,0,0,0,0,42,0,42,0,0,0,0,0,42,0,84,0,0,0,0,0,84,,,SOUNDVIEW CC CORNERSTONE PROGRAM - COMPUTER TECHNOLOGY,cpd11-20bx.pdf
HAM18TCCK,THROGGS NECK COMMUNITY C ENTER KITCHEN UPDATE,806,HOUSING PRESERVATION AND DEVEL,LOW TO MODERATE INCOME PUBLIC HOUSING UPGRADE,210,BRONX,HA-X001,600,0,600,0,0,0,0,0,600,0,600,0,0,0,0,0,600,0,1200,0,0,0,0,0,1200,,,NYCHA THROGS NECK ADDITION COMMUNITY CENTER--UPDATE KITCHEN 550 BALCOLM AVENUE.,cpd11-20bx.pdf
HAM18TCCL,THROGGS NECK COMMUNITY CENTER LIGHTING,806,HOUSING PRESERVATION AND DEVEL,LOW TO MODERATE INCOME PUBLIC HOUSING UPGRADE,210,BRONX,HA-X001,500,305,195,0,0,0,0,0,500,305,195,0,0,0,0,0,500,610,390,0,0,0,0,0,1000,,,NYCHA THROGS NECK HOUSES COMMUNITY CENTER--LIGHTING THROUGHOUT FACILITY 550 BALCOM,cpd11-20bx.pdf
HAM18TNCR,THROGGS NECK COMMUNITY - ROOF RENOVATIONS,806,HOUSING PRESERVATION AND DEVEL,LOW TO MODERATE INCOME PUBLIC HOUSING UPGRADE,210,BRONX,HA-X001,1000,0,1000,0,0,0,0,0,1000,0,1000,0,0,0,0,0,1000,0,2000,0,0,0,0,0,2000,,,NYCHA THROGS NECK HOUSES COMMUNITY CENTER--NEW ROOF RENOVATIONS 550 BALCOLM,cpd11-20bx.pdf
HAM19ADEL,ADAMS HOUSES ELEVATOR REPLACEMENT,806,HOUSING PRESERVATION AND DEVEL,LOW TO MODERATE INCOME PUBLIC HOUSING UPGRADE,201,BRONX,HA-0001,8566,0,7387,0,0,0,0,0,7387,0,7387,0,0,0,0,0,7387,0,14774,0,0,0,0,0,14774,,,REPLACE ELEVATOR AT ADAMS HOUSES,cpd11-20bx.pdf
HAM19BESC,BETANCES SENIOR CENTER COURTYARD RENOVATIONS,806,HOUSING PRESERVATION AND DEVEL,LOW TO MODERATE INCOME PUBLIC HOUSING UPGRADE,200,BRONX,HA-X001,500,0,250,0,0,0,0,0,250,0,250,0,0,0,0,0,250,0,500,0,0,0,0,0,500,,,BETANCES SENIOR CENTER COURTYARD RENOVATIONS,cpd11-20bx.pdf
HAM19BHSC,BAILEY HOUSES SECURITY CAMERAS,806,HOUSING PRESERVATION AND DEVEL,LOW TO MODERATE INCOME PUBLIC HOUSING UPGRADE,207,BRONX,HA-D001,500,0,500,0,0,0,0,0,500,0,500,0,0,0,0,0,500,0,1000,0,0,0,0,0,1000,,,FUNDING FOR SECURITY CAMERAS,cpd11-20bx.pdf
HAM19BPWS,BUTLER HOUSES PLAYGROUND WATER SPRAYS,806,HOUSING PRESERVATION AND DEVEL,LOW TO MODERATE INCOME PUBLIC HOUSING UPGRADE,203,BRONX,HA-D001,200,0,700,0,0,0,0,0,700,0,700,0,0,0,0,0,700,0,1400,0,0,0,0,0,1400,,,PLAYGROUND WATER SPRAY SYSTEMS,cpd11-20bx.pdf
HAM19BRSC,BRONX RIVER SENIOR CENTER KITCHEN RENOVATIONS,806,HOUSING PRESERVATION AND DEVEL,LOW TO MODERATE INCOME PUBLIC HOUSING UPGRADE,200,BRONX,HA-X001 HA-D001,1000,0,1000,0,0,0,0,0,1000,0,1000,0,0,0,0,0,1000,0,2000,0,0,0,0,0,2000,,,BRONX RIVER SENIOR CENTER KITCHEN RENOVATIONS,cpd11-20bx.pdf
HAM19CAGR,CASTLE HILL HOUSES GAS RISER REPLACEMENTS,806,HOUSING PRESERVATION AND DEVEL,LOW TO MODERATE INCOME PUBLIC HOUSING UPGRADE,209,BRONX,HA-0001,10602,0,10138,0,0,0,0,0,10138,0,10138,0,0,0,0,0,10138,0,20276,0,0,0,0,0,20276,,,GAS RISER REPLACEMENT,cpd11-20bx.pdf
HAM19CASC,EAST 152ND-COURTLANDT AVENUE SECURITY CAMERAS,806,HOUSING PRESERVATION AND DEVEL,LOW TO MODERATE INCOME PUBLIC HOUSING UPGRADE,207,BRONX,HA-D001,225,0,225,0,0,0,0,0,225,0,225,0,0,0,0,0,225,0,450,0,0,0,0,0,450,,,FUNDING FOR SECURITY CAMERAS,cpd11-20bx.pdf
HAM19CMHP,MOORE HOUSES PLAYGROUND,806,HOUSING PRESERVATION AND DEVEL,LOW TO MODERATE INCOME PUBLIC HOUSING UPGRADE,201,BRONX,HA-0001,1200,0,1200,0,0,0,0,0,1200,0,1200,0,0,0,0,0,1200,0,2400,0,0,0,0,0,2400,,,FUNDING FOR MOORE HOUSES PLAYGROUND UPGRADE,cpd11-20bx.pdf
HAM19MARE,MORRISANIA AIR RIGHTS ELEVATOR REPLACEMENT AT 3135 PARK AVE,806,HOUSING PRESERVATION AND DEVEL,LOW TO MODERATE INCOME PUBLIC HOUSING UPGRADE,203,BRONX,HA-D001,2000,0,2000,0,0,0,0,0,2000,0,2000,0,0,0,0,0,2000,0,4000,0,0,0,0,0,4000,,,ELEVATOR REPLACEMENT AT 3135 PARK AVENUE,cpd11-20bx.pdf
HAM19MHSE,MARBLE HILL SECURITY ENHANCEMENTS,806,HOUSING PRESERVATION AND DEVEL,LOW TO MODERATE INCOME PUBLIC HOUSING UPGRADE,208,BRONX,HA-D001,75,0,75,0,0,0,0,0,75,0,75,0,0,0,0,0,75,0,150,0,0,0,0,0,150,,,MARBLE HILL SECURITY ENHANCEMENTS-INSTALLATION OF SECURITY EQUIPMENT,cpd11-20bx.pdf
HAM19MHSP,MARBLE HILL PARKING LOT SECURITY POLES,806,HOUSING PRESERVATION AND DEVEL,LOW TO MODERATE INCOME PUBLIC HOUSING UPGRADE,208,BRONX,HA-D001,100,0,139,0,0,0,0,0,139,0,139,0,0,0,0,0,139,0,278,0,0,0,0,0,278,,,PARKING LOT SECURITY POLES,cpd11-20bx.pdf
HAM19PHBC,PATTERSON HOUSES BASKETBALL COURT UPGRADE,806,HOUSING PRESERVATION AND DEVEL,LOW TO MODERATE INCOME PUBLIC HOUSING UPGRADE,201,BRONX,HA-D001,500,339,161,0,0,0,0,0,500,339,161,0,0,0,0,0,500,678,322,0,0,0,0,0,1000,,,BASKETBALL COURT UPGRADE,cpd11-20bx.pdf
HAM19UNSC,1865 UNIVERSITY AVE- SECURITY CAMERAS,806,HOUSING PRESERVATION AND DEVEL,LOW TO MODERATE INCOME PUBLIC HOUSING UPGRADE,205,BRONX,HA-D001,121,0,121,0,0,0,0,0,121,0,121,0,0,0,0,0,121,0,242,0,0,0,0,0,242,,,SECURITY CAMERAS AT 1865 UNIVERSITY AVENUE,cpd11-20bx.pdf
HAM20EGCC,EASTCHESTER GARDENS COMMUNITY CENTER UPGRADE,806,HOUSING PRESERVATION AND DEVEL,LOW TO MODERATE INCOME PUBLIC HOUSING UPGRADE,211,BRONX,HA-0001,3650,0,3650,0,0,0,0,0,3650,0,3650,0,0,0,0,0,3650,0,7300,0,0,0,0,0,7300,,,EASTCHESTER GARDENS COMMUNITY CENTER UPGRADE,cpd11-20bx.pdf
HAM20GMEL,GOUVERNEUR MORRIS- EXTERIOR LED LIGHTING,806,HOUSING PRESERVATION AND DEVEL,LOW TO MODERATE INCOME PUBLIC HOUSING UPGRADE,203,BRONX,HA-D001,250,0,250,0,0,0,0,0,250,0,250,0,0,0,0,0,250,0,500,0,0,0,0,0,500,,,INSTALLATION OF EXTERIOR LED LIGHTING AT GOUVERNEUR MORRIS HOUSES,cpd11-20bx.pdf
HAM20MCIE,"JAMES MONROE HOUSES- CAMERAS, INSTALLATION, EQUIPMENT",806,HOUSING PRESERVATION AND DEVEL,LOW TO MODERATE INCOME PUBLIC HOUSING UPGRADE,209,BRONX,HA-D001,2506,0,2506,0,0,0,0,0,2506,0,2506,0,0,0,0,0,2506,0,5012,0,0,0,0,0,5012,,,"JAMES MONROE HOUSES- CAMERAS, INSTALLATION, EQUIPMENT",cpd11-20bx.pdf
HAM20MHGR,MONTEREY HOUSES-RENOVATIONS TO PLAYGROUND,806,HOUSING PRESERVATION AND DEVEL,LOW TO MODERATE INCOME PUBLIC HOUSING UPGRADE,206,BRONX,HA-D001,225,0,225,0,0,0,0,0,225,0,225,0,0,0,0,0,225,0,450,0,0,0,0,0,450,,,NYCHA MONTEREY HOUSES OUTDOOR RENOVATIONS -- FUNDS WILL SUPPORT RENOVATIONS TO THE,cpd11-20bx.pdf
HAM20MLPC,"MILLBROOK- LIGHTS, PLAYGROUNDS UPGRADES AND CAMERAS",806,HOUSING PRESERVATION AND DEVEL,LOW TO MODERATE INCOME PUBLIC HOUSING UPGRADE,201,BRONX,HA-D001,300,0,300,0,0,0,0,0,300,0,300,0,0,0,0,0,300,0,600,0,0,0,0,0,600,,,"INSTALLATION OF LED LIGHTS, PLAYGROUND UPGRADES, AND CAMERAS AT MILLBROOK HOUSES",cpd11-20bx.pdf
HAM20PSCC,PARKSIDE COMMUNITY CENTER UPGRADE,806,HOUSING PRESERVATION AND DEVEL,LOW TO MODERATE INCOME PUBLIC HOUSING UPGRADE,200,BRONX,HA-0001,1700,0,1700,0,0,0,0,0,1700,0,1700,0,0,0,0,0,1700,0,3400,0,0,0,0,0,3400,,,PARKSIDE COMMUNITY CENTER UPGRADE,cpd11-20bx.pdf
HAM20SEED,SEDGWICK HOUSES ENHANCEMENT ENTRANCE DOORS,806,HOUSING PRESERVATION AND DEVEL,LOW TO MODERATE INCOME PUBLIC HOUSING UPGRADE,205,BRONX,HA-D001,880,0,880,0,0,0,0,0,880,0,880,0,0,0,0,0,880,0,1760,0,0,0,0,0,1760,PROJECT DELAYED DUE TO CHANGES IN SCOPE/DESIGN,,NYCHA SEDGWICK HOUSES -- 4 ENHANCEMENT ENTRANCE DOORS,cpd11-20bx.pdf
HAM21BHIN,BUTLER HOUSES0 INFRASTRUCTURE IMPROVEMENTS,806,HOUSING PRESERVATION AND DEVEL,LOW TO MODERATE INCOME PUBLIC HOUSING UPGRADE,203,BRONX,HA-D001,0,0,84,0,0,0,0,0,84,0,84,0,0,0,0,0,84,0,168,0,0,0,0,0,168,,,BUTLER HOUSES- INFRASTRUCTURE IMPROVEMENTS,cpd11-20bx.pdf
HAM21BRIN,BRONX RIVER HOUSES- INFRASTRUCTURE IMPROVEMENTS,806,HOUSING PRESERVATION AND DEVEL,LOW TO MODERATE INCOME PUBLIC HOUSING UPGRADE,209,BRONX,HA-D001,0,0,84,0,0,0,0,0,84,0,84,0,0,0,0,0,84,0,168,0,0,0,0,0,168,,,BRONX RIVER HOUSES- INFRASTRUCTURE IMPROVEMENTS,cpd11-20bx.pdf
HAM21CHIN,CASTLEHILL HOUSES-INFRASTRUCTURE IMPROVEMENTS,806,HOUSING PRESERVATION AND DEVEL,LOW TO MODERATE INCOME PUBLIC HOUSING UPGRADE,209,BRONX,HA-D001,0,0,83,0,0,0,0,0,83,0,83,0,0,0,0,0,83,0,166,0,0,0,0,0,166,,,CASTLEHILL HOUSES-INFRASTRUCTURE IMPROVEMENTS,cpd11-20bx.pdf
HAM21EHSS,NYCHA/EAST SIDE HOUSE HEAD START SPRINKLER SYSTEM - VARIOUS,806,HOUSING PRESERVATION AND DEVEL,LOW TO MODERATE INCOME PUBLIC HOUSING CONSTRUCTION,200,BRONX,HA-X001,0,0,500,0,0,0,0,0,500,0,500,0,0,0,0,0,500,0,1000,0,0,0,0,0,1000,,,NYCHA/EAST SIDE HOUSE HEAD START SPRINKLER SYSTEMS - VARIOUS,cpd11-20bx.pdf
HAM21EWGR,EDENWALD GAS RISERS #6,806,HOUSING PRESERVATION AND DEVEL,LOW TO MODERATE INCOME PUBLIC HOUSING UPGRADE,212,BRONX,HA-0001,9900,0,9000,0,0,0,0,0,9000,0,9000,0,0,0,0,0,9000,0,18000,0,0,0,0,0,18000,,,INSTALLATION OF GAS RISERS #6,cpd11-20bx.pdf
HAM21HHIN,HIGHBRIDGE HOUSES- INFRASTRUCTURE IMPROVEMENTS,806,HOUSING PRESERVATION AND DEVEL,LOW TO MODERATE INCOME PUBLIC HOUSING UPGRADE,204,BRONX,HA-D001,0,0,83,0,0,0,0,0,83,0,83,0,0,0,0,0,83,0,166,0,0,0,0,0,166,,,HIGHBRIDGE HOUSES- INFRASTRUCTURE IMPROVEMENTS,cpd11-20bx.pdf
HAM21HMCC,MONROE HOUSES- COMMUNITY CENTER,806,HOUSING PRESERVATION AND DEVEL,LOW TO MODERATE INCOME PUBLIC HOUSING UPGRADE,209,BRONX,HA-0001,0,0,5738,0,0,0,0,0,5738,0,5738,0,0,0,0,0,5738,0,11476,0,0,0,0,0,11476,,,MONROE HOUSES- COMMUNITY CENTER,cpd11-20bx.pdf
HAM21JHIN,JACKSON HOUSES- INFRASTRUCTURE IMPROVEMENTS,806,HOUSING PRESERVATION AND DEVEL,LOW TO MODERATE INCOME PUBLIC HOUSING UPGRADE,201,BRONX,HA-D001,0,0,83,0,0,0,0,0,83,0,83,0,0,0,0,0,83,0,166,0,0,0,0,0,166,,,JACKSON HOUSES- INFRASTRUCTURE IMPROVEMENTS,cpd11-20bx.pdf
HAM21MHCC,UPGRADE COMMUNITY CENTER MOTT HAVEN,806,HOUSING PRESERVATION AND DEVEL,LOW TO MODERATE INCOME PUBLIC HOUSING UPGRADE,201,BRONX,HA-0001,1600,0,1600,0,0,0,0,0,1600,0,1600,0,0,0,0,0,1600,0,3200,0,0,0,0,0,3200,,,UPGRADE COMMUNITY CENTER MOTT HAVEN,cpd11-20bx.pdf
HAM21MHIN,MOTT HAVEN- INFRASTRUCTURE IMPROVEMENTS,806,HOUSING PRESERVATION AND DEVEL,LOW TO MODERATE INCOME PUBLIC HOUSING UPGRADE,201,BRONX,HA-D001,0,0,83,0,0,0,0,0,83,0,83,0,0,0,0,0,83,0,166,0,0,0,0,0,166,,,MOTT HAVEN HOUSES-INFRASTRUCTURE IMPROVEMENTS,cpd11-20bx.pdf
HAM21MHOA,NYCHA MONTEREY HOUSES-OUTDOOR AREA RENOVATIONS,806,HOUSING PRESERVATION AND DEVEL,LOW TO MODERATE INCOME PUBLIC HOUSING UPGRADE,206,BRONX,HA-D001,0,0,225,0,0,0,0,0,225,0,225,0,0,0,0,0,225,0,450,0,0,0,0,0,450,,,NYCHA MONTEREY HOUSES-OUTDOOR AREA RENOVATIONS,cpd11-20bx.pdf
HAM21MICC,UPGRADE COMMUNITY CENTER MITCHEL,806,HOUSING PRESERVATION AND DEVEL,LOW TO MODERATE INCOME PUBLIC HOUSING UPGRADE,201,BRONX,HA-0001,4400,0,4400,0,0,0,0,0,4400,0,4400,0,0,0,0,0,4400,0,8800,0,0,0,0,0,8800,,,UPGRADE COMMUNITY CENTER MITCHEL,cpd11-20bx.pdf
HAM21MIIN,MITCHELL HOUSES- INFRASTRUCTURE IMPROVEMENTS,806,HOUSING PRESERVATION AND DEVEL,LOW TO MODERATE INCOME PUBLIC HOUSING UPGRADE,201,BRONX,HA-D001,0,0,83,0,0,0,0,0,83,0,83,0,0,0,0,0,83,0,166,0,0,0,0,0,166,,,MITCHELL HOUSES- INFRASTRUCTURE IMPROVEMENTS,cpd11-20bx.pdf
HAM21MLCC,UPGRADE COMMUNITY CENTER MILLBROOK,806,HOUSING PRESERVATION AND DEVEL,LOW TO MODERATE INCOME PUBLIC HOUSING UPGRADE,201,BRONX,HA-0001,1800,0,1800,0,0,0,0,0,1800,0,1800,0,0,0,0,0,1800,0,3600,0,0,0,0,0,3600,,,UPGRADE COMMUNITY CENTER MILLBROOK,cpd11-20bx.pdf
HAM21MLIN,MELROSE HOUSES- INFRASTRUCTURE IMPROVEMENTS,806,HOUSING PRESERVATION AND DEVEL,LOW TO MODERATE INCOME PUBLIC HOUSING UPGRADE,201,BRONX,HA-D001,0,0,84,0,0,0,0,0,84,0,84,0,0,0,0,0,84,0,168,0,0,0,0,0,168,,,MELROSE HOUSES- INFRASTRUCTURE IMPROVEMENTS,cpd11-20bx.pdf
HAM21MOIN,MONROE HOUSES- INFRASTRUCTURE IMPROVEMENTS,806,HOUSING PRESERVATION AND DEVEL,LOW TO MODERATE INCOME PUBLIC HOUSING UPGRADE,209,BRONX,HA-D001,0,0,84,0,0,0,0,0,84,0,84,0,0,0,0,0,84,0,168,0,0,0,0,0,168,,,MONROE HOUSES- INFRASTRUCTURE IMPROVEMENTS,cpd11-20bx.pdf
HAM21PHCC,UPGRADE COMMUNITY CENTER PATTERSON,806,HOUSING PRESERVATION AND DEVEL,LOW TO MODERATE INCOME PUBLIC HOUSING UPGRADE,201,BRONX,HA-0001,5100,0,5100,0,0,0,0,0,5100,0,5100,0,0,0,0,0,5100,0,10200,0,0,0,0,0,10200,,,UPGRADE COMMUNITY CENTER PATTERSON,cpd11-20bx.pdf
HAM21PHIN,PATTERSON HOUSES- INFRASTRUCTURE IMPROVEMENTS,806,HOUSING PRESERVATION AND DEVEL,LOW TO MODERATE INCOME PUBLIC HOUSING UPGRADE,201,BRONX,HA-D001,0,0,83,0,0,0,0,0,83,0,83,0,0,0,0,0,83,0,166,0,0,0,0,0,166,,,PATTERSON HOUSES- INFRASTRUCTURE IMPROVEMENTS,cpd11-20bx.pdf
HAM21SHIN,SOTOMAYOR HOUSES- INFRASTRUCTURE IMPROVEMENTS,806,HOUSING PRESERVATION AND DEVEL,LOW TO MODERATE INCOME PUBLIC HOUSING UPGRADE,209,BRONX,HA-D001,0,0,83,0,0,0,0,0,83,0,83,0,0,0,0,0,83,0,166,0,0,0,0,0,166,,,SOTOMAYOR HOUSES-INFRASTRUCTURE IMPROVEMENTS,cpd11-20bx.pdf
HAM21WHIN,WEBSTER HOUSES- INFRASTRUCTURE IMPROVEMENTS,806,HOUSING PRESERVATION AND DEVEL,LOW TO MODERATE INCOME PUBLIC HOUSING UPGRADE,203,BRONX,HA-D001,0,0,83,0,0,0,0,0,83,0,83,0,0,0,0,0,83,0,166,0,0,0,0,0,166,,,WEBSTER HOUSES- INFRASTRUCTURE IMPROVEMENTS,cpd11-20bx.pdf
HAM21WMCI,SECURITY CAMERA INSTALLATION AT WEBSTER MORRISANIA,806,HOUSING PRESERVATION AND DEVEL,LOW TO MODERATE INCOME PUBLIC HOUSING UPGRADE,203,BRONX,HA-D001,0,0,800,0,0,0,0,0,800,0,800,0,0,0,0,0,800,0,1600,0,0,0,0,0,1600,,,NYCHA WEBSTER MORRISANIA-FY19 SHORTFALL OF SECURITY CAMERA INSTALLATION,cpd11-20bx.pdf
HAM24CHBR,CASTLE HILL BATHROOMS,806,HOUSING PRESERVATION AND DEVEL,LOW TO MODERATE INCOME PUBLIC HOUSING UPGRADE,209,BRONX,HA-0001,42800,0,0,0,0,500,7000,31409,38909,0,0,0,0,500,7000,31409,38909,0,0,0,0,1000,14000,62818,77818,,,INSTALLATION OF CASTLE HILL BATHROOMS,cpd11-20bx.pdf
SWBPELCN,Bronx Point Esplanade - Lower Concourse North,806,HOUSING PRESERVATION AND DEVEL,NEIGHBORHOOD REVITALIZATION,200,BRONX,ED-0384,0,0,27000,0,0,0,0,0,27000,0,27000,0,0,0,0,0,27000,0,54000,0,0,0,0,0,54000,,"MILL POND PARK TO THE NORTH, 145TH STREET BRIDGE TO THE SOUTH, EXTERIOR STREET TO THE",CREATE BRONX POINT ESPLANADE WATERFRONT ACCESS AND EXTEND MILL POND PARK,cpd11-20bx.pdf
HL82BERGN,"BERGEN BUILDING RENOVATION - 1932 ARTHUR AVE., BRONX, NY",816,DEPARTMENT OF HEALTH AND MENTAL HYGIENE,CLINIC RENOVATION AND REHABILITATION,,BRONX,HL-0082,800,1093,511,0,0,0,0,0,1604,1093,511,0,0,0,0,0,1604,2186,1022,0,0,0,0,0,3208,,,"GENERAL CONSTRUCTION, ELECTRICAL POWER, LIGHTING & PLUMBING",cpd11-20bx.pdf
HL82GLEEB,"BUILDING RENOVATION - 2527 GLEBE AVE, BRONX, NY",816,DEPARTMENT OF HEALTH AND MENTAL HYGIENE,CLINIC RENOVATION AND REHABILITATION,,BRONX,HL-0082,2500,0,0,0,0,800,9200,0,10000,0,0,0,0,800,9200,0,10000,0,0,0,0,1600,18400,0,20000,PROJECT DELAYED DUE TO BUDGETARY CONSTRAINTS,,BUILDING ROOFING AND EXTERIOR RENOVATION,cpd11-20bx.pdf
HL82MORHC,Morrisania Health Center interior renovation,816,DEPARTMENT OF HEALTH AND MENTAL HYGIENE,CLINIC RENOVATION AND REHABILITATION,,BRONX,HL-0082,4700,0,0,0,0,1496,1000,0,2496,0,0,0,0,1496,1000,0,2496,0,0,0,0,2992,2000,0,4992,,,MORRISANIA HEALTH CENTER INTERIOR RENOVATION,cpd11-20bx.pdf
HL82ZERGA,"LEASE SPACE RENOVATION - 1235 ZEREGA AVENUE, BRONX, NY",816,DEPARTMENT OF HEALTH AND MENTAL HYGIENE,ADMINISTRATION,,BRONX,HL-0082,2000,3291,366,0,0,0,0,0,3657,3291,366,0,0,0,0,0,3657,6582,732,0,0,0,0,0,7314,,,LEASE SPACE RENOVATION,cpd11-20bx.pdf
02201801,JMC,819,HEALTH AND HOSPITALS CORP,ROUTINE RECONSTRUCTION,,BRONX,HO-0214,7638,6708,20,0,0,910,0,0,7638,6708,20,0,0,910,0,0,7638,13416,40,0,0,1820,0,0,15276,PROJECT DELAYED DUE TO CHANGES IN SCOPE/DESIGN,"1400 PELHAM PARKWAY SOUTH, BRONX, NY 10461",THIS PROJECT CONSISTS OF THE NECESSARY RELOCATION OF EXISTING JACOBI DEPARTMENTS TO,cpd11-20bx.pdf
02201802,JACOBI,819,HEALTH AND HOSPITALS CORP,ROUTINE RECONSTRUCTION,,BRONX,HO-0214,840,759,12,0,0,69,0,0,840,759,12,0,0,69,0,0,840,1518,24,0,0,138,0,0,1680,PROJECT DELAYED DUE TO CHANGES IN SCOPE/DESIGN,"1400 PELHAM PARKWAY SOUTH, BRONX","CONSTRUCT PLAYGROUND ""PARATE SHIP"" FOR THE PEDIATRIC DEPT. AT JACOBI MEDICAL CENTER.",cpd11-20bx.pdf
20201501,BELVIS,819,HEALTH AND HOSPITALS CORP,ROUTINE RECONSTRUCTION,201,BRONX,HO-D003,92,0,0,92,0,0,0,0,92,0,0,92,0,0,0,0,92,0,0,184,0,0,0,0,184,,"545 EAST 142ND STREET, BRONX, BY 10454","MODERNIZE PEDIATRIC SUITE, INCLUDING NEW PHYSICIAN AND NURSE WORKSTATIONS, EXPANDED",cpd11-20bx.pdf
21200603,JACOBI,819,HEALTH AND HOSPITALS CORP,ROUTINE RECONSTRUCTION,211,BRONX,HO-0214,3722,3561,0,0,0,62,0,0,3623,3561,0,0,0,62,0,0,3623,7122,0,0,0,124,0,0,7246,PROJECT DELAYED DUE TO CHANGES IN SCOPE/DESIGN,"1400 PELHAM PARKWAY SOUTH, BRONX, NY 10461","UPON COMPLETION OF THIS PROJECT, JACOBI MEDICAL CENTER WILL OPERATE A WOMEN'S OPTIONS",cpd11-20bx.pdf
21201601,JACOBI,819,HEALTH AND HOSPITALS CORP,ROUTINE RECONSTRUCTION,211,BRONX,HO-0214,2034,266,4269,413,0,0,0,0,4948,266,4269,413,0,0,0,0,4948,532,8538,826,0,0,0,0,9896,,"1400 PELHAM PARKWAY SOUTH, BRONX NY 10461",THE PURPOSE OF THIS PROJECT IS TO RENOVATE BUILDINGS AT JACOBI HOSPITAL CENTER USING,cpd11-20bx.pdf
21201704,JMC,819,HEALTH AND HOSPITALS CORP,ROUTINE RECONSTRUCTION,211,BRONX,HO-0377,905,828,0,0,0,77,0,0,905,828,0,0,0,77,0,0,905,1656,0,0,0,154,0,0,1810,PROJECT DELAYED DUE TO CHANGES IN SCOPE/DESIGN,"1400 PELHAM PARKWAY SOUTH, BRONX, NY 10461",REHABILITATE MAIN LOBBY CEILING IN BUILDING 6 AT JACOBI MEDICAL CENTER.,cpd11-20bx.pdf
21201901,JMC,819,HEALTH AND HOSPITALS CORP,ROUTINE RECONSTRUCTION,,BRONX,HO-0214,346,209,138,0,0,0,0,0,347,209,138,0,0,0,0,0,347,418,276,0,0,0,0,0,694,PROJECT DELAYED DUE TO CHANGES IN SCOPE/DESIGN,"1400 PELHAM PKWAY SOUTH, BRONX, NY 10461","NYC HEALTH + HOSPITALS / JACOBI, BX",cpd11-20bx.pdf
21202004,JAC,819,HEALTH AND HOSPITALS CORP,ROUTINE RECONSTRUCTION,,BRONX,HO-D003,500,0,778,500,0,0,0,0,1278,0,778,500,0,0,0,0,1278,0,1556,1000,0,0,0,0,2556,,"1400 PELHAM PKWY SOUTH, BRONX",RENOVATE AND UPGRADE JACOBI'S WELLNESS CENTER LOCATED ON THE CELLAR LEVEL OF BUILDING,cpd11-20bx.pdf
21202101,HVAC SYSTEM LAB UPGRADE,819,HEALTH AND HOSPITALS CORP,ROUTINE RECONSTRUCTION,,BRONX,HO-0214,1547,0,0,1547,0,0,0,0,1547,0,0,1547,0,0,0,0,1547,0,0,3094,0,0,0,0,3094,,"1400 PELHAM PARKWAY SOUTH, BRONX NY 10461",HVAC SYSTEM LAB UPGRADE,cpd11-20bx.pdf
24201502,NCB,819,HEALTH AND HOSPITALS CORP,ROUTINE RECONSTRUCTION,,BRONX,HO-D003,1200,0,0,0,0,83,0,0,83,0,0,0,0,83,0,0,83,0,0,0,0,166,0,0,166,PROJECT DELAYED DUE TO CHANGES IN SCOPE/DESIGN,,RENOVATE THE NURSING AND DELIVERY SUITE AT NORTH CENTRAL BRONX HOSPITAL AND RE-OPEN,cpd11-20bx.pdf
24201610,RENOVATE TREMONT HEALTH CLINIC,819,HEALTH AND HOSPITALS CORP,ROUTINE RECONSTRUCTION,206,BRONX,HO-0214,841,1186,0,0,0,54,0,0,1240,1186,0,0,0,54,0,0,1240,2372,0,0,0,108,0,0,2480,PROJECT DELAYED DUE TO CHANGES IN SCOPE/DESIGN,"1826 ARTHUR AVENUE, BRONX, NY 10457",RENOVATE TREMONT HEALTH CLINIC IN ORDER TO EXPAND PRIMARY CARE HEALTHSERVICES.,cpd11-20bx.pdf
24201901,NCB,819,HEALTH AND HOSPITALS CORP,ROUTINE RECONSTRUCTION,,BRONX,HO-0214,12448,888,0,641,0,10919,0,0,12448,888,0,641,0,10919,0,0,12448,1776,0,1282,0,21838,0,0,24896,,"3424 KOSUTH AVENUE, BRONX, NY",FACADE REHABILIATION AND WINDOW REPLACEMENT,cpd11-20bx.pdf
24201920,NCB,819,HEALTH AND HOSPITALS CORP,MAJOR MEDICAL EQUIPMENT,,BRONX,HO-0214,192,0,192,0,0,0,0,0,192,0,192,0,0,0,0,0,192,0,384,0,0,0,0,0,384,,"3424 KOSSUTH AVENUE, BRONX, NEW YORK 10467",,cpd11-20bx.pdf
24202001,NORTH CENTRAL BRONX HOSPITAL - ELEVATOR UPGRADE,819,HEALTH AND HOSPITALS CORP,ROUTINE RECONSTRUCTION,,BRONX,HO-X002,900,0,900,0,0,0,0,0,900,0,900,0,0,0,0,0,900,0,1800,0,0,0,0,0,1800,,3424 KOSSUTH AVENUE,NORTH CENTRAL BRONX HOSPITAL - ELEVATOR UPGRADE,cpd11-20bx.pdf
25201262,LINCOLN,819,HEALTH AND HOSPITALS CORP,MAJOR MEDICAL EQUIPMENT,201,BRONX,HO-0214,7700,7372,357,0,0,0,0,0,7729,7372,357,0,0,0,0,0,7729,14744,714,0,0,0,0,0,15458,PROJECT DELAYED DUE TO CHANGES IN SCOPE/DESIGN,"234 EAST 149 STREET, BRONX, NY 10451",,cpd11-20bx.pdf
25201401,LINCOLN,819,HEALTH AND HOSPITALS CORP,ROUTINE RECONSTRUCTION,201,BRONX,HO-D003 HO-X002,1248,2,109,1137,0,0,0,0,1248,2,109,1137,0,0,0,0,1248,4,218,2274,0,0,0,0,2496,PROJECT DELAYED DUE TO CHANGES IN SCOPE/DESIGN,"234 149TH STREET, BRONX, NY 10451",RENOVATE AND MODERNIZE ADOLESCENT AND PEDIATRIC CLINIC AT LINCOLN MEDICAL CENTER.,cpd11-20bx.pdf
25201601,LINCOLN,819,HEALTH AND HOSPITALS CORP,ROUTINE RECONSTRUCTION,201,BRONX,HO-0214,11235,10434,0,0,0,801,0,0,11235,10434,0,0,0,801,0,0,11235,20868,0,0,0,1602,0,0,22470,PROJECT DELAYED DUE TO CHANGES IN SCOPE/DESIGN,"234 EAST 149TH STREET, BRONX, NY 10451",REPLACE COOLING TOWER AT LINCOLN MEDICAL & MENTAL HEALTH CENTER,cpd11-20bx.pdf
25201602,LINCOLN,819,HEALTH AND HOSPITALS CORP,ROUTINE RECONSTRUCTION,,BRONX,HO-0214,9834,252,16845,2518,0,0,0,0,19615,252,16845,2518,0,0,0,0,19615,504,33690,5036,0,0,0,0,39230,PROJECT DELAYED DUE TO CHANGES IN SCOPE/DESIGN,"234 EAST 149TH STREET, BRONX, NY 10451",REPLACE UNDERGROUND FUEL TANKS AT LINCOLN MEDICAL & MENTAL HEALTH CENTER,cpd11-20bx.pdf
25201604,LINCOLN,819,HEALTH AND HOSPITALS CORP,ROUTINE RECONSTRUCTION,,BRONX,HO-0214,335,0,0,335,0,0,0,0,335,0,0,335,0,0,0,0,335,0,0,670,0,0,0,0,670,,"234 EAST 149TH STREET, BRONX, NY 10451",RESTORE EXTERIOR FACADE TO COMPLY WITH LOCAL LAW 11 GUIDELINES.,cpd11-20bx.pdf
25201701,LINCOLN,819,HEALTH AND HOSPITALS CORP,ROUTINE RECONSTRUCTION,,BRONX,HO-0214,945,212,6069,22,0,0,0,0,6303,212,6069,22,0,0,0,0,6303,424,12138,44,0,0,0,0,12606,,"234 EAST 149TH STREET, BRONX, NY 10451",UPGRADE THE ELECTRICAL PANELS AT LINCOLN MEDICAL & MENTAL HEALTH CENTER.,cpd11-20bx.pdf
25201806,LINCOLN,819,HEALTH AND HOSPITALS CORP,ROUTINE RECONSTRUCTION,,BRONX,HO-0214,3900,82,382,3436,0,0,0,0,3900,82,382,3436,0,0,0,0,3900,164,764,6872,0,0,0,0,7800,,"234 EAST 149TH STREET, BRONX, NY 10451",NYC HEALTH + HOSPITALS ¦ LINCOLN,cpd11-20bx.pdf
25201807,LINCOLN,819,HEALTH AND HOSPITALS CORP,ROUTINE RECONSTRUCTION,,BRONX,HO-0214,501,450,0,0,0,51,0,0,501,450,0,0,0,51,0,0,501,900,0,0,0,102,0,0,1002,,"234 EAST 149TH STREET, BRONX, NY 10451",NYC HEALTH + HOSPITALS ¦ LINCOLN,cpd11-20bx.pdf
25201901,LINCOLN,819,HEALTH AND HOSPITALS CORP,ROUTINE RECONSTRUCTION,,BRONX,HO-0214,686,585,0,226,0,0,0,0,811,585,0,226,0,0,0,0,811,1170,0,452,0,0,0,0,1622,PROJECT DELAYED DUE TO CHANGES IN SCOPE/DESIGN,"EAST 149TH STREET, BRONX, NY 10451",RETAIL PHARMACY RENOVATION AT LINCOLN MEDICAL & MENTAL HEALTH CENTER,cpd11-20bx.pdf
25201942,LINCOLN,819,HEALTH AND HOSPITALS CORP,MAJOR MEDICAL EQUIPMENT,,BRONX,HO-0214,2173,0,2173,0,0,0,0,0,2173,0,2173,0,0,0,0,0,2173,0,4346,0,0,0,0,0,4346,,"234 EAST 149TH STREET, BRONX, NY 10451",,cpd11-20bx.pdf
25202001,LIN,819,HEALTH AND HOSPITALS CORP,ROUTINE RECONSTRUCTION,,BRONX,HO-0214,236,0,236,0,0,0,0,0,236,0,236,0,0,0,0,0,236,0,472,0,0,0,0,0,472,,"234 EAST 149TH STREET, BRONX, NY 10451",LINCOLN MEDICAL & MENTAL HEALTH CENTER,cpd11-20bx.pdf
25202002,LINCOLN MEDICAL CENTER - DEVELOP A BRIDGE CLINIC,819,HEALTH AND HOSPITALS CORP,ROUTINE RECONSTRUCTION,,BRONX,HO-X002,500,0,150,350,0,0,0,0,500,0,150,350,0,0,0,0,500,0,300,700,0,0,0,0,1000,,"234 EAST 149TH STREET, BRONX, NY 10451",LINCOLN MEDICAL CENTER - DEVELOP A BRIDGE CLINIC,cpd11-20bx.pdf
25202003,LINCOLN,819,HEALTH AND HOSPITALS CORP,ROUTINE RECONSTRUCTION,,BRONX,HO-0214,515,0,0,515,0,0,0,0,515,0,0,515,0,0,0,0,515,0,0,1030,0,0,0,0,1030,,EAST 149TH STREET,NA,cpd11-20bx.pdf
42201301,MORRISANIA,819,HEALTH AND HOSPITALS CORP,ROUTINE RECONSTRUCTION,204,BRONX,HO-D003,345,0,345,0,0,0,0,0,345,0,345,0,0,0,0,0,345,0,690,0,0,0,0,0,690,,"1225 GERARD AVENUE, BRONX, NY 10452",THE DENTAL SUITE AT MORRISANIA D&TC IS IN NEED OF RENOVATION AND NEW EXAM CHAIRS.,cpd11-20bx.pdf
42201515,MORRISANIA,819,HEALTH AND HOSPITALS CORP,ROUTINE RECONSTRUCTION,204,BRONX,HO-D003,588,742,113,0,0,0,0,0,855,742,113,0,0,0,0,0,855,1484,226,0,0,0,0,0,1710,PROJECT DELAYED DUE TO CHANGES IN SCOPE/DESIGN,"1225 GERARD AVENUE, BRONX, NY 10452",RECONIGURE EXISTING WOMEN'S HEALTH SERVICES/RADIOLOGY DEPARTMENT TO MAKE SERVICES,cpd11-20bx.pdf
42201901,MORRISANIA,819,HEALTH AND HOSPITALS CORP,ROUTINE RECONSTRUCTION,,BRONX,HO-0214,2425,2388,0,37,0,0,0,0,2425,2388,0,37,0,0,0,0,2425,4776,0,74,0,0,0,0,4850,,"1225 GERARD AVENUE, BRONX, NY 10452","PERFORM EXTERIOR STRUCTURAL RESTORATIONS AT NYC HEALTH + HOSPITALS / GOTHAM HEALTH,",cpd11-20bx.pdf
ACEHHC409,HHC LINCOLN MEDICAL CENTER ENERGY UPGRADE,819,HEALTH AND HOSPITALS CORP,"BUILDING CONSTRUCTION, RECONSTRUCTION OR RETROFIT",,BRONX,HO-0214,13495,12302,1193,0,0,0,0,0,13495,12302,1193,0,0,0,0,0,13495,24604,2386,0,0,0,0,0,26990,,,ENERGY UPGRADE OF TWENTY (20) AIR HANDLER UNITS. UPGRADE OF FLOURESCENT FIXTURES WITH,cpd11-20bx.pdf
ACEHHC606,JMC ENERGY CONSERVATION MEASURES,819,HEALTH AND HOSPITALS CORP,ROUTINE RECONSTRUCTION,,BRONX,HO-0214 PU-0025,11051,10273,0,175,602,0,0,0,11050,10273,0,175,602,0,0,0,11050,20546,0,350,1204,0,0,0,22100,PROJECT DELAYED DUE TO CHANGES IN SCOPE/DESIGN,"1400 PELHAM PARKWAY SOUTH, BRONX, NY 10461",ENERGY CONSERVATION MEASURES AT JACOBI MEDICAL CENTER,cpd11-20bx.pdf
CRO-590,Jerome Park Gate House #7 Sluice Gate and Operator Replacmnt,826,DEPT ENVIRONMENTAL PROTECTION,WATER QUALITY PRESERVATION,207,BRONX,WM-0105,3000,0,0,0,3000,0,0,0,3000,0,0,0,3000,0,0,0,3000,0,0,0,6000,0,0,0,6000,,,JEROME PARK GATE HOUSE #7 SLUICE GATE & OPERATOR REPLACEMENT,cpd11-20bx.pdf
CRO-593,INSTALL. MONO CRANE AND HOIST OF SHUTTERS AT JEROME GATE,826,DEPT ENVIRONMENTAL PROTECTION,WATER QUALITY PRESERVATION,207,BRONX,WM-0105,3000,0,0,0,3000,0,0,0,3000,0,0,0,3000,0,0,0,3000,0,0,0,6000,0,0,0,6000,PROJECT DELAYED DUE TO BUDGETARY CONSTRAINTS,,INSTALL. MONO CRANE AND HOIST OF SHUTTERS AT JEROME GATE,cpd11-20bx.pdf
CRO-604,Croton Filtration Optimization,826,DEPT ENVIRONMENTAL PROTECTION,CROTON FILTER PROJECT,200,BRONX,WM-0011,2300,0,0,0,0,2300,0,0,2300,0,0,0,0,2300,0,0,2300,0,0,0,0,4600,0,0,4600,,,CROTON FILTATION PLANT WRAP UP ITEMS,cpd11-20bx.pdf
CRO-M&A,MITIGATION AND AMENITIES FOR WTP,826,DEPT ENVIRONMENTAL PROTECTION,CROTON FILTER PROJECT,207 208,BRONX,WM-0011,24386,0,0,0,0,0,23386,0,23386,0,0,0,0,0,23386,0,23386,0,0,0,0,0,46772,0,46772,,,MITIGATION AND AMENITIES FOR WTP (IN CONJUNCTION WITH HED-545),cpd11-20bx.pdf
CRO-NCA,NEW CROTON AQUEDUCT,826,DEPT ENVIRONMENTAL PROTECTION,CROTON FILTER PROJECT,207 208,BRONX,WM-0011,116162,176059,149,0,0,0,0,0,176208,176059,149,0,0,0,0,0,176208,352118,298,0,0,0,0,0,352416,PROJECT DELAYED DUE TO BUDGETARY CONSTRAINTS,,NEW CROTON AQUEDUCT,cpd11-20bx.pdf
CS-BX-LTP,BRONX RIVER LONG TERM CONTROL PLAN FOR CSO ABATEMENT,826,DEPT ENVIRONMENTAL PROTECTION,WATER QUALITY MANDATES,200,BRONX,WP-0169,146200,17312,0,0,0,17600,111000,0,145912,17312,0,0,0,17600,111000,0,145912,34624,0,0,0,35200,222000,0,291824,,,CITY-WIDE LONG TERM CONTROL PLAN FOR COMBINED SEWER OVERFLOW ABATEMENT,cpd11-20bx.pdf
CS-ER-WCM,WESTCHESTER CSO MODIFICATIONS,826,DEPT ENVIRONMENTAL PROTECTION,WATER QUALITY MANDATES,200,BRONX,WP-0169,48000,31963,1377,0,0,0,0,0,33340,31963,1377,0,0,0,0,0,33340,63926,2754,0,0,0,0,0,66680,PROJECT DELAYED DUE TO BUDGETARY CONSTRAINTS,,WESTCHESTER CREEK CSO MODIFICATION @EAST RIVER,cpd11-20bx.pdf
CSO-HR-DF,CSO HUTCHINSON RIVER DISINFECTION FACILITY,826,DEPT ENVIRONMENTAL PROTECTION,WATER QUALITY MANDATES,200,BRONX,WP-0169,131000,14472,0,0,0,0,0,218000,232472,14472,0,0,0,0,0,218000,232472,28944,0,0,0,0,0,436000,464944,,,CSO HUTCHINSON RIVER OUTFALL & DISINFECTION,cpd11-20bx.pdf
HBBA24181,"Replacement of WM Infra on E 188 Street, Bronx",826,DEPT ENVIRONMENTAL PROTECTION,AUGMENTATION OF WATER SUPPLY SYSTEMS,206,BRONX,WM-0001,983,0,114,869,0,0,0,0,983,0,114,869,0,0,0,0,983,0,228,1738,0,0,0,0,1966,,,REPLACEMENT/INSTALLATION OF WATER MAIN INFRASTRUCTURE TO CONNECT WITHNYC DOTS,cpd11-20bx.pdf
HED-545,CROTON FILTRATION PLANT,826,DEPT ENVIRONMENTAL PROTECTION,CROTON FILTER PROJECT,207 208,BRONX,WM-0011,1689115,2826738,5522,0,0,0,0,0,2832260,2826738,5522,0,0,0,0,0,2832260,5653476,11044,0,0,0,0,0,5664520,PROJECT DELAYED DUE TO BUDGETARY CONSTRAINTS,THE BRONX,CONSTRUCTION OF CROTON FILTRATION PLANT WRAP UP,cpd11-20bx.pdf
HED-581,"Dist WM rplmt in Mace Ave btwn Olinville & Cruger Ave, BX",826,DEPT ENVIRONMENTAL PROTECTION,AUGMENTATION OF WATER SUPPLY SYSTEMS,200,BRONX,WM-0001,10953,0,0,9957,0,0,0,0,9957,0,0,9957,0,0,0,0,9957,0,0,19914,0,0,0,0,19914,,,DISTRIBUTION WATER MAIN REPLACEMENT WORK IN MACE AVENUE BETWEEN OLINVILLE AVENUE &,cpd11-20bx.pdf
HED-CROOS,CROTON FILTRATION PLANT - OFF-SITE FACILITIES,826,DEPT ENVIRONMENTAL PROTECTION,CROTON FILTER PROJECT,207 208,BRONX,WM-0011,168500,154702,274,0,0,0,0,0,154976,154702,274,0,0,0,0,0,154976,309404,548,0,0,0,0,0,309952,PROJECT DELAYED DUE TO BUDGETARY CONSTRAINTS,,CROTON FILTRATION PLANT - OFF-SITE FACILITIES,cpd11-20bx.pdf
HP-238-L,REPLACEMENT OF THE DIGESTER @ THE HUNTS POINT WWTP,826,DEPT ENVIRONMENTAL PROTECTION,PLANT UPGRADING AND RECONSTRUCTION,200,BRONX,WP-0112,100000,23829,1514,393000,0,0,0,0,418343,23829,1514,393000,0,0,0,0,418343,47658,3028,786000,0,0,0,0,836686,,"COSTER STREET AND RYAWA AVENUE, BRONX, N.Y. 10474",REPLACEMENT OF THE DIGESTER AT THE HUNTS POINT WWTP,cpd11-20bx.pdf
HP-252-L,INSTALL (2) MOTOR CONTROL CENTERS (MCCS) @ HUNTS POINT WWTP,826,DEPT ENVIRONMENTAL PROTECTION,PLANT UPGRADING AND RECONSTRUCTION,200,BRONX,WP-0112,2185,4377,159,0,0,0,0,0,4536,4377,159,0,0,0,0,0,4536,8754,318,0,0,0,0,0,9072,,,INSTALLATION OF TWO (2) MOTOR CONTROL CENTERS (MCCS) AT THE HUNTA POINT WWTP. THE,cpd11-20bx.pdf
HP-253-L,INSTALL EDDY CURRENT DRIVE SYS. FOR MSP @ HUNTS POINT,826,DEPT ENVIRONMENTAL PROTECTION,PLANT UPGRADING AND RECONSTRUCTION,200,BRONX,WP-0112,0,0,0,6700,0,0,0,0,6700,0,0,6700,0,0,0,0,6700,0,0,13400,0,0,0,0,13400,,"1270 RYAWA AVENUE, BRONX, N.Y. 10474",NSTALLATION OF EDDY CURRENT DRIVE SYSTEMS FOR MAIN SEWAGE PUMPS AT HUNTS POINT WWTP.,cpd11-20bx.pdf
HP-254-L,TRC - CONS OF DECHLORINATION FACILITY @ HUNTS POINT WWTP,826,DEPT ENVIRONMENTAL PROTECTION,CONSENT DECREE UPGRADING AND CONSTRUCTION,200,BRONX,WP-0282,22552,0,0,0,20470,0,0,0,20470,0,0,0,20470,0,0,0,20470,0,0,0,40940,0,0,0,40940,,"COSTER STREET & RYAWA AVENUE, BRONX, NEW YORK 10474",CONSTRUCTION OF DECHLORINATION FACILITY TO UTILIZE SODIUM BISULFITE AT THE EFFLUENT AT,cpd11-20bx.pdf
HP-3R,RECONSTRUCTION OF EXISTING DIGESTERS AT HUNTS POINT WPCP,826,DEPT ENVIRONMENTAL PROTECTION,PLANT COMPONENT STABILIZATION,200 202,BRONX,WP-0056,40000,17392,129,0,0,0,0,0,17521,17392,129,0,0,0,0,0,17521,34784,258,0,0,0,0,0,35042,PROJECT DELAYED DUE TO BUDGETARY CONSTRAINTS,,RECONSTRUCT EXISTING DIGESTERS AT HUNTS POINT WATER POLLUTION CONTROLPLANT,cpd11-20bx.pdf
JRAQ-REH,JEROME RESERVOIR & AQUEDUCT REHABILITATION,826,DEPT ENVIRONMENTAL PROTECTION,WATER QUALITY PRESERVATION,207,BRONX,WM-0105,31000,36429,39920,0,0,0,0,0,76349,36429,39920,0,0,0,0,0,76349,72858,79840,0,0,0,0,0,152698,,,JEROME RESERVOIR & AQUEDUCT REHABILITATION,cpd11-20bx.pdf
PS-236A,Throgs Neck Pumping Station Rehabilitation and Improvements,826,DEPT ENVIRONMENTAL PROTECTION,PLANT UPGRADING AND RECONSTRUCTION,200,BRONX,WP-0269,54000,4300,0,49800,0,0,0,0,54100,4300,0,49800,0,0,0,0,54100,8600,0,99600,0,0,0,0,108200,,,RECONSTRUCTION OF THROGS NECK PS,cpd11-20bx.pdf
PS-288,233RD STREET PUMPING STATION,826,DEPT ENVIRONMENTAL PROTECTION,PLANT UPGRADING AND RECONSTRUCTION,200,BRONX,WP-0269,2000,0,0,0,0,0,0,27500,27500,0,0,0,0,0,0,27500,27500,0,0,0,0,0,0,55000,55000,PROJECT DELAYED DUE TO BUDGETARY CONSTRAINTS,233RD STREET PUMPING STATION,233RD STREET PUMPING STATION,cpd11-20bx.pdf
PS-290,CONNER STREET PUMPING STATION,826,DEPT ENVIRONMENTAL PROTECTION,PLANT UPGRADING AND RECONSTRUCTION,200,BRONX,WP-0269,9848,0,0,0,17000,0,0,0,17000,0,0,0,17000,0,0,0,17000,0,0,0,34000,0,0,0,34000,,CONNOR STREET PUMPING STATION,CONNOR STREET PUMPING STATION,cpd11-20bx.pdf
SEX002272,Combined SE Replacement in Davidson Avenue. Bronx,826,DEPT ENVIRONMENTAL PROTECTION,REPLACEMENT OR AUGMENTATION OF EXISTING SYSTEMS,205,BRONX,SE-0002X,239,0,239,0,0,0,0,0,239,0,239,0,0,0,0,0,239,0,478,0,0,0,0,0,478,,,THI PROJECT IS IN CONJUNCTION WITH DOT HIGHWAY PROJECT ID HWXS711 TO REPLACE COMBINED,cpd11-20bx.pdf
SEX002273,Replacement of combined sewers in Bruckner Blvd BRONX,826,DEPT ENVIRONMENTAL PROTECTION,REPLACEMENT OR AUGMENTATION OF EXISTING SYSTEMS,202,BRONX,SE-0002X,1153,0,0,0,1023,0,0,0,1023,0,0,0,1023,0,0,0,1023,0,0,0,2046,0,0,0,2046,,,REPAIR/ REPLACE COMBINES SEWER IN BRUCKNER BOULEVARD AND OTHER LOCATIONS IN THE,cpd11-20bx.pdf
S136-264L,Bronx 5 Garage Roof Replacement,827,DEPARTMENT OF SANITATION,GARAGES AND FACILITIES,205,BRONX,S-0136,0,1311,87,0,0,0,0,0,1398,1311,87,0,0,0,0,0,1398,2622,174,0,0,0,0,0,2796,,,REPLACE ROOF,cpd11-20bx.pdf
S136-332M,BRONX 6/6A GARAGE REHAB,827,DEPARTMENT OF SANITATION,GARAGES AND FACILITIES,206 207,BRONX,S-0136,20240,1935,2173,2417,23392,0,0,0,29917,1935,2173,2417,23392,0,0,0,29917,3870,4346,4834,46784,0,0,0,59834,,,BRONX 6/6A GARAGE REHAB,cpd11-20bx.pdf
S136-424,"Bronx 12 Rehabilitation (Slabs, Roof, Fueling Enclosure)",827,DEPARTMENT OF SANITATION,GARAGES AND FACILITIES,212,BRONX,S-0136,44594,1881,4096,37706,0,0,0,0,43683,1881,4096,37706,0,0,0,0,43683,3762,8192,75412,0,0,0,0,87366,,,FLOOR SLAB REPLACEMENT,cpd11-20bx.pdf
S136-429,Bronx 3A 1661 West Farms Road Garage Reconstruction,827,DEPARTMENT OF SANITATION,GARAGES AND FACILITIES,203,BRONX,S-0136,9891,0,0,0,853,0,6353,0,7206,0,0,0,853,0,6353,0,7206,0,0,0,1706,0,12706,0,14412,,,REHAB,cpd11-20bx.pdf
S136-429D,Bronx 3A 1661 West Farms Road Garage Demolition,827,DEPARTMENT OF SANITATION,GARAGES AND FACILITIES,203,BRONX,S-0136,300,447,2908,0,0,0,0,0,3355,447,2908,0,0,0,0,0,3355,894,5816,0,0,0,0,0,6710,,,DEMOLITION,cpd11-20bx.pdf
S136-440C,Bronx 9/10/11 South Lot Sidewalk and Driveway Rconstruction,827,DEPARTMENT OF SANITATION,GARAGES AND FACILITIES,201,BRONX,S-0136,225,0,225,0,0,0,0,0,225,0,225,0,0,0,0,0,225,0,450,0,0,0,0,0,450,,,DRIVEWAY AND CURB CUT TO ACCESS FUEL STATION,cpd11-20bx.pdf
S136-464G,Bronx 3 Sec 31 Roof Replacement Washington Ave,827,DEPARTMENT OF SANITATION,GARAGES AND FACILITIES,203,BRONX,S-0136,144,0,514,0,0,0,0,0,514,0,514,0,0,0,0,0,514,0,1028,0,0,0,0,0,1028,PROJECT DELAYED DUE TO BUDGETARY CONSTRAINTS,,ROOF REPLACEMENT,cpd11-20bx.pdf
S195-228M,Bronx 2 Salt Shed Rehabilitation,827,DEPARTMENT OF SANITATION,GARAGES AND FACILITIES,202,BRONX,S-0195,350,0,250,0,0,0,0,0,250,0,250,0,0,0,0,0,250,0,500,0,0,0,0,0,500,,,DEMOLISH UNSAFE ROOF,cpd11-20bx.pdf
S248-423,Bronx 9/10/11 Garage Replacement,827,DEPARTMENT OF SANITATION,GARAGES AND FACILITIES,200,BRONX,S-0248,266742,31853,417,0,23000,261586,0,3000,319856,31853,417,0,23000,261586,0,3000,319856,63706,834,0,46000,523172,0,6000,639712,,,REPLACEMENT OF THE BRONX 9/10/11 GARAGES,cpd11-20bx.pdf
SANDBX12G,Hurricane Sandy Bronx 12 Garage R/R & Haz Mitigation,827,DEPARTMENT OF SANITATION,GARAGES AND FACILITIES,212,BRONX,S-0136,1197,143,17,100,0,0,0,0,260,143,17,100,0,0,0,0,260,286,34,200,0,0,0,0,520,,,REPLACEMENT WORK AND HAZRD MITIGATION DUE TO HURRICANE SANDY,cpd11-20bx.pdf
BRX2110,BOSTON ROAD OVER BRONX RIVER BIN,841,DEPARTMENT OF TRANSPORTATION,USEFUL LIFE EXTENSION,200 211,BRONX,HB-0215,12036,1326,0,942,0,19588,0,0,21856,1326,0,942,0,19588,0,0,21856,2652,0,1884,0,39176,0,0,43712,PROJECT DELAYED DUE TO BUDGETARY CONSTRAINTS,,BOSTON ROAD OVER BRONX RIVER ÝBIN,cpd11-20bx.pdf
BRX9579,BOSTON ROAD OVER HUTCHINSON RIVER BIN,841,DEPARTMENT OF TRANSPORTATION,USEFUL LIFE EXTENSION,200 212,BRONX,HB-1070 HB-0215,185832,4908,0,74894,0,0,0,0,79802,4908,0,74894,0,0,0,0,79802,9816,0,149788,0,0,0,0,159604,PROJECT DELAYED DUE TO BUDGETARY CONSTRAINTS,,BOSTON POST ROAD OVER HUTCHINSON RIVER ÝBIN,cpd11-20bx.pdf
BXECONDEV,FA - BX Council for Economic Devel. - Streetscape Furniture,841,DEPARTMENT OF TRANSPORTATION,COMMERCIAL DEVELOPMENT,200,BRONX,ED-D384,1430,754,88,0,0,0,0,0,842,754,88,0,0,0,0,0,842,1508,176,0,0,0,0,0,1684,PROJECT DELAYED DUE TO BUDGETARY CONSTRAINTS,,BRONX COUNCIL FOR ECONOMIC DEVELOPMENT-STREETSCAPE FURNITURE,cpd11-20bx.pdf
CTYISLBRD,Reconstruction of City Island Access Bridge,841,DEPARTMENT OF TRANSPORTATION,RECONSTRUCTION OF FERRY TERMINAL FACILITIES,200,BRONX,FA-0021,5180,6941,763,0,0,0,0,4996,12700,6941,763,0,0,0,0,4996,12700,13882,1526,0,0,0,0,9992,25400,PROJECT DELAYED DUE TO BUDGETARY CONSTRAINTS,,RECON CITY ISLAND ACCESS BRIDGE,cpd11-20bx.pdf
HBBA06672,EAST 174TH ST/SHERIDAN EXPWY AMTRAK BIN# 2066720,841,DEPARTMENT OF TRANSPORTATION,FAIR BRIDGES,200,BRONX,HB-6672,14670,3734,0,6770,0,14330,116621,0,141455,3734,0,6770,0,14330,116621,0,141455,7468,0,13540,0,28660,233242,0,282910,PROJECT DELAYED DUE TO BUDGETARY CONSTRAINTS,EAST 174TH ST/SHERIDAN EXPWY AMTRAK BIN# 2066720,EAST 174TH ST/SHERIDAN EXPWY AMTRAK BIN# 2066720,cpd11-20bx.pdf
HBBA24138,Pelham Bay Park Equestrian over Amtrak- CSX BIN 2241380,841,DEPARTMENT OF TRANSPORTATION,FAIR BRIDGES,200,BRONX,P-0508,41329,1709,0,1402,0,3360,35358,0,41829,1709,0,1402,0,3360,35358,0,41829,3418,0,2804,0,6720,70716,0,83658,,PELHAM BAY PARK EQUESTRIAN OVER AMTRAK- CSX BIN 2241380,PELHAM BAY PARK EQUESTRIAN OVER AMTRAK- CSX BIN 2241380,cpd11-20bx.pdf
HBBA24180,East 183rd St over MNRR Har BIN 2241800,841,DEPARTMENT OF TRANSPORTATION,BRIDGE LIFE EXTENSION AND MISCELLANEOUS WORK,200,BRONX,HB-1139,22339,1010,1054,0,9739,0,0,0,11803,1010,1054,0,9739,0,0,0,11803,2020,2108,0,19478,0,0,0,23606,PROJECT DELAYED DUE TO BUDGETARY CONSTRAINTS,EAST 183RD ST OVER MNRR HAR BIN 2241800,EAST 183RD ST OVER MNRR HAR BIN 2241800,cpd11-20bx.pdf
HBBA24181,East 188th St over MNRR Har BIN 2241810,841,DEPARTMENT OF TRANSPORTATION,FAIR BRIDGES,200,BRONX,HB-1172,30967,1592,1208,0,28967,0,0,0,31767,1592,1208,0,28967,0,0,0,31767,3184,2416,0,57934,0,0,0,63534,PROJECT DELAYED DUE TO BUDGETARY CONSTRAINTS,EAST 188TH ST OVER MNRR HAR BIN 2241810,EAST 188TH ST OVER MNRR HAR BIN 2241810,cpd11-20bx.pdf
HBBA24245,EAST 233RD ST/ BRONX RIVER BIN # 2242459,841,DEPARTMENT OF TRANSPORTATION,FAIR BRIDGES,200,BRONX,HB-1012 HB-0215,24927,1942,0,1191,0,23010,0,0,26143,1942,0,1191,0,23010,0,0,26143,3884,0,2382,0,46020,0,0,52286,,EAST 233RD ST/ BRONX RIVER,EAST 233RD ST/ BRONX RIVER BIN # 2242459,cpd11-20bx.pdf
HBX1086,WESTCHESTER AVE BR OVER HUTCH RIVER PKWY 2-075837,841,DEPARTMENT OF TRANSPORTATION,BRIDGE LIFE EXTENSION AND MISCELLANEOUS WORK,210 211,BRONX,HB-1086,27909,27928,2995,5207,0,0,0,0,36130,27928,2995,5207,0,0,0,0,36130,55856,5990,10414,0,0,0,0,72260,PROJECT DELAYED DUE TO BUDGETARY CONSTRAINTS,,WESTCHESTER AVE BRIDGE,cpd11-20bx.pdf
HBX1103,CONCOURSE VLGE AVE/ M-N 2-24159-0,841,DEPARTMENT OF TRANSPORTATION,FAIR BRIDGES,204,BRONX,HB-1103,10949,1918,2592,0,0,46059,0,0,50569,1918,2592,0,0,46059,0,0,50569,3836,5184,0,0,92118,0,0,101138,PROJECT DELAYED DUE TO BUDGETARY CONSTRAINTS,,,cpd11-20bx.pdf
HBX1127,RECON PELHAM PKWY BRIDGE OVER HUTCHINSON PKWY 2-07584-9,841,DEPARTMENT OF TRANSPORTATION,BRIDGE LIFE EXTENSION AND MISCELLANEOUS WORK,210 211,BRONX,HB-1012 HB-1127,10870,8349,300,0,0,48349,0,0,56998,8349,300,0,0,48349,0,0,56998,16698,600,0,0,96698,0,0,113996,PROJECT DELAYED DUE TO BUDGETARY CONSTRAINTS,,,cpd11-20bx.pdf
HBX1131,BRUCKNER EXP / WESTCHESTER CREEK 1-066510,841,DEPARTMENT OF TRANSPORTATION,FAIR BRIDGES,209 210,BRONX,HB-1131,57008,120622,3620,3290,61,0,0,0,127593,120622,3620,3290,61,0,0,0,127593,241244,7240,6580,122,0,0,0,255186,PROJECT DELAYED DUE TO BUDGETARY CONSTRAINTS,,,cpd11-20bx.pdf
HBX1148B,SHORE ROAD BRIDGE / HUTCHINSON RIVER 2-240200,841,DEPARTMENT OF TRANSPORTATION,FAIR BRIDGES,210,BRONX,HB-1148,113110,14643,1146,2026,0,1150,0,244411,263376,14643,1146,2026,0,1150,0,244411,263376,29286,2292,4052,0,2300,0,488822,526752,PROJECT DELAYED DUE TO BUDGETARY CONSTRAINTS,N/A,,cpd11-20bx.pdf
HBX1190,GRAND CONCOURSE / METRO NORTH RR HUD2-24140-9,841,DEPARTMENT OF TRANSPORTATION,FAIR BRIDGES,204,BRONX,HB-1190,16514,68848,0,4295,0,0,0,0,73143,68848,0,4295,0,0,0,0,73143,137696,0,8590,0,0,0,0,146286,PROJECT DELAYED DUE TO BUDGETARY CONSTRAINTS,NA,,cpd11-20bx.pdf
HBX1215,E. 175TH ST/METRO NORTH RR HAR 2-24174-0 TD PKG 1,841,DEPARTMENT OF TRANSPORTATION,BRIDGE LIFE EXTENSION AND MISCELLANEOUS WORK,200 205,BRONX,HB-4174 TF-0002 TF-0502 HB-1012,5799,6840,11687,3202,0,0,0,0,21729,6840,11687,3202,0,0,0,0,21729,13680,23374,6404,0,0,0,0,43458,PROJECT DELAYED DUE TO BUDGETARY CONSTRAINTS,E. 175TH ST/METRO NORTH RR HAR 2-24174-0,E. 175TH ST/METRO NORTH RR HAR 2-24174-0 TD PKG 1,cpd11-20bx.pdf
HBX1460,WEST TREMONT AVENUE OVER METRO NORTH RR BIN,841,DEPARTMENT OF TRANSPORTATION,BRIDGE LIFE EXTENSION AND MISCELLANEOUS WORK,200 205,BRONX,HB-4146,27508,7298,1710,50315,0,0,0,0,59323,7298,1710,50315,0,0,0,0,59323,14596,3420,100630,0,0,0,0,118646,PROJECT DELAYED DUE TO BUDGETARY CONSTRAINTS,,WEST TREMONT AVENUE OVER METRO NORTH RR ÝBIN,cpd11-20bx.pdf
HBX156,E 156TH ST BRIDGE OVER ACCESS TO HOUSING (BIN 2270030),841,DEPARTMENT OF TRANSPORTATION,FAIR BRIDGES,200 201,BRONX,HB-7003,9916,1886,0,4114,0,60000,0,0,66000,1886,0,4114,0,60000,0,0,66000,3772,0,8228,0,120000,0,0,132000,PROJECT DELAYED DUE TO BUDGETARY CONSTRAINTS,RECONSTRUCTION OF E 156TH ST BRIDGE OVER ACCESS TO HOUSING (BIN 2270030),RECONSTRUCTION OF E 156TH ST BRIDGE OVER ACCESS TO HOUSING (BIN 2270030),cpd11-20bx.pdf
HBX163,"5 Bridges - Melrose, Bronx",841,DEPARTMENT OF TRANSPORTATION,FAIR BRIDGES,200 201,BRONX,HB-0163 HD-0098,14751,22859,2662,0,0,0,0,0,25521,22859,2662,0,0,0,0,0,25521,45718,5324,0,0,0,0,0,51042,,"FIVE BRIDGES - MELROSE, BRONX","FIVE BRIDGES - MELROSE, BRONX",cpd11-20bx.pdf
HBX180,E. 180TH ST OVER METRO NORTH RR HAR (BIN 2-24179-0),841,DEPARTMENT OF TRANSPORTATION,FAIR BRIDGES,200 206,BRONX,HB-1010 TF-0002 TF-0502 WM-0001 HB-0215,8120,8798,24286,1530,0,0,0,0,34614,8798,24286,1530,0,0,0,0,34614,17596,48572,3060,0,0,0,0,69228,PROJECT DELAYED DUE TO BUDGETARY CONSTRAINTS,E. 180TH ST OVER METRO NORTH RR HAR (BIN 2241790),E. 180TH ST OVER METRO NORTH RR HAR (BIN 2241790),cpd11-20bx.pdf
HBX199,E153RD ST BR AT PARK AVE OVER RR,841,DEPARTMENT OF TRANSPORTATION,BRIDGE LIFE EXTENSION AND MISCELLANEOUS WORK,201 204,BRONX,HB-0061 HB-0199,121223,20773,0,0,0,0,3500,7977,32250,20773,0,0,0,0,3500,7977,32250,41546,0,0,0,0,7000,15954,64500,PROJECT DELAYED DUE TO BUDGETARY CONSTRAINTS,,THE WORK CONSISTS OF DEMOLITION OF THE EAST 153RD STREET BRIDGE OVER TNORTH COMMUTER,cpd11-20bx.pdf
HBX2370,REHAB GRAND CONCOURSE BIN 2242370,841,DEPARTMENT OF TRANSPORTATION,BRIDGE LIFE EXTENSION AND MISCELLANEOUS WORK,200 201 204 205 207,BRONX,HB-1070,17721,0,0,0,0,2077,0,26600,28677,0,0,0,0,2077,0,26600,28677,0,0,0,0,4154,0,53200,57354,PROJECT DELAYED DUE TO BUDGETARY CONSTRAINTS,,REHAB GRAND CONCOURSE BIN 2242370,cpd11-20bx.pdf
HBX644S,MADISON AVE BR - REHAB OF ELECTRICAL AND MECHANICAL SYSTEM,841,DEPARTMENT OF TRANSPORTATION,BRIDGE LIFE EXTENSION AND MISCELLANEOUS WORK,201 204,BRONX,HB-0644,43944,28962,495,1111,0,0,0,0,30568,28962,495,1111,0,0,0,0,30568,57924,990,2222,0,0,0,0,61136,PROJECT DELAYED DUE TO BUDGETARY CONSTRAINTS,MAIDISON AVE BR - SEISMIC RETROFITTING & REHABILITATION,MADISON AVE BR - SEISMIC RETROFITTING & REHABILITATION,cpd11-20bx.pdf
HW2CR19A,Citywide Milling - Bronx,841,DEPARTMENT OF TRANSPORTATION,PRIMARY STREET RESURFACING,200,BRONX,HW-0002X,5857,5555,637,0,0,0,0,0,6192,5555,637,0,0,0,0,0,6192,11110,1274,0,0,0,0,0,12384,PROJECT DELAYED DUE TO BUDGETARY CONSTRAINTS,,CITYWIDE MILLING- BRONX,cpd11-20bx.pdf
HWCWSTPR,NY RESTORATION PROJECT - DEVELOP & DESIGN STREET PIER,841,DEPARTMENT OF TRANSPORTATION,PRIMARY STREET RECONSTRUCTION,,BRONX,HW-X001 HW-D105,2750,0,0,0,0,0,0,2750,2750,0,0,0,0,0,0,2750,2750,0,0,0,0,0,0,5500,5500,PROJECT DELAYED DUE TO BUDGETARY CONSTRAINTS,,NY RESTORATION PROJECT - DEVELOP & DESIGN STREET PIER,cpd11-20bx.pdf
HWS2021X,PRIOR NOTICE SIDEWALK - BRONX,841,DEPARTMENT OF TRANSPORTATION,SIDEWALK RECONSTRUCTION,200,BRONX,HW-0200 P-1331,2280,0,1323,0,0,0,0,0,1323,0,1323,0,0,0,0,0,1323,0,2646,0,0,0,0,0,2646,,PRIOR NOTICE SIDEWALKS - BRONX,PRIOR NOTICE SIDEWALKS - BRONX,cpd11-20bx.pdf
HWX1048A,South Bronx Greenway,841,DEPARTMENT OF TRANSPORTATION,PRIMARY STREET RECONSTRUCTION,200,BRONX,HW-0001X,10259,0,0,0,0,0,0,10259,10259,0,0,0,0,0,0,10259,10259,0,0,0,0,0,0,20518,20518,PROJECT DELAYED DUE TO BUDGETARY CONSTRAINTS,SOUTH BRONX GREENWAY,SOUTH BRONX GREENWAY,cpd11-20bx.pdf
HWX405,Southern Blvd Pedestrian and Bike Improvements,841,DEPARTMENT OF TRANSPORTATION,PRIMARY STREET RECONSTRUCTION,200,BRONX,HW-0001X,9482,0,0,0,0,0,9482,0,9482,0,0,0,0,0,9482,0,9482,0,0,0,0,0,18964,0,18964,PROJECT DELAYED DUE TO BUDGETARY CONSTRAINTS,SOUTHERN BLVD PEDESTRIAN AND BIKE IMPROVEMENTS (BEDFORD PARK BLVD TO E 179TH ST),SOUTHERN BLVD PEDESTRIAN AND BIKE IMPROVEMENTS (BEDFORD PARK BLVD TO E 179TH ST),cpd11-20bx.pdf
HWX711,Bronx River Greenway @ 233rd St,841,DEPARTMENT OF TRANSPORTATION,PRIMARY STREET RECONSTRUCTION,200,BRONX,HW-0001X,750,0,0,0,2625,0,0,0,2625,0,0,0,2625,0,0,0,2625,0,0,0,5250,0,0,0,5250,PROJECT DELAYED DUE TO BUDGETARY CONSTRAINTS,BRONX RIVER GREENWAY @ 233RD ST.,BRONX RIVER GREENWAY @ 233RD ST.,cpd11-20bx.pdf
HWXJEROME,Jerome Avenue Safety Improvements,841,DEPARTMENT OF TRANSPORTATION,PRIMARY STREET RECONSTRUCTION,200,BRONX,HW-0001,48253,0,0,0,0,8553,0,0,8553,0,0,0,0,8553,0,0,8553,0,0,0,0,17106,0,0,17106,PROJECT DELAYED DUE TO BUDGETARY CONSTRAINTS,,JEROME AVENUE SAFETY IMPROVEMENTS,cpd11-20bx.pdf
TFD005X01,DOT Camera install at Clay Avenue Step Street and 169th BX,841,DEPARTMENT OF TRANSPORTATION,SIGNAL INSTALLATION AND COMPUTERIZATION,200,BRONX,TF-D005,75,0,0,75,0,0,0,0,75,0,0,75,0,0,0,0,75,0,0,150,0,0,0,0,150,,,(PB) DOT 169TH STREET CLAY AVENUE--DOT CAMERA INSTALLATION AT CLAY AVENUE STEP STREET,cpd11-20bx.pdf
TFD503X21,CLAY AV.HISTORIC DISTRICT OLD-STYLE ST LAMP BET. E165& 167TH,841,DEPARTMENT OF TRANSPORTATION,INSTALLATION OF LAMPPOSTS AND LUMINAIRES,200 204,BRONX,TF-D503,200,73,0,0,0,127,0,0,200,73,0,0,0,127,0,0,200,146,0,0,0,254,0,0,400,PROJECT DELAYED DUE TO BUDGETARY CONSTRAINTS,CLAY AV. HSITORIC DISTRICT OLD-STYLE LAMP BET. E165& 167TH,CLAY AV. HSITORIC DISTRICT OLD-STYLE LAMP BET. E165& 167TH,cpd11-20bx.pdf
TFX50301,GRAND CONCOURSE DECORATIVE STREET LIGHTING,841,DEPARTMENT OF TRANSPORTATION,INSTALLATION OF LAMPPOSTS AND LUMINAIRES,200 201 204 205 207,BRONX,TF-X503,250,654,0,0,0,177,0,0,831,654,0,0,0,177,0,0,831,1308,0,0,0,354,0,0,1662,PROJECT DELAYED DUE TO BUDGETARY CONSTRAINTS,GRAND CONCOURSE DECORATIVE STREET LIGHTING,GRAND CONCOURSE DECORATIVE STREET LIGHTING,cpd11-20bx.pdf
TRANSBCTY,Reconstruction Transfer Bridge Structure at City Island,841,DEPARTMENT OF TRANSPORTATION,RECONSTRUCTION OF FERRY TERMINAL FACILITIES,200,BRONX,FA-0021,3400,0,0,340,0,3060,0,0,3400,0,0,340,0,3060,0,0,3400,0,0,680,0,6120,0,0,6800,,,RECONSTRUCT TRANSFER BRIDGE STRUCTURE AT CITY ISLAND,cpd11-20bx.pdf
GXBXGI-01,Bronx Parkland Green Infrastructure Retrofits,846,DEPT OF PARKS AND RECREATION,LAND ACQUISITION AND TREE PLANTING,200,BRONX,WP-0169 P-D021,2270,604,0,1640,1864,0,0,0,4108,604,0,1640,1864,0,0,0,4108,1208,0,3280,3728,0,0,0,8216,,BRONX PARKLAND GREEN INFRASTRUCTURE RETROFITS,BRONX PARKLAND GREEN INFRASTRUCTURE RETROFITS,cpd11-20bx.pdf
HIF-1FSPB,Franz Sigel Park Ballfields-Install BallField Lighting,846,DEPT OF PARKS AND RECREATION,NEIGHBORHOOD PARKS AND PLAYGROUNDS,200,BRONX,P-D021 ED-0075,9614,903,53,6311,2447,0,0,0,9714,903,53,6311,2447,0,0,0,9714,1806,106,12622,4894,0,0,0,19428,,"GERARD AVE., WALTON AVE., GRAND CONCOURSE BET. E. 151 ST., E. 153 ST.AND E. 158 ST IN THE",FRANZ SIGEL PARK BALLFIELD LIGHTING,cpd11-20bx.pdf
NDF-BRPLG,NDF-Bridge Playground- X148A3-318M,846,DEPT OF PARKS AND RECREATION,NEIGHBORHOOD PARKS AND PLAYGROUNDS,200 204 205,BRONX,P-X245,1575,2522,359,0,0,0,0,0,2881,2522,359,0,0,0,0,0,2881,5044,718,0,0,0,0,0,5762,,HARLEM RIVER BETWEEN W 175 STREET AND ALEXANDER HAMILTON BRIDGE,BRIDGE PLAYGROUND,cpd11-20bx.pdf
NDF-CPFSP,NDF-CORPORAL FISCHER PLAYGROUND X269-119M,846,DEPT OF PARKS AND RECREATION,NEIGHBORHOOD PARKS AND PLAYGROUNDS,200 204,BRONX,ED-0384,4642,394,4642,0,0,0,0,0,5036,394,4642,0,0,0,0,0,5036,788,9284,0,0,0,0,0,10072,,NELSON AVE BET. W169 STREET AND W. 170 ST BOROUGH OF THE BRONX,CORPROAL FISHCER PLAYGROUND CONSTRUCTION,cpd11-20bx.pdf
NDF-DVDSO,Neighborhood Dev. Fund-1801 Davidson,846,DEPT OF PARKS AND RECREATION,NEIGHBORHOOD PARKS AND PLAYGROUNDS,200,BRONX,ED-0384,11233,942,146,10314,0,0,0,0,11402,942,146,10314,0,0,0,0,11402,1884,292,20628,0,0,0,0,22804,,BRONX,NEIGHBORHOOD DEV. FUND-1801 DAVIDSON,cpd11-20bx.pdf
NDF-GRANT,NDF-Grant Park X271-119M,846,DEPT OF PARKS AND RECREATION,NEIGHBORHOOD PARKS AND PLAYGROUNDS,200 204,BRONX,ED-0384 HW-0001M P-X245,25717,2008,1368,24114,0,0,0,0,27490,2008,1368,24114,0,0,0,0,27490,4016,2736,48228,0,0,0,0,54980,,EAST 170 STREET BET SHERIDAN AVENUE AND MORRIS AVENUE,NDF-GRANT PARK -NEW DEVELOPMENT,cpd11-20bx.pdf
NDF-MORTN,NDF-MORTON PLAYGROUND RECONSTRUCTION (X001A),846,DEPT OF PARKS AND RECREATION,"LARGE, MAJOR AND REGIONAL PARK RECONSTRUCTION",200 205 207,BRONX,ED-0384,5216,283,5153,0,0,0,0,0,5436,283,5153,0,0,0,0,0,5436,566,10306,0,0,0,0,0,10872,,MORTON PL & UNIVERSITY AVE BOROUGH OF BRONX,RECONSTRUCTION OF MORTONPLAYGROUND USIING NDF FUNDS,cpd11-20bx.pdf
NDF-SOAQK,NDF-Aqueduct Walk,846,DEPT OF PARKS AND RECREATION,NEIGHBORHOOD PARKS AND PLAYGROUNDS,200,BRONX,ED-0384,10000,0,1000,0,0,9000,0,0,10000,0,1000,0,0,9000,0,0,10000,0,2000,0,0,18000,0,0,20000,,BOROUGH OF BRONX,NDF- RC AQUEDUCT WALK,cpd11-20bx.pdf
P-100CDAR,Cedar Playground - RC C/S X111-114M,846,DEPT OF PARKS AND RECREATION,NEIGHBORHOOD PARKS AND PLAYGROUNDS,200 205,BRONX,P-X245,1200,1193,60,0,86,0,0,0,1339,1193,60,0,86,0,0,0,1339,2386,120,0,172,0,0,0,2678,PROJECT DELAYED DUE TO CHANGES IN SCOPE/DESIGN,"CEDAR PLGD, THE BRONX",CEDAR PLGD RC,cpd11-20bx.pdf
P-101BPAR,Brook Park - sitting area & comfort station,846,DEPT OF PARKS AND RECREATION,NEIGHBORHOOD PARKS AND PLAYGROUNDS,200 204,BRONX,P-D021 P-X245,1850,178,0,0,0,884,0,0,1062,178,0,0,0,884,0,0,1062,356,0,0,0,1768,0,0,2124,PROJECT DELAYED DUE TO UNFORESEEN SITE/FIELD CONDITION,BRONX,BROOK PARK RECON SITTING AREA AND COMFORT STATION.,cpd11-20bx.pdf
P-101LZDA,"Lozada Park Renovation- New play equip.,spray shower, swings",846,DEPT OF PARKS AND RECREATION,NEIGHBORHOOD PARKS AND PLAYGROUNDS,200 201,BRONX,P-0245X,2000,0,0,0,0,2000,0,0,2000,0,0,0,0,2000,0,0,2000,0,0,0,0,4000,0,0,4000,PROJECT DELAYED DUE TO CHANGES IN SCOPE/DESIGN,E 135 ST BET. ALEXANDER AV AND WILLIS AVE IN THE BRONX,"LOZADA PARK RENOVATION - NEW PLAY EQUIPMENT, DRINKING FOUNTAINS, SPRAY SHOWERS,",cpd11-20bx.pdf
P-101MAR2,St. Mary's Plgd West - ADA CS (X045-118M),846,DEPT OF PARKS AND RECREATION,NEIGHBORHOOD PARKS AND PLAYGROUNDS,200,BRONX,P-1018 P-1250,0,2836,419,0,0,0,0,0,3255,2836,419,0,0,0,0,0,3255,5672,838,0,0,0,0,0,6510,,,ST MARY'S PLGD WEST - ADA CS,cpd11-20bx.pdf
P-101PULP,Pulaski Park Reconstruction- X041-118M,846,DEPT OF PARKS AND RECREATION,NEIGHBORHOOD PARKS AND PLAYGROUNDS,200,BRONX,P-0510,1750,3034,259,0,0,0,0,0,3293,3034,259,0,0,0,0,0,3293,6068,518,0,0,0,0,0,6586,,,PULASKI PARK RECONSTRUCTION,cpd11-20bx.pdf
P-101STMH,ST. MARY'S PK REC CTR HVAC X045-116M,846,DEPT OF PARKS AND RECREATION,NEIGHBORHOOD PARKS AND PLAYGROUNDS,200,BRONX,P-1250,1500,2374,11,149,0,0,0,0,2534,2374,11,149,0,0,0,0,2534,4748,22,298,0,0,0,0,5068,PROJECT DELAYED DUE TO UNFORESEEN SITE/FIELD CONDITION,,ST. MARY'S PK REC CTR HVAC,cpd11-20bx.pdf
P-101STMR,"St Mary's plgd (w) ph1 recon w/equip, landscape-X045-215MA",846,DEPT OF PARKS AND RECREATION,NEIGHBORHOOD PARKS AND PLAYGROUNDS,200,BRONX,P-D021 P-1018,1500,4231,2,226,0,0,0,0,4459,4231,2,226,0,0,0,0,4459,8462,4,452,0,0,0,0,8918,PROJECT DELAYED DUE TO CHANGES IN SCOPE/DESIGN,"ST MARY'S PLGD, BRONX","RECON PLGD TO INCLUDE NEW PLDG EQUIP, SAFETY SURFACING, DRINKING WATER, LANDSCAPING",cpd11-20bx.pdf
P-101WLSP,Willis Plgd Recon - X217-118M,846,DEPT OF PARKS AND RECREATION,NEIGHBORHOOD PARKS AND PLAYGROUNDS,200,BRONX,P-D021,3410,469,0,2450,0,0,0,0,2919,469,0,2450,0,0,0,0,2919,938,0,4900,0,0,0,0,5838,,,"WILLIS PLGD RENOV. NEW EQUIPMENT, SAFETY SURFACING &FOUNTAIN",cpd11-20bx.pdf
P-102BRPP,Bill Rainey Park--Lights For Baseball Field & Score Board,846,DEPT OF PARKS AND RECREATION,NEIGHBORHOOD PARKS AND PLAYGROUNDS,200,BRONX,P-D021,1364,141,80,920,0,0,0,0,1141,141,80,920,0,0,0,0,1141,282,160,1840,0,0,0,0,2282,,,BILL RAINEY PARK--LIGHTS FOR BASEBALL FIELD & SCORE BOARD X255-119M,cpd11-20bx.pdf
P-102CEME,"Bronx River - Concrete Plant Park - XG-31700-201M, 205M",846,DEPT OF PARKS AND RECREATION,NEIGHBORHOOD PARKS AND PLAYGROUNDS,202,BRONX,WM-0011,10241,6375,45,0,0,0,0,0,6420,6375,45,0,0,0,0,0,6420,12750,90,0,0,0,0,0,12840,PROJECT DELAYED DUE TO CHANGES IN SCOPE/DESIGN,BRONX,CEMENT PLANT,cpd11-20bx.pdf
P-102HNT2,Hunts Point - Riverside Park - Dock Repair X336-119M,846,DEPT OF PARKS AND RECREATION,NEIGHBORHOOD PARKS AND PLAYGROUNDS,200 202,BRONX,P-D021,100,48,0,0,350,0,0,0,398,48,0,0,350,0,0,0,398,96,0,0,700,0,0,0,796,PROJECT DELAYED DUE TO UNFORESEEN SITE/FIELD CONDITION,HUNTS POINT RIVERSIDE PARK,HUNTS POINT RIVERSIDE PARK DOCK REPAIR PH II,cpd11-20bx.pdf
P-102MNDA,Manida Park-Lighting & Scoreboard Renovation,846,DEPT OF PARKS AND RECREATION,NEIGHBORHOOD PARKS AND PLAYGROUNDS,200,BRONX,P-0245X P-D021,382,181,160,0,1826,0,0,0,2167,181,160,0,1826,0,0,0,2167,362,320,0,3652,0,0,0,4334,PROJECT DELAYED DUE TO CHANGES IN SCOPE/DESIGN,,MANIDA PARK-LIGHTING & SCOREBOARD RENOVATION,cpd11-20bx.pdf
P-102RJPP,Rev. J Polite Plgd-Recon of synthetic turf,846,DEPT OF PARKS AND RECREATION,NEIGHBORHOOD PARKS AND PLAYGROUNDS,200 202,BRONX,P-1018 P-0510,3736,327,508,0,2872,0,0,0,3707,327,508,0,2872,0,0,0,3707,654,1016,0,5744,0,0,0,7414,,REV JAMES POLITE AV TO INTERVAL AV BET. E 167 ST AND HOME ST BRONX,RECON OF SYNTHETIC TURF AT REV. J. POLITE PLAYGROUND,cpd11-20bx.pdf
P-103CGJF,CS-134-Fence and Water Supply- (X340-116MA),846,DEPT OF PARKS AND RECREATION,NEIGHBORHOOD PARKS AND PLAYGROUNDS,200 203,BRONX,P-D021,841,1046,78,0,0,0,0,0,1124,1046,78,0,0,0,0,0,1124,2092,156,0,0,0,0,0,2248,PROJECT DELAYED DUE TO UNFORESEEN SITE/FIELD CONDITION,CS134 COMMUNITY GARDEN AND JACKSON FOREST COMMUNITY GARDEN,ONSTRUCTION OF PERIMETER FENCE & WATER SUPPLY IN CS134 COMMUNITY GARDEN AND WATER,cpd11-20bx.pdf
P-103CPB5,Crotona Park - ballfield #5 * X010-115M,846,DEPT OF PARKS AND RECREATION,"LARGE, MAJOR AND REGIONAL PARK RECONSTRUCTION",200 203,BRONX,P-1018 P-0245X,1000,4585,1167,0,0,0,0,0,5752,4585,1167,0,0,0,0,0,5752,9170,2334,0,0,0,0,0,11504,PROJECT DELAYED DUE TO UNFORESEEN SITE/FIELD CONDITION,BOROUGH OF THE BRONX,CROTONA PARK BALLFIELD# 5,cpd11-20bx.pdf
P-103CPEW,CROTONA PARK GREENWAY - X010-105M,846,DEPT OF PARKS AND RECREATION,"LARGE, MAJOR AND REGIONAL PARK RECONSTRUCTION",203,BRONX,P-0697,1035,245,0,0,0,0,0,0,245,245,0,0,0,0,0,0,245,490,0,0,0,0,0,0,490,PROJECT DELAYED DUE TO UNFORESEEN SITE/FIELD CONDITION,BRONX,CROTONA PARK ENVIRONMENTAL WORK,cpd11-20bx.pdf
P-103CRCS,CROTONA PK COMFORT STATION X010-214M,846,DEPT OF PARKS AND RECREATION,"LARGE, MAJOR AND REGIONAL PARK RECONSTRUCTION",200 203,BRONX,P-0245X P-D021,840,1626,218,0,0,0,0,0,1844,1626,218,0,0,0,0,0,1844,3252,436,0,0,0,0,0,3688,PROJECT DELAYED DUE TO CHANGES IN SCOPE/DESIGN,CROTONA PARK,CROTONA PARK,cpd11-20bx.pdf
P-103CRO1,CROTONA PK LIGHTING FOR B/F X010-116M,846,DEPT OF PARKS AND RECREATION,"LARGE, MAJOR AND REGIONAL PARK RECONSTRUCTION",200 203,BRONX,P-1018,250,1736,201,0,0,0,0,0,1937,1736,201,0,0,0,0,0,1937,3472,402,0,0,0,0,0,3874,PROJECT DELAYED DUE TO CHANGES IN SCOPE/DESIGN,BOROUGH OF THE BRONX,CROTONA PARK,cpd11-20bx.pdf
P-103DPLS,Drew Playground Security Lighting X021-119M,846,DEPT OF PARKS AND RECREATION,NEIGHBORHOOD PARKS AND PLAYGROUNDS,200,BRONX,P-1018,420,503,67,0,0,0,0,0,570,503,67,0,0,0,0,0,570,1006,134,0,0,0,0,0,1140,,,SECURITY LIGHTING,cpd11-20bx.pdf
P-103WPBC,Waring Plgd Basketball Courts Recon (X002-118M),846,DEPT OF PARKS AND RECREATION,NEIGHBORHOOD PARKS AND PLAYGROUNDS,200,BRONX,P-0245X P-D021 P-X245,500,533,0,3054,0,0,0,0,3587,533,0,3054,0,0,0,0,3587,1066,0,6108,0,0,0,0,7174,PROJECT DELAYED DUE TO UNFORESEEN SITE/FIELD CONDITION,,WARING PLGD BASKETBALL COURTS RECON (X002-,cpd11-20bx.pdf
P-104CLMT,Claremont Park Improvements,846,DEPT OF PARKS AND RECREATION,"LARGE, MAJOR AND REGIONAL PARK RECONSTRUCTION",200,BRONX,P-D021,2418,29,0,0,0,418,0,0,447,29,0,0,0,418,0,0,447,58,0,0,0,836,0,0,894,PROJECT DELAYED DUE TO CHANGES IN SCOPE/DESIGN,"CLAY AVE., ANTHONY AVE. BET. MOUNT EDEN PKWY. AND E. 170 ST IN THE BRONX",CLAREMONT PARK IMPROVEMENTS,cpd11-20bx.pdf
P-104FISH,Cons of 182nd St. Fish Passage Dam X002-111M,846,DEPT OF PARKS AND RECREATION,NEIGHBORHOOD PARKS AND PLAYGROUNDS,200 206 204,BRONX,P-X245,1572,1390,101,0,0,0,0,0,1491,1390,101,0,0,0,0,0,1491,2780,202,0,0,0,0,0,2982,PROJECT DELAYED DUE TO UNFORESEEN SITE/FIELD CONDITION,"182ND ST, BRONX",CONST OF 182ND ST FISH PASSAGE DAM,cpd11-20bx.pdf
P-104GBLE,"Goble Playground- new BBall equip., swings, handball court",846,DEPT OF PARKS AND RECREATION,NEIGHBORHOOD PARKS AND PLAYGROUNDS,200 204,BRONX,P-D021,1750,0,100,0,3628,1750,0,0,5478,0,100,0,3628,1750,0,0,5478,0,200,0,7256,3500,0,0,10956,PROJECT DELAYED DUE TO CHANGES IN SCOPE/DESIGN,GOBLE PL BET. INWOOD AV AND MACOMBS RD IN THE BRONX,"GOBLE PLAYGROUND -- NEW BASKETBALL EQUIPMENT, SWINGS, AND HANDBALL COURT.",cpd11-20bx.pdf
P-104GPPV,Grant Avenue Park - Reconst of playground ( X271-115M),846,DEPT OF PARKS AND RECREATION,NEIGHBORHOOD PARKS AND PLAYGROUNDS,200 204,BRONX,P-0245X,2000,4076,206,0,0,0,0,0,4282,4076,206,0,0,0,0,0,4282,8152,412,0,0,0,0,0,8564,PROJECT DELAYED DUE TO UNFORESEEN SITE/FIELD CONDITION,BRONX,CHARLTON GARDEN PHASE II PASSIVE AREA,cpd11-20bx.pdf
P-104HGBG,Highbridge Park - step streets/park ldscape X120-110M,846,DEPT OF PARKS AND RECREATION,NEIGHBORHOOD PARKS AND PLAYGROUNDS,200 204 205,BRONX,P-D021 P-1018,200,5705,611,0,0,0,0,0,6316,5705,611,0,0,0,0,0,6316,11410,1222,0,0,0,0,0,12632,PROJECT DELAYED DUE TO CHANGES IN SCOPE/DESIGN,W 170 STREET UNIVERSITY AVE & HIGHBRIDGE,$1437K FY19 P1018 TRSF FR P-6517CBF...,cpd11-20bx.pdf
P-104HPRM,Bridge Park-Highbridge Greenway promenade,846,DEPT OF PARKS AND RECREATION,NEIGHBORHOOD PARKS AND PLAYGROUNDS,200 204,BRONX,P-D021 P-X245,600,558,0,0,1692,0,0,0,2250,558,0,0,1692,0,0,0,2250,1116,0,0,3384,0,0,0,4500,PROJECT DELAYED DUE TO UNFORESEEN SITE/FIELD CONDITION,HIGHBRIDGE IN THE BRONX,EXPANSION OF THE GREENWAY TO IMMEDIATE NORTH OF HIGHBRIDGE FOR A SMALL PARK AREA AND,cpd11-20bx.pdf
P-104JKIL,Joyce Kilmer Park - Fencing (X028-114M),846,DEPT OF PARKS AND RECREATION,NEIGHBORHOOD PARKS AND PLAYGROUNDS,200 204,BRONX,P-0245X P-D021,886,1114,0,17,0,0,0,0,1131,1114,0,17,0,0,0,0,1131,2228,0,34,0,0,0,0,2262,PROJECT DELAYED DUE TO UNFORESEEN SITE/FIELD CONDITION,"JOYCE KILMER PARK, THE BRONX",JOYCE KILMER PARK FENCING,cpd11-20bx.pdf
P-104JRME,Jerome Playground S- Handball courts renovation,846,DEPT OF PARKS AND RECREATION,NEIGHBORHOOD PARKS AND PLAYGROUNDS,200 204,BRONX,P-D021 P-X245,1800,392,245,0,0,1900,0,0,2537,392,245,0,0,1900,0,0,2537,784,490,0,0,3800,0,0,5074,PROJECT DELAYED DUE TO CHANGES IN SCOPE/DESIGN,S/S CROSS BRONX EXWY BET. TOWNSEND AV AND JEROME AVE IN THE BRONX,JEROME PLAYGROUND SOUTH -- HANDBALL COURTS NEED TO BE RENOVATED,cpd11-20bx.pdf
P-104MPSK,Mullaly Park Skate Park Reconstruction,846,DEPT OF PARKS AND RECREATION,NEIGHBORHOOD PARKS AND PLAYGROUNDS,200 204,BRONX,P-0801,2000,0,550,0,0,1450,0,0,2000,0,550,0,0,1450,0,0,2000,0,1100,0,0,2900,0,0,4000,,JEROME AV TO RIVER AV BET. E 164 ST AND MCCLELLAN ST AT CROMWELL AVE IN THE BRONX,MULLALY PARK SKATE PARK RECONSTRUCTION,cpd11-20bx.pdf
P-104NELP,Nelson Bleacher Reconstruction-X168-117M,846,DEPT OF PARKS AND RECREATION,NEIGHBORHOOD PARKS AND PLAYGROUNDS,200,BRONX,P-D021,500,405,0,146,0,0,0,0,551,405,0,146,0,0,0,0,551,810,0,292,0,0,0,0,1102,PROJECT DELAYED DUE TO UNFORESEEN SITE/FIELD CONDITION,,NELSON PLAYGROUND RECONSTRUCTION,cpd11-20bx.pdf
P-104SMPG,Summit Playground - Improvements,846,DEPT OF PARKS AND RECREATION,NEIGHBORHOOD PARKS AND PLAYGROUNDS,204,BRONX,P-D021,0,0,75,0,0,0,0,0,75,0,75,0,0,0,0,0,75,0,150,0,0,0,0,0,150,,,SUMMIT PLAYGROUND - IMPROVEMENTS,cpd11-20bx.pdf
P-105GALO,Galileo Playground - bring surface area to grade,846,DEPT OF PARKS AND RECREATION,NEIGHBORHOOD PARKS AND PLAYGROUNDS,200 205,BRONX,P-D021,1100,0,325,0,0,0,0,0,325,0,325,0,0,0,0,0,325,0,650,0,0,0,0,0,650,,MACOMBS RD BET. W 176 ST AND W 175 ST. IN THE BRONX,GALILEO PLAYGROUND -- FILL AND COMPACT SUBSIDENCE TO BRING SURFACE AREA TO GRADE.,cpd11-20bx.pdf
P-106CMLT,CROTONA MALLS - MOHEGAN LOT - X334-104M,846,DEPT OF PARKS AND RECREATION,"LARGE, MAJOR AND REGIONAL PARK RECONSTRUCTION",206,BRONX,P-D021,1014,897,74,0,0,0,0,0,971,897,74,0,0,0,0,0,971,1794,148,0,0,0,0,0,1942,,BRONX,CROTONA MALLS-MOHEGAN LOT,cpd11-20bx.pdf
P-106MAPE,CPI Phase 2-Mapes Ballfield-X289-118M,846,DEPT OF PARKS AND RECREATION,NEIGHBORHOOD PARKS AND PLAYGROUNDS,200,BRONX,P-0245X P-1018,11379,9462,3333,0,180,0,0,0,12975,9462,3333,0,180,0,0,0,12975,18924,6666,0,360,0,0,0,25950,,,MAPES BALLFIELD,cpd11-20bx.pdf
P-106QUAR,Quarry Ballfield-Cons of synthetic turf soccer fd-X263-119M,846,DEPT OF PARKS AND RECREATION,NEIGHBORHOOD PARKS AND PLAYGROUNDS,200,BRONX,P-0245X,7798,916,0,0,6769,0,0,0,7685,916,0,0,6769,0,0,0,7685,1832,0,0,13538,0,0,0,15370,,,QUARRY BALLFIELD - BRONX,cpd11-20bx.pdf
P-107CPFE,Classic Plgd in Van Cortlandt Park-Install Fitness Equipment,846,DEPT OF PARKS AND RECREATION,"LARGE, MAJOR AND REGIONAL PARK RECONSTRUCTION",200,BRONX,P-D021 P-X245,272,36,0,500,975,0,0,0,1511,36,0,500,975,0,0,0,1511,72,0,1000,1950,0,0,0,3022,PROJECT DELAYED DUE TO CHANGES IN SCOPE/DESIGN,,CLASSIC PLGD IN VAN CORTLANDT PARK-INSTALL FITNESS EQUIPMENT,cpd11-20bx.pdf
P-107DPDR,Devoe Park- Cons of a Dog Run X013-218M,846,DEPT OF PARKS AND RECREATION,NEIGHBORHOOD PARKS AND PLAYGROUNDS,200,BRONX,P-D021 P-0245X,840,160,796,0,0,0,0,0,956,160,796,0,0,0,0,0,956,320,1592,0,0,0,0,0,1912,,,DEVOE PARK-DOG RUN AT ST JAMES PARK AND DEVOE PARK,cpd11-20bx.pdf
P-107KOSS,Kossuth Playground Recon X033-118M,846,DEPT OF PARKS AND RECREATION,NEIGHBORHOOD PARKS AND PLAYGROUNDS,200,BRONX,P-1018 P-X245,660,3726,640,0,0,0,0,0,4366,3726,640,0,0,0,0,0,4366,7452,1280,0,0,0,0,0,8732,PROJECT DELAYED DUE TO UNFORESEEN SITE/FIELD CONDITION,,KOSSUTH PLAYGROUND RECON (X033-,cpd11-20bx.pdf
P-107PPV1,Poe Park - Poe Cottage - ADA ramp X040-116M,846,DEPT OF PARKS AND RECREATION,NEIGHBORHOOD PARKS AND PLAYGROUNDS,200,BRONX,P-D021,444,527,572,0,0,0,0,0,1099,527,572,0,0,0,0,0,1099,1054,1144,0,0,0,0,0,2198,PROJECT DELAYED DUE TO UNFORESEEN SITE/FIELD CONDITION,"POE ARK, BRONX",POE PARK,cpd11-20bx.pdf
P-107SJDR,St. James Park--Dog Run- X044-118M,846,DEPT OF PARKS AND RECREATION,NEIGHBORHOOD PARKS AND PLAYGROUNDS,200,BRONX,P-D021 P-0245X,894,146,831,0,0,0,0,0,977,146,831,0,0,0,0,0,977,292,1662,0,0,0,0,0,1954,,,ST. JAMES PARK--DOG RUN,cpd11-20bx.pdf
P-107SJHV,ST. JAMES PARK HVAC X044-113M,846,DEPT OF PARKS AND RECREATION,NEIGHBORHOOD PARKS AND PLAYGROUNDS,200 207,BRONX,P-1250,840,2122,55,265,0,0,0,0,2442,2122,55,265,0,0,0,0,2442,4244,110,530,0,0,0,0,4884,PROJECT DELAYED DUE TO CHANGES IN SCOPE/DESIGN,ST. JAMES PARK IN BRONX,HVAC SYSTEM AT ST. JAMES PARK,cpd11-20bx.pdf
P-107SJRC,"MISC PARKS, PLGDS, CONS, RC, BX-ST JAMES PARK REC CTR RENOV.",846,DEPT OF PARKS AND RECREATION,NEIGHBORHOOD PARKS AND PLAYGROUNDS,200,BRONX,P-0245X,3200,0,320,0,2880,0,0,0,3200,0,320,0,2880,0,0,0,3200,0,640,0,5760,0,0,0,6400,,,"MISCELLANEOUS PARKS, PLAYGROUNDS, CONSTRUCTION, RECONSTRUCTION, BRONX-- ST. JAMES",cpd11-20bx.pdf
P-107STFA,ST. James Rec. Center,846,DEPT OF PARKS AND RECREATION,NEIGHBORHOOD PARKS AND PLAYGROUNDS,207,BRONX,P-0506,331,0,357,0,0,0,0,0,357,0,357,0,0,0,0,0,357,0,714,0,0,0,0,0,714,,"2550 JEROME AVE, BRONX.",RECONSTRUCTION OF FIRE ALARM AT ST. JAMES REC CENTER.,cpd11-20bx.pdf
P-107WBSK,Williamsbridge Oval const Skate Park- X104-115M,846,DEPT OF PARKS AND RECREATION,NEIGHBORHOOD PARKS AND PLAYGROUNDS,200,BRONX,P-1018,750,1325,0,89,0,0,0,0,1414,1325,0,89,0,0,0,0,1414,2650,0,178,0,0,0,0,2828,PROJECT DELAYED DUE TO CHANGES IN SCOPE/DESIGN,"WILLIAMSBRIDGE OVAL CONST SKATE PARK, BRONX","WILLIAMSBRIDGE OVAL CONST SKATE PARK, BRONX",cpd11-20bx.pdf
P-108EWNP,Ewen Park Installation of adult fitness equipment(X019-119M),846,DEPT OF PARKS AND RECREATION,NEIGHBORHOOD PARKS AND PLAYGROUNDS,200 208,BRONX,P-D021,910,165,64,737,0,0,0,0,966,165,64,737,0,0,0,0,966,330,128,1474,0,0,0,0,1932,,"JOHNSON AV, W 232 ST, RIVERDALE AVE IN THE BRONX",ADULT FITNESS EQUIPMENT AT EWEN PARK -- INSTALLATION OF ADULT FITNESSEQUIPMENT AT EWEN,cpd11-20bx.pdf
P-108FTFR,Washington's Walk Fort Four Plgd comfort station- X038-118M,846,DEPT OF PARKS AND RECREATION,NEIGHBORHOOD PARKS AND PLAYGROUNDS,200,BRONX,P-D021 P-X245 P-0505,700,364,1,0,3585,0,0,0,3950,364,1,0,3585,0,0,0,3950,728,2,0,7170,0,0,0,7900,PROJECT DELAYED DUE TO CHANGES IN SCOPE/DESIGN,RESERVOIR AVENUE & SEDWICK AVENUE,CONSTRUCT NEW COMFORT STATION,cpd11-20bx.pdf
P-108HHPK,Henry Hudson Park basketball court renovation (X080-115M),846,DEPT OF PARKS AND RECREATION,NEIGHBORHOOD PARKS AND PLAYGROUNDS,200,BRONX,P-D021,1000,1143,3,200,0,0,0,0,1346,1143,3,200,0,0,0,0,1346,2286,6,400,0,0,0,0,2692,PROJECT DELAYED DUE TO CHANGES IN SCOPE/DESIGN,"HENRY HUDSON PARK, BRONX",HENRY HUDSON PARK BASKETBALL COURT RENOVATION,cpd11-20bx.pdf
P-108MHDR,Marble Hill Playground - Dog Run,846,DEPT OF PARKS AND RECREATION,NEIGHBORHOOD PARKS AND PLAYGROUNDS,208,BRONX,P-D021,0,0,100,0,0,0,0,0,100,0,100,0,0,0,0,0,100,0,200,0,0,0,0,0,200,,,MARBLE HILL PLAYGROUND - DOG RUN,cpd11-20bx.pdf
P-108MUSM,Van Cortlandt Park - House Museum Renovation,846,DEPT OF PARKS AND RECREATION,MAJOR RECREATIONAL FACILITIES AND FACILITY RECONSTRUCTION,200,BRONX,P-0245X,4650,0,0,4550,0,0,0,0,4550,0,0,4550,0,0,0,0,4550,0,0,9100,0,0,0,0,9100,,,VAN CORTLANDT PARK - HOUSE MUSEUM RENOVATION,cpd11-20bx.pdf
P-108RIVE,RIVERDALE PARK-WETLANDS & SLOPES / X142-101M,846,DEPT OF PARKS AND RECREATION,NEIGHBORHOOD PARKS AND PLAYGROUNDS,208,BRONX,P-0245X,243,158,0,0,0,0,0,0,158,158,0,0,0,0,0,0,158,316,0,0,0,0,0,0,316,,"HUDSON RIVER, W 254 ST, PALISADE AVE, W 232 ST",RECONSTRUCTION OF A FRESHWATER WETLAND AND THE ADJACENT SLOPES,cpd11-20bx.pdf
P-108SETN,Seton Park soccer & ball field X201-113M,846,DEPT OF PARKS AND RECREATION,NEIGHBORHOOD PARKS AND PLAYGROUNDS,200 208,BRONX,P-D021 P-1018,900,1113,275,0,0,0,0,0,1388,1113,275,0,0,0,0,0,1388,2226,550,0,0,0,0,0,2776,PROJECT DELAYED DUE TO CHANGES IN SCOPE/DESIGN,AT INDEPENDENCE AVE & W 232ST,SETON PARK SOCCER FIELD RESURFACE OF JR FIELD AT INDEPENDENCE AVE & W232ST,cpd11-20bx.pdf
P-108SKTE,Van Cortlandt Park - Skate park & Basketballl cou(X092-114M),846,DEPT OF PARKS AND RECREATION,"LARGE, MAJOR AND REGIONAL PARK RECONSTRUCTION",200 208,BRONX,P-1018,1400,1579,1,102,0,0,0,0,1682,1579,1,102,0,0,0,0,1682,3158,2,204,0,0,0,0,3364,PROJECT DELAYED DUE TO UNFORESEEN SITE/FIELD CONDITION,SKATE PARK @ VAN CORTLANDT PARK,SKATE PARK PROJECT,cpd11-20bx.pdf
P-108SPBC,Seton Park Basketball Court Recon (X201-220M),846,DEPT OF PARKS AND RECREATION,NEIGHBORHOOD PARKS AND PLAYGROUNDS,200,BRONX,P-D021 P-D018 P-0245X P-X245,210,145,350,0,3540,0,0,0,4035,145,350,0,3540,0,0,0,4035,290,700,0,7080,0,0,0,8070,PROJECT DELAYED DUE TO UNFORESEEN SITE/FIELD CONDITION,,SETON PARK BASKETBALL COURT RECON (X201-,cpd11-20bx.pdf
P-108SPDU,Spuyten Duyvil Park - pond restoration- X171-116M,846,DEPT OF PARKS AND RECREATION,NEIGHBORHOOD PARKS AND PLAYGROUNDS,200 208,BRONX,P-D021,170,977,141,0,0,0,0,0,1118,977,141,0,0,0,0,0,1118,1954,282,0,0,0,0,0,2236,PROJECT DELAYED DUE TO UNFORESEEN SITE/FIELD CONDITION,"PALISADE AVENUE, JOHNSON AVENUE AND EDSALL AVENUES",POND RESTORATION,cpd11-20bx.pdf
P-108VCBD,Van Cortlandt Pk. Tot Lot Recon (X092-115M),846,DEPT OF PARKS AND RECREATION,"LARGE, MAJOR AND REGIONAL PARK RECONSTRUCTION",200,BRONX,P-1018 P-0245X,2263,3022,300,0,0,0,0,0,3322,3022,300,0,0,0,0,0,3322,6044,600,0,0,0,0,0,6644,PROJECT DELAYED DUE TO CHANGES IN SCOPE/DESIGN,"VAN CORTLANDT PARK CONST OF PLGD ON BDWAY, BRONX","VAN CORTLANDT PARK CONST OF PLGD ON BDWAY, BRONX",cpd11-20bx.pdf
P-108VCIW,Van Cortlandt Park renovate Indian Fields (X092-215M),846,DEPT OF PARKS AND RECREATION,"LARGE, MAJOR AND REGIONAL PARK RECONSTRUCTION",200,BRONX,P-D021,1500,1682,0,318,0,0,0,0,2000,1682,0,318,0,0,0,0,2000,3364,0,636,0,0,0,0,4000,PROJECT DELAYED DUE TO CHANGES IN SCOPE/DESIGN,"VAN CORTLANDT PARK RENOVATE INDIAN LAKE & WOODLAWN, BRONX","VAN CORTLANDT PARK RENOVATE INDIAN LAKE & WOODLAWN, BRONX",cpd11-20bx.pdf
P-108VCPT,Van Cortlandt Park Trails Recon (X092-,846,DEPT OF PARKS AND RECREATION,NEIGHBORHOOD PARKS AND PLAYGROUNDS,200,BRONX,P-0088,543,99,0,0,0,0,0,0,99,99,0,0,0,0,0,0,99,198,0,0,0,0,0,0,198,PROJECT DELAYED DUE TO CHANGES IN SCOPE/DESIGN,,VAN CORTLANDT PARK TRAILS RECON (X092-,cpd11-20bx.pdf
P-108WDLN,WOODLAWN PARK RENOVATIONS,846,DEPT OF PARKS AND RECREATION,NEIGHBORHOOD PARKS AND PLAYGROUNDS,200 208,BRONX,P-D021,250,0,100,0,4600,0,0,0,4700,0,100,0,4600,0,0,0,4700,0,200,0,9200,0,0,0,9400,,"WOODLAWN PLAYGROUND LIES WITHIN VAN CORTLANDT PARK, NEAR VAN CORTLANDT PARK EAST",WOODLAWN PARK -- FUNDING FOR WOODLAWN PARK RENOVATIONS,cpd11-20bx.pdf
P-108WWST,Strong Street Plg Reconstruction,846,DEPT OF PARKS AND RECREATION,NEIGHBORHOOD PARKS AND PLAYGROUNDS,200,BRONX,P-D021 P-X245,1200,150,100,1070,0,1870,0,0,3190,150,100,1070,0,1870,0,0,3190,300,200,2140,0,3740,0,0,6380,PROJECT DELAYED DUE TO CHANGES IN SCOPE/DESIGN,,STRONG STREET PLAYGROUND  RECONSTRUCTION OF PLAYGROUND,cpd11-20bx.pdf
P-109NBLE,Noble Playground - RC Comfort Station X123-118M,846,DEPT OF PARKS AND RECREATION,NEIGHBORHOOD PARKS AND PLAYGROUNDS,200,BRONX,P-X245 P-D021,700,280,1390,0,0,0,0,0,1670,280,1390,0,0,0,0,0,1670,560,2780,0,0,0,0,0,3340,PROJECT DELAYED DUE TO CHANGES IN SCOPE/DESIGN,"NOBLE AVENUE BETWEEN BRONX RIVER AVENUE AND E. 177 STREET, BOROUGH OFBRONX",PHASE 2 RECONSTRUCT COMFORT STATION BUILDING WITH ADA ACCESSIBILITY,cpd11-20bx.pdf
P-109NOBE,Noble Playground Reconstruction (X123-119M),846,DEPT OF PARKS AND RECREATION,NEIGHBORHOOD PARKS AND PLAYGROUNDS,200,BRONX,P-D021,3000,250,200,0,2300,0,0,0,2750,250,200,0,2300,0,0,0,2750,500,400,0,4600,0,0,0,5500,,NOBLE AVE. BET. BRONX RIVER AV AND E 177 ST IN THE BRONX,NYC PARKS - NOBLE PLAYGROUND -- NOBLE PLAYGROUND RECONSTRUCTION,cpd11-20bx.pdf
P-109PAR2,Parque de los Ninos Ph II - track & BField X004A-114M,846,DEPT OF PARKS AND RECREATION,NEIGHBORHOOD PARKS AND PLAYGROUNDS,200 209,BRONX,P-X245 P-1018,2000,3934,611,0,0,0,0,0,4545,3934,611,0,0,0,0,0,4545,7868,1222,0,0,0,0,0,9090,PROJECT DELAYED DUE TO UNFORESEEN SITE/FIELD CONDITION,"PARQUES DE LOS NINOS, BRONX",INSTALLATION OF RUNNING TRACK AND MULTIPURPOSE BALL FIELDS,cpd11-20bx.pdf
P-110CCCS,Co-Op City Park - Comfort Station,846,DEPT OF PARKS AND RECREATION,NEIGHBORHOOD PARKS AND PLAYGROUNDS,200,BRONX,P-0505,4772,159,350,0,3150,0,0,0,3659,159,350,0,3150,0,0,0,3659,318,700,0,6300,0,0,0,7318,,,CO-OP CITY PARK - COMFORT STATION,cpd11-20bx.pdf
P-110CCTY,Co-Op City Park,846,DEPT OF PARKS AND RECREATION,NEIGHBORHOOD PARKS AND PLAYGROUNDS,200,BRONX,P-0245X,14320,25,0,0,1500,9000,0,0,10525,25,0,0,1500,9000,0,0,10525,50,0,0,3000,18000,0,0,21050,PROJECT DELAYED DUE TO CHANGES IN SCOPE/DESIGN,,CO-OP CITY PARK,cpd11-20bx.pdf
P-110CIDR,City Island Dog Run,846,DEPT OF PARKS AND RECREATION,NEIGHBORHOOD PARKS AND PLAYGROUNDS,200,BRONX,P-D021,840,109,0,600,0,0,0,0,709,109,0,600,0,0,0,0,709,218,0,1200,0,0,0,0,1418,,,CITY ISLAND DOG RUN,cpd11-20bx.pdf
P-110EXPA,ORCHARD BEACH BATHHOUSE -- X039-102M/402M,846,DEPT OF PARKS AND RECREATION,BEACHES AND BOARDWALKS,210,BRONX,P-X715,755,557,86,0,0,0,0,0,643,557,86,0,0,0,0,0,643,1114,172,0,0,0,0,0,1286,,"ORCHARD BEACH AT PELHAM BAY PARK, BRONX",RECONSTRUCTION OF PORTIONS OF THE BATH HOUSE AT ORCHARD BEACH IN PELHAM BAY PARK,cpd11-20bx.pdf
P-110FLAG,Ferry Point Park - Flagpole at 911 Memorial Hilltop Grove,846,DEPT OF PARKS AND RECREATION,NEIGHBORHOOD PARKS AND PLAYGROUNDS,210,BRONX,P-D021,0,0,950,0,0,0,0,0,950,0,950,0,0,0,0,0,950,0,1900,0,0,0,0,0,1900,,,FERRY POINT PARK - FLAGPOLE AT 911 MEMORIAL HILLTOP GROVE,cpd11-20bx.pdf
P-110MAN2,Bartow Mansion Structural Stabilization&Carriage House Roof,846,DEPT OF PARKS AND RECREATION,NEIGHBORHOOD PARKS AND PLAYGROUNDS,200,BRONX,P-1018 P-D021,142,0,419,0,0,0,0,0,419,0,419,0,0,0,0,0,419,0,838,0,0,0,0,0,838,,,BARTOW PELL MANSION STRUCTURAL STABILIZATION AND CARRIAGE HOUSE ROOF RECONSTRUCTION,cpd11-20bx.pdf
P-110MANS,PDF - BARTOW PELL MANSION - PORTIONS OF BUILDING X039-506M,846,DEPT OF PARKS AND RECREATION,NEIGHBORHOOD PARKS AND PLAYGROUNDS,200 210,BRONX,P-X245,385,2360,0,500,0,0,0,0,2860,2360,0,500,0,0,0,0,2860,4720,0,1000,0,0,0,0,5720,PROJECT DELAYED DUE TO CHANGES IN SCOPE/DESIGN,"BARTOW PELL MANSION, BRONX, NY",BARTOW PELL MANSION IMPROVEMENTS,cpd11-20bx.pdf
P-110ODFA,Owen Dolen Rec. Center,846,DEPT OF PARKS AND RECREATION,NEIGHBORHOOD PARKS AND PLAYGROUNDS,210,BRONX,P-0506,280,0,309,0,0,0,0,0,309,0,309,0,0,0,0,0,309,0,618,0,0,0,0,0,618,,"2551 WESTCHESTER AVENUE, BRONX.",FIRE ALARM RECONSTRUCTION AT OWEN DOLEN REC. CENTER.,cpd11-20bx.pdf
P-110PFIT,Pelham bay Park - construction of fitness area X039-213M,846,DEPT OF PARKS AND RECREATION,"LARGE, MAJOR AND REGIONAL PARK RECONSTRUCTION",200 210,BRONX,P-1018,500,1199,0,79,0,0,0,0,1278,1199,0,79,0,0,0,0,1278,2398,0,158,0,0,0,0,2556,PROJECT DELAYED DUE TO UNFORESEEN SITE/FIELD CONDITION,"PELHAM BAY PARK, BOROUGH OF THE BRONX",CONSTRUCTION OF FITNESS CENTER IN PELHAM BAY PARK,cpd11-20bx.pdf
P-110PSKT,PELHAM BAY PK- Renovation of Skate Park (X039-220M),846,DEPT OF PARKS AND RECREATION,"LARGE, MAJOR AND REGIONAL PARK RECONSTRUCTION",200 210,BRONX,P-D021,3818,362,13,0,2700,0,0,0,3075,362,13,0,2700,0,0,0,3075,724,26,0,5400,0,0,0,6150,,"HUTCHINSON RIVER, LONG ISLAND SOUND BET. BRONC COUNTY LINE AND MIDDLETOWN RD., WATT",PELHAM BAY PARK- RENOVATION OF SKATE PARK,cpd11-20bx.pdf
P-111BPWF,Bronx PK- Installation of a water fountain,846,DEPT OF PARKS AND RECREATION,"LARGE, MAJOR AND REGIONAL PARK RECONSTRUCTION",200 206 211,BRONX,P-D021,250,34,290,0,0,0,0,0,324,34,290,0,0,0,0,0,324,68,580,0,0,0,0,0,648,,"BURKE AVE., E. 180 ST. BET. DR. KAZAMIROFF BLVD., SOUTHERN BLVD. AND BRONX PARK E.,",BRONX PK- INSTALLATION OF A WATER FOUNTAIN,cpd11-20bx.pdf
P-111FFBB,FRISCH FIELD IN BRONX PK- RENO OF BBALL FIELD,846,DEPT OF PARKS AND RECREATION,"LARGE, MAJOR AND REGIONAL PARK RECONSTRUCTION",200,BRONX,P-D021,2500,0,100,0,2400,2500,0,0,5000,0,100,0,2400,2500,0,0,5000,0,200,0,4800,5000,0,0,10000,,"BURKE AVE., E. 180 ST. BET. DR. KAZAMIROFF BLVD., SOUTHERN BLVD. AND BRONX PARK E.,",FRISCH FIELD IN BRONX PARK- RENO OF BASEBALL FIELD,cpd11-20bx.pdf
P-111LPFE,Cons. of Adult Fitness Equip in Colucci Pk. (X122-117M),846,DEPT OF PARKS AND RECREATION,NEIGHBORHOOD PARKS AND PLAYGROUNDS,200,BRONX,P-0245X,1299,1429,23,77,0,0,0,0,1529,1429,23,77,0,0,0,0,1529,2858,46,154,0,0,0,0,3058,,,CONS. OF ADULT FITNESS EQUIP IN LORETO PK. (X122-,cpd11-20bx.pdf
P-111LRTO,Loreto Park - Recon Soccer field Asphalt to Turf (X163-118M,846,DEPT OF PARKS AND RECREATION,NEIGHBORHOOD PARKS AND PLAYGROUNDS,200,BRONX,P-0245X,1500,822,150,0,0,0,0,0,972,822,150,0,0,0,0,0,972,1644,300,0,0,0,0,0,1944,PROJECT DELAYED DUE TO UNFORESEEN SITE/FIELD CONDITION,,LORETO PARK - RECON SOCCER FIELD ASPHALT TO TURF (X163-,cpd11-20bx.pdf
P-111VCPE,PWOB - Van Cortlandt Park Broadway Entrance Recon- X092-217M,846,DEPT OF PARKS AND RECREATION,NEIGHBORHOOD PARKS AND PLAYGROUNDS,200,BRONX,P-1018,5040,6352,506,127,0,0,0,0,6985,6352,506,127,0,0,0,0,6985,12704,1012,254,0,0,0,0,13970,PROJECT DELAYED DUE TO UNFORESEEN SITE/FIELD CONDITION,,VAN CORTLANDT PARK BROADWAY ENTRANCE RECON,cpd11-20bx.pdf
P-111ZIMP,Zimmerman Playground Basketball Court Recon.-X087-118M,846,DEPT OF PARKS AND RECREATION,NEIGHBORHOOD PARKS AND PLAYGROUNDS,200,BRONX,P-D021,500,43,40,0,0,1572,0,0,1655,43,40,0,0,1572,0,0,1655,86,80,0,0,3144,0,0,3310,PROJECT DELAYED DUE TO CHANGES IN SCOPE/DESIGN,,ZIMMERMAN PLAYGROUND BASKETBALL COURT RECON.,cpd11-20bx.pdf
P-112AGNS,Agnes Haywood Park - basketball court & park house X169-114M,846,DEPT OF PARKS AND RECREATION,NEIGHBORHOOD PARKS AND PLAYGROUNDS,200 212,BRONX,P-D021 P-1018,650,3784,50,158,0,0,0,0,3992,3784,50,158,0,0,0,0,3992,7568,100,316,0,0,0,0,7984,PROJECT DELAYED DUE TO UNFORESEEN SITE/FIELD CONDITION,IN BRONX,AGNES HAYWOOD PK RENOVATE BASKETBALL CT & PKHOUSE,cpd11-20bx.pdf
P-112LACE,BX River Shoelace Pk- Recon of Paths & Entrance (X004-117M),846,DEPT OF PARKS AND RECREATION,NEIGHBORHOOD PARKS AND PLAYGROUNDS,200,BRONX,P-1018,3150,2569,436,0,0,0,0,0,3005,2569,436,0,0,0,0,0,3005,5138,872,0,0,0,0,0,6010,PROJECT DELAYED DUE TO CHANGES IN SCOPE/DESIGN,,THE SHOELACE PARK LINK IS A MULTI-BENEFIT PROJECT TO ENHANCE PEDESTRIAN AND BICYCLE,cpd11-20bx.pdf
P-112SETW,Seton Falls Park Walkways Renovations X092-113M,846,DEPT OF PARKS AND RECREATION,NEIGHBORHOOD PARKS AND PLAYGROUNDS,200 212,BRONX,P-D021 P-X245,1181,81,306,875,0,0,0,0,1262,81,306,875,0,0,0,0,1262,162,612,1750,0,0,0,0,2524,,E. 233 ST. BET. SETON AVE. AND BAYCHESTER AVE. IN THE BRONX,SETON FALLS PARK WALKWAYS RENOVATIONS IN THE BRONX,cpd11-20bx.pdf
P-112WKFD,Wakefield Park Reconstruction (X188-116M),846,DEPT OF PARKS AND RECREATION,NEIGHBORHOOD PARKS AND PLAYGROUNDS,200,BRONX,P-D021 P-1018 P-X245,200,480,4029,0,0,0,0,0,4509,480,4029,0,0,0,0,0,4509,960,8058,0,0,0,0,0,9018,PROJECT DELAYED DUE TO UNFORESEEN SITE/FIELD CONDITION,,WAKEFIELD PARK RECON,cpd11-20bx.pdf
P-113LLSF,Resurfacing of little league fields and sports field in CD13,846,DEPT OF PARKS AND RECREATION,NEIGHBORHOOD PARKS AND PLAYGROUNDS,200,BRONX,P-D021,100,0,0,100,0,0,0,0,100,0,0,100,0,0,0,0,100,0,0,200,0,0,0,0,200,,UNKNOWN,RESURFACING OF LITTLE LEAGUE FIELDS AND OTHER SPORTS FIELDS IN COUNCIL DISTRICT 13,cpd11-20bx.pdf
P-117CPBM,Crotona Park- Install Bluelight Monitors in CD17,846,DEPT OF PARKS AND RECREATION,"LARGE, MAJOR AND REGIONAL PARK RECONSTRUCTION",200 203,BRONX,P-D021,500,0,0,500,0,0,0,0,500,0,0,500,0,0,0,0,500,0,0,1000,0,0,0,0,1000,,"CROTONA PARK NORTH TO SOUTH, FULTON AV TO SOUTHERN BLVD AND CROTONA PARK EAST IN THE",NYC PARKS (CROTONA PARK) -- FUNDS WILL GO TO INSTALL BLUELIGHT MONITORS THROUGHOUT,cpd11-20bx.pdf
P-118FOXP,FOX PLAYGROUND C/S X247-118M,846,DEPT OF PARKS AND RECREATION,NEIGHBORHOOD PARKS AND PLAYGROUNDS,200,BRONX,P-D021,3500,299,0,3490,0,0,0,0,3789,299,0,3490,0,0,0,0,3789,598,0,6980,0,0,0,0,7578,,,FOX PLAYGROUND C/S,cpd11-20bx.pdf
P-1ANCH01,Anchor Pk St.Mary's Park Ballfields &Dog Run Recon X045-318M,846,DEPT OF PARKS AND RECREATION,"LARGE, MAJOR AND REGIONAL PARK RECONSTRUCTION",200,BRONX,P-0568 P-C017 P-C024,10450,9240,453,129,0,0,0,0,9822,9240,453,129,0,0,0,0,9822,18480,906,258,0,0,0,0,19644,,ST MARY'S STREET BETWEEN ST ANNS'S AVE AND JACKSON AVE BRONX,ANCHOR PARK ST. MARY'S PARK BALLFIELDS AND DOG RUN RECON,cpd11-20bx.pdf
P-1ANCH02,"St. Mary's Anchor Pk Ph. 2-Amphi, Plaza &Pathways X045-218M",846,DEPT OF PARKS AND RECREATION,NEIGHBORHOOD PARKS AND PLAYGROUNDS,200,BRONX,P-0568 P-1018,17380,17135,2912,0,0,0,0,0,20047,17135,2912,0,0,0,0,0,20047,34270,5824,0,0,0,0,0,40094,,,"ST. MARY'S ANCHOR PARK PHASE 2-AMPHITHEATER, PLAZA &PATHWAYS",cpd11-20bx.pdf
P-1AQWALK,MLK Triangle/Aqueduct Walk X001-114M,846,DEPT OF PARKS AND RECREATION,"LARGE, MAJOR AND REGIONAL PARK RECONSTRUCTION",200 204 201,BRONX,WM-0011 P-1018,2000,3256,228,0,0,0,0,0,3484,3256,228,0,0,0,0,0,3484,6512,456,0,0,0,0,0,6968,PROJECT DELAYED DUE TO UNFORESEEN SITE/FIELD CONDITION,IN BRONX,MLK TRIANGLE/AQUEDUCT WALK XG-31950-109M,cpd11-20bx.pdf
P-1ARAMEZ,Mezzanine dsgn & cons Aramark Bldg Shops & store X360-119M,846,DEPT OF PARKS AND RECREATION,NEIGHBORHOOD PARKS AND PLAYGROUNDS,200,BRONX,P-1018 P-0505,559,15,6,403,0,0,0,0,424,15,6,403,0,0,0,0,424,30,12,806,0,0,0,0,848,,"850 EAST 138TH STREET, BRONX",MEZZANINE DESIGN AND CONSTRUCTION AT ARAMARK BUILDING (CWS SHOPS AND STOREHOUSE),cpd11-20bx.pdf
P-1BATHGA,Bathgate Avenue Park - X252-102MA,846,DEPT OF PARKS AND RECREATION,NEIGHBORHOOD PARKS AND PLAYGROUNDS,206,BRONX,P-D021,776,726,36,0,0,0,0,0,762,726,36,0,0,0,0,0,762,1452,72,0,0,0,0,0,1524,,"BOUNDED BY WASHINGTON AND BATHGATE AVENUES, EAST 181 ST. AND 182 ST. , BRONX",CONSTRUCTION OF A BALLFIELD IN BATHGATE AVENUE PARK,cpd11-20bx.pdf
P-1BCSPL1,BRONX - ELEC OFFICIALS BLDG REQ - PLMB XG-308M,846,DEPT OF PARKS AND RECREATION,NEIGHBORHOOD PARKS AND PLAYGROUNDS,200,BRONX,WM-0011,281,238,90,0,0,0,0,0,328,238,90,0,0,0,0,0,328,476,180,0,0,0,0,0,656,PROJECT DELAYED DUE TO UNFORESEEN SITE/FIELD CONDITION,BOROUGH OF THE BRONX,BUILDING REQUIREMENTS - PLMB,cpd11-20bx.pdf
P-1BRTPEL,BARTOW PELL MANSION RESTORE THE ORANGERIE,846,DEPT OF PARKS AND RECREATION,NEIGHBORHOOD PARKS AND PLAYGROUNDS,200,BRONX,P-X245,300,0,300,0,0,0,0,0,300,0,300,0,0,0,0,0,300,0,600,0,0,0,0,0,600,,,BARTOW PELL MANSION RESTORATION OF THE ORENGERIE,cpd11-20bx.pdf
P-1BRUCKN,Bruckner Soundview Greenway Connection - XG-31700-104M,846,DEPT OF PARKS AND RECREATION,"LARGE, MAJOR AND REGIONAL PARK RECONSTRUCTION",209,BRONX,P-0963,2148,795,0,0,0,0,0,0,795,795,0,0,0,0,0,0,795,1590,0,0,0,0,0,0,1590,PROJECT DELAYED DUE TO CHANGES IN SCOPE/DESIGN,BRONX RIVER,GREENWAY CONNECTION,cpd11-20bx.pdf
P-1BRXPK1,"Bronx Park, bet. Zones 3 & 5A, Priority 1",846,DEPT OF PARKS AND RECREATION,NEIGHBORHOOD PARKS AND PLAYGROUNDS,200,BRONX,P-1018,600,30,600,0,0,0,0,0,630,30,600,0,0,0,0,0,630,60,1200,0,0,0,0,0,1260,,BRONX,"BRONX PARK, BET. ZONES 3 & 5A, PRIORITY 1",cpd11-20bx.pdf
P-1BRXPK2,"Bronx Park, bet. Zones 3 & 5A, Priority 2",846,DEPT OF PARKS AND RECREATION,NEIGHBORHOOD PARKS AND PLAYGROUNDS,200,BRONX,P-1018,250,0,0,0,250,0,0,0,250,0,0,0,250,0,0,0,250,0,0,0,500,0,0,0,500,,BRONX,"BRONX PARK, BET. ZONES 3 & 5A, PRIORITY 2",cpd11-20bx.pdf
P-1BRXPK3,"Bronx Park, Zone 1",846,DEPT OF PARKS AND RECREATION,NEIGHBORHOOD PARKS AND PLAYGROUNDS,200,BRONX,P-1018,450,0,0,0,450,0,0,0,450,0,0,0,450,0,0,0,450,0,0,0,900,0,0,0,900,,BRONX,"BRONX PARK, ZONE 1",cpd11-20bx.pdf
P-1BWBXP1,"Reconstruction of plgrs, Borough of Bronx (XG-508M)",846,DEPT OF PARKS AND RECREATION,"LARGE, MAJOR AND REGIONAL PARK RECONSTRUCTION",200,BRONX,P-1018,1236,1610,0,0,0,0,0,0,1610,1610,0,0,0,0,0,0,1610,3220,0,0,0,0,0,0,3220,PROJECT DELAYED DUE TO UNFORESEEN SITE/FIELD CONDITION,VARIOUS IN THE BRONX,RC OF PLGRDS,cpd11-20bx.pdf
P-1BWRCTR,WEST BX RECR CTR HVAC RC- X261-116M,846,DEPT OF PARKS AND RECREATION,"LARGE, MAJOR AND REGIONAL PARK RECONSTRUCTION",200,BRONX,P-1250,1228,1321,133,0,0,0,0,0,1454,1321,133,0,0,0,0,0,1454,2642,266,0,0,0,0,0,2908,,,BX REC CTRS HVAC RC,cpd11-20bx.pdf
P-1CASHIL,Castle Hill Park - reconstruction of pier X007-113M,846,DEPT OF PARKS AND RECREATION,NEIGHBORHOOD PARKS AND PLAYGROUNDS,209,BRONX,P-X245,696,1042,50,0,0,0,0,0,1092,1042,50,0,0,0,0,0,1092,2084,100,0,0,0,0,0,2184,PROJECT DELAYED DUE TO UNFORESEEN SITE/FIELD CONDITION,"HART ST., CASTLE HILL AVE",CASTLE HILL PARK - RECONSTRUCTION OF PIER,cpd11-20bx.pdf
P-1CHARLG,Charlton Garden - Phase II X086-108M,846,DEPT OF PARKS AND RECREATION,NEIGHBORHOOD PARKS AND PLAYGROUNDS,200 203,BRONX,P-X245,1050,1697,0,0,230,0,0,0,1927,1697,0,0,230,0,0,0,1927,3394,0,0,460,0,0,0,3854,PROJECT DELAYED PENDING RESOLUTION OF LEGAL ISSUES,BRONX,CHARLTON GARDEN RECONSTRUCTION,cpd11-20bx.pdf
P-1CLEMAB,Roberto Clemente State Park - Activities Building,846,DEPT OF PARKS AND RECREATION,NEIGHBORHOOD PARKS AND PLAYGROUNDS,200,BRONX,P-X245,1000,0,0,0,1000,0,0,0,1000,0,0,0,1000,0,0,0,1000,0,0,0,2000,0,0,0,2000,,"ROBERTO CLEMENTE PARK- ACTIVITIES BUILDING, BRONX.",ROBERTO CLEMENTE STATE PARK - ACTIVITIES BUILDING,cpd11-20bx.pdf
P-1CPI134,CPI PH2 - Playground 134 Reconstruction (X138-117M),846,DEPT OF PARKS AND RECREATION,NEIGHBORHOOD PARKS AND PLAYGROUNDS,200,BRONX,P-1018,3270,5222,2295,0,0,0,0,0,7517,5222,2295,0,0,0,0,0,7517,10444,4590,0,0,0,0,0,15034,,,CPI PH3 - PLAYGROUND 134 RECONSTRUCTION (X138-,cpd11-20bx.pdf
P-1CPIBPG,CPI PH2 - Blackrock Plgd. Recon. (X205-116M),846,DEPT OF PARKS AND RECREATION,NEIGHBORHOOD PARKS AND PLAYGROUNDS,200,BRONX,P-1018,1500,2023,1,216,0,0,0,0,2240,2023,1,216,0,0,0,0,2240,4046,2,432,0,0,0,0,4480,PROJECT DELAYED DUE TO CHANGES IN SCOPE/DESIGN,,CPI- RECONSTRUCTION OF BLACKROCK PLAYGROUND.,cpd11-20bx.pdf
P-1CPIBR2,CPI PH2-174TH St.Plgd/BX River House-Plgd/Mini Pool X159-118,846,DEPT OF PARKS AND RECREATION,NEIGHBORHOOD PARKS AND PLAYGROUNDS,200,BRONX,P-1018,0,4551,132,470,0,0,0,0,5153,4551,132,470,0,0,0,0,5153,9102,264,940,0,0,0,0,10306,,CPI PH2 - 174TH ST. PLGD/BX RIVER HOUSE-PLAYGROUND/MINI POOL,CPI PH2 - 174TH ST. PLGD/BX RIVER HOUSE-PLAYGROUND/MINI POOL,cpd11-20bx.pdf
P-1CPIBR3,CPI PH2-174TH St.Plgd/BX River House- Comfort Stat X159-218M,846,DEPT OF PARKS AND RECREATION,NEIGHBORHOOD PARKS AND PLAYGROUNDS,200,BRONX,P-1018,1516,1518,417,0,0,0,0,0,1935,1518,417,0,0,0,0,0,1935,3036,834,0,0,0,0,0,3870,,,CPI PH2-174TH ST. PLGD/BX RIVER HOUSE- COMFORT STATION,cpd11-20bx.pdf
P-1CPIGAR,CPI PH2 - Garrison Playground (X106-117M),846,DEPT OF PARKS AND RECREATION,NEIGHBORHOOD PARKS AND PLAYGROUNDS,200,BRONX,P-1018,7180,6100,0,764,0,0,0,0,6864,6100,0,764,0,0,0,0,6864,12200,0,1528,0,0,0,0,13728,PROJECT DELAYED DUE TO UNFORESEEN SITE/FIELD CONDITION,,CPI PH 3 - GARRISON PLAYGROUND,cpd11-20bx.pdf
P-1CPIHNT,CPI PH 1- Hunts Point Playground (X113-115M),846,DEPT OF PARKS AND RECREATION,NEIGHBORHOOD PARKS AND PLAYGROUNDS,200,BRONX,P-1018,1500,4200,41,0,0,0,0,0,4241,4200,41,0,0,0,0,0,4241,8400,82,0,0,0,0,0,8482,PROJECT DELAYED DUE TO UNFORESEEN SITE/FIELD CONDITION,"HUNTS POINT PLAYGROUND, BRONX",CPI - HUNTS POINT PLAYGROUND,cpd11-20bx.pdf
P-1CPILCM,CPI Phase 1- Little Claremont Pk X299-116M,846,DEPT OF PARKS AND RECREATION,NEIGHBORHOOD PARKS AND PLAYGROUNDS,200,BRONX,WP-0169,3808,3948,0,69,0,0,0,0,4017,3948,0,69,0,0,0,0,4017,7896,0,138,0,0,0,0,8034,PROJECT DELAYED DUE TO UNFORESEEN SITE/FIELD CONDITION,"CPI PHASE 1- LITTLE CLAREMONT PK , BRONX",CPI PHASE 1- LITTLE CLAREMONT PK X299-116M,cpd11-20bx.pdf
P-1CPIPMT,CPI PH 2 - Plimpton Playground (X148A2-117M),846,DEPT OF PARKS AND RECREATION,NEIGHBORHOOD PARKS AND PLAYGROUNDS,200,BRONX,P-1018,4436,4359,0,626,0,0,0,0,4985,4359,0,626,0,0,0,0,4985,8718,0,1252,0,0,0,0,9970,PROJECT DELAYED DUE TO UNFORESEEN SITE/FIELD CONDITION,,CPI PH 3 - PLIMPTON PLAYGROUND (X1482-,cpd11-20bx.pdf
P-1CPIPRO,CPI Phase 2- Prospect Playground-X148H1-118M,846,DEPT OF PARKS AND RECREATION,NEIGHBORHOOD PARKS AND PLAYGROUNDS,200,BRONX,P-1018,6266,5461,1318,0,0,0,0,0,6779,5461,1318,0,0,0,0,0,6779,10922,2636,0,0,0,0,0,13558,,,CPI PHASE 2- PROSPECT PLAYGROUND,cpd11-20bx.pdf
P-1CRNAPK,Crotona Park RC of the Nature Center X010-114M,846,DEPT OF PARKS AND RECREATION,NEIGHBORHOOD PARKS AND PLAYGROUNDS,200 203,BRONX,P-1018,500,3731,302,178,0,0,0,0,4211,3731,302,178,0,0,0,0,4211,7462,604,356,0,0,0,0,8422,PROJECT DELAYED DUE TO BUDGETARY CONSTRAINTS,"CROTONA PARK, BRONX",CROTONA PARK NATURE CTR - PH I EXTER & INTER RENOV,cpd11-20bx.pdf
P-1CRO17A,Williamsbridge Oval Park - Recr Bldg X104-207M/507M,846,DEPT OF PARKS AND RECREATION,"LARGE, MAJOR AND REGIONAL PARK RECONSTRUCTION",200 207,BRONX,WM-0011,3480,6827,210,0,0,0,0,0,7037,6827,210,0,0,0,0,0,7037,13654,420,0,0,0,0,0,14074,PROJECT DELAYED DUE TO UNFORESEEN SITE/FIELD CONDITION,BX,PORTION OF PARK WORK TO INCLUDE,cpd11-20bx.pdf
P-1CRO17B,WILLIAMSBRIDGE OVAL PLGD 1 & 3 AND SPRAY PLAZA X104-107MA,846,DEPT OF PARKS AND RECREATION,"LARGE, MAJOR AND REGIONAL PARK RECONSTRUCTION",200,BRONX,WM-0011,6100,5723,384,0,0,0,0,0,6107,5723,384,0,0,0,0,0,6107,11446,768,0,0,0,0,0,12214,PROJECT DELAYED DUE TO CHANGES IN SCOPE/DESIGN,INTERSECTION OF VAN CORTLANDT AVENUE EAST AND RESERVOIR OVAL,"RECONST OF PLGDS 1 & 3, AND THE CENTRAL SPRAY PLAZA, IN WILLIAMSBRIDGE OVAL, LOCATED AT",cpd11-20bx.pdf
P-1CRO19,"Harris Park - Recon perimeter,construct new fence X136-115M",846,DEPT OF PARKS AND RECREATION,"LARGE, MAJOR AND REGIONAL PARK RECONSTRUCTION",200,BRONX,WM-0011,1761,1257,344,0,0,0,0,0,1601,1257,344,0,0,0,0,0,1601,2514,688,0,0,0,0,0,3202,PROJECT DELAYED DUE TO CHANGES IN SCOPE/DESIGN,,"RECONSTRUCTION OF PERIMETER, CONSTRUCTION OF FENCE AND SEWER CONNECTION",cpd11-20bx.pdf
P-1CROALG,CROTONA PARK INDIAN LAKE ALGAE REDUCTION,846,DEPT OF PARKS AND RECREATION,NEIGHBORHOOD PARKS AND PLAYGROUNDS,200,BRONX,P-X245 P-0822,500,0,575,0,0,0,0,0,575,0,575,0,0,0,0,0,575,0,1150,0,0,0,0,0,1150,,,CROTONA PARK ALGAE REDUCTION AT INDIAN LAKE IN THE BRONX,cpd11-20bx.pdf
P-1CROT02,BRONX RIVER GNWAY,846,DEPT OF PARKS AND RECREATION,"LARGE, MAJOR AND REGIONAL PARK RECONSTRUCTION",211,BRONX,WM-0011,3502,3245,75,0,0,0,0,0,3320,3245,75,0,0,0,0,0,3320,6490,150,0,0,0,0,0,6640,PROJECT DELAYED DUE TO UNFORESEEN SITE/FIELD CONDITION,,STUDY AND IMPLEMENTATION OF A ONE MILE BRONX RIVER GREENWAY LINK WITHIN BRONX PARK.,cpd11-20bx.pdf
P-1CROT05,Putnam Trail - Acquisition of Right-of-Way- XPUTNAM,846,DEPT OF PARKS AND RECREATION,"LARGE, MAJOR AND REGIONAL PARK RECONSTRUCTION",208,BRONX,WM-0011 P-0056,824,0,726,790,3670,0,0,0,5186,0,726,790,3670,0,0,0,5186,0,1452,1580,7340,0,0,0,10372,PROJECT DELAYED DUE TO UNFORESEEN SITE/FIELD CONDITION,BX,THE AQUISITION OF THE PUTNAM RAILROAD R.O.W. BETWEEN THE CITY LINE AND THE HARLEM RIVER,cpd11-20bx.pdf
P-1CROT06,BRONX RIVER GREENWAY,846,DEPT OF PARKS AND RECREATION,"LARGE, MAJOR AND REGIONAL PARK RECONSTRUCTION",212,BRONX,WM-0011,5001,3493,182,0,0,0,0,0,3675,3493,182,0,0,0,0,0,3675,6986,364,0,0,0,0,0,7350,PROJECT DELAYED DUE TO UNFORESEEN SITE/FIELD CONDITION,BX,CONSTRUCTION OF A NEW PEDESTRIAN BRIDGE IN BRONX PARK OVER PARKWAY AND RIVER TO,cpd11-20bx.pdf
P-1CROT09,Pelham Bay Park,846,DEPT OF PARKS AND RECREATION,"LARGE, MAJOR AND REGIONAL PARK RECONSTRUCTION",209,BRONX,WM-0011,8002,2339,297,0,0,0,0,0,2636,2339,297,0,0,0,0,0,2636,4678,594,0,0,0,0,0,5272,PROJECT DELAYED DUE TO UNFORESEEN SITE/FIELD CONDITION,BX,"DEVELOPMENT OF WATERFRONT AREA NEAR LANDFILL, PLUS GREENWAY LINK AND SEAWALL REPAIR",cpd11-20bx.pdf
P-1CROT12,PUGSLEY CREEK SALT MARSH & BUFFER RESTOR X088-506M&106M OMBP,846,DEPT OF PARKS AND RECREATION,"LARGE, MAJOR AND REGIONAL PARK RECONSTRUCTION",209,BRONX,WM-0011,852,1134,142,0,0,0,0,0,1276,1134,142,0,0,0,0,0,1276,2268,284,0,0,0,0,0,2552,PROJECT DELAYED DUE TO CHANGES IN SCOPE/DESIGN,BX,BOND ACT MATCH TO RESTORE 2.25-ACRE SALT MARSH AREA ON THE NORTHEAST BANK OF PUGSLEY,cpd11-20bx.pdf
P-1CROT13,VC PK- Recon Headhouse & Demolish Greenhouse X092-207M,846,DEPT OF PARKS AND RECREATION,"LARGE, MAJOR AND REGIONAL PARK RECONSTRUCTION",200 207 208 212,BRONX,WM-0011 P-0245X,3001,1111,2573,0,5555,0,0,0,9239,1111,2573,0,5555,0,0,0,9239,2222,5146,0,11110,0,0,0,18478,PROJECT DELAYED DUE TO CHANGES IN SCOPE/DESIGN,BX,THE UPGRADE AND EXPANSION OF THE EXISTING NURSERY. WORK TO INCLUDE CONSTRUCTION AND,cpd11-20bx.pdf
P-1CROT14,AQUEDUCT WALK - COMF. STATION X001-207M/507M,846,DEPT OF PARKS AND RECREATION,"LARGE, MAJOR AND REGIONAL PARK RECONSTRUCTION",205,BRONX,WM-0011,1800,1873,392,0,0,0,0,0,2265,1873,392,0,0,0,0,0,2265,3746,784,0,0,0,0,0,4530,PROJECT DELAYED DUE TO CHANGES IN SCOPE/DESIGN,BX,CONSTRUCTION OF A COMFORT STATION WITH AN OPERATIONS COMPONENT,cpd11-20bx.pdf
P-1CROT19,HARRIS PARK ATHLETIC FIELDS X136-106M,846,DEPT OF PARKS AND RECREATION,"LARGE, MAJOR AND REGIONAL PARK RECONSTRUCTION",207,BRONX,WM-0011,9479,15569,169,0,0,0,0,0,15738,15569,169,0,0,0,0,0,15738,31138,338,0,0,0,0,0,31476,PROJECT DELAYED DUE TO UNFORESEEN HAZARDOUS CONDITION,BX,"RC OF 9 ATHLETIC FIELDS, 3 NEW STAIRCASES AND ADA ACCESS LEADING TO THE PARK.",cpd11-20bx.pdf
P-1CROT28,JEROME PARK RESERVOIR-RECREATIONAL PATHWAY XG-20000-107M,846,DEPT OF PARKS AND RECREATION,"LARGE, MAJOR AND REGIONAL PARK RECONSTRUCTION",208,BRONX,WM-0011,2768,4515,492,0,0,0,0,0,5007,4515,492,0,0,0,0,0,5007,9030,984,0,0,0,0,0,10014,PROJECT DELAYED DUE TO UNFORESEEN SITE/FIELD CONDITION,BX,NEW RECREATIONAL PATHWAY TO BE CONSTRUCTED AROUND THE RESERVOIR.,cpd11-20bx.pdf
P-1CROT32,RECON PATH & MISC WORK @ AQUEDUCT WALK X001-107M,846,DEPT OF PARKS AND RECREATION,"LARGE, MAJOR AND REGIONAL PARK RECONSTRUCTION",207,BRONX,WM-0011,7001,5077,137,0,0,0,0,0,5214,5077,137,0,0,0,0,0,5214,10154,274,0,0,0,0,0,10428,PROJECT DELAYED DUE TO UNFORESEEN SITE/FIELD CONDITION,BX,RC OF FIRST AQUEDUCT SECTION FROM KINGSBRIDGE RD TO MORTON PLACE. SECTION TO INCLUDE,cpd11-20bx.pdf
P-1CROT36,PELHAM PARKWAY MALLS X003-107M,846,DEPT OF PARKS AND RECREATION,"LARGE, MAJOR AND REGIONAL PARK RECONSTRUCTION",211,BRONX,WM-0011,1502,2379,37,0,0,0,0,0,2416,2379,37,0,0,0,0,0,2416,4758,74,0,0,0,0,0,4832,PROJECT DELAYED DUE TO UNFORESEEN SITE/FIELD CONDITION,BX,RC OF THE PELHAM BAY MALLS FROM THE HUTCHINSON RIVER PARKWAY TO BOSTON ROAD.,cpd11-20bx.pdf
P-1CROT42,STORY PLAYGROUND RC OF P. S. 100             X204-106M,846,DEPT OF PARKS AND RECREATION,NEIGHBORHOOD PARKS AND PLAYGROUNDS,200,BRONX,WM-0011,7316,5573,197,0,0,0,0,0,5770,5573,197,0,0,0,0,0,5770,11146,394,0,0,0,0,0,11540,PROJECT DELAYED PENDING APPROVAL OF NECESSARY PERMITS,"TAYLOR AND THIERIOT AVENUES, BRONX",RC OF P.S. 100 (STORY) PLAYGROUND,cpd11-20bx.pdf
P-1CROT44,PUGSLEY CREEK - FIELD OF DREAMS BFLDS & SITEWORK X088-207M,846,DEPT OF PARKS AND RECREATION,NEIGHBORHOOD PARKS AND PLAYGROUNDS,202,BRONX,WM-0011,2201,1172,149,0,0,0,0,0,1321,1172,149,0,0,0,0,0,1321,2344,298,0,0,0,0,0,2642,PROJECT DELAYED DUE TO CHANGES IN SCOPE/DESIGN,BX,CREATION OF 3 BALLFIELDS WITH APPROPRIATE IRRIGATION.,cpd11-20bx.pdf
P-1CROT45,PUGSLEY CREEK PK - Construct basketball court X088-111M,846,DEPT OF PARKS AND RECREATION,NEIGHBORHOOD PARKS AND PLAYGROUNDS,209,BRONX,WM-0011,1202,1356,242,0,0,0,0,0,1598,1356,242,0,0,0,0,0,1598,2712,484,0,0,0,0,0,3196,PROJECT DELAYED DUE TO UNFORESEEN SITE/FIELD CONDITION,BX,CREATION OF A SMALL PLAYGROUND ALONG WHITE PLAINS ROAD AT PATTERSON AVENUE NEAR I.S.,cpd11-20bx.pdf
P-1CROT46,HINES PARK - RECONST OF RETAINING WALL X026-107M,846,DEPT OF PARKS AND RECREATION,NEIGHBORHOOD PARKS AND PLAYGROUNDS,203,BRONX,WM-0011,677,518,37,0,0,0,0,0,555,518,37,0,0,0,0,0,555,1036,74,0,0,0,0,0,1110,PROJECT DELAYED DUE TO UNFORESEEN SITE/FIELD CONDITION,BX,RENOVATION OF PLAYGROUND.,cpd11-20bx.pdf
P-1CROT48,CLARK PLAYGROUND RC X200-105M,846,DEPT OF PARKS AND RECREATION,NEIGHBORHOOD PARKS AND PLAYGROUNDS,201,BRONX,WM-0011,1527,1346,225,0,0,0,0,0,1571,1346,225,0,0,0,0,0,1571,2692,450,0,0,0,0,0,3142,,BX,"PLAYGROUND RC TO INCLUDE NEW PLAY EQUIPMENT, HANDBALL AND BASKETBALL COURT",cpd11-20bx.pdf
P-1CROT51,SEDGWICK PLAYGROUND X158-106M,846,DEPT OF PARKS AND RECREATION,NEIGHBORHOOD PARKS AND PLAYGROUNDS,205,BRONX,WM-0011,172,1941,227,0,0,0,0,0,2168,1941,227,0,0,0,0,0,2168,3882,454,0,0,0,0,0,4336,PROJECT DELAYED DUE TO UNFORESEEN SITE/FIELD CONDITION,BX,"RC OF ENTIRE PLAYGROUND, INCLUDING COMFORT STATION.",cpd11-20bx.pdf
P-1CROT68,MULLALY PARK - SKATE BUILDING X034-207M,846,DEPT OF PARKS AND RECREATION,NEIGHBORHOOD PARKS AND PLAYGROUNDS,299,BRONX,WM-0011,1782,3148,529,0,0,0,0,0,3677,3148,529,0,0,0,0,0,3677,6296,1058,0,0,0,0,0,7354,PROJECT DELAYED DUE TO UNFORESEEN SITE/FIELD CONDITION,MULLALY PARK - BOROUGH OF THE BRONX,RECONSTRUCTION OF THE SKATE BUILDING AT MULLALY PARK,cpd11-20bx.pdf
P-1CROUL1,VAN CORT PLGD & COMF. STAT(SACHKERAH WOODS) X092-400MA/700MA,846,DEPT OF PARKS AND RECREATION,NEIGHBORHOOD PARKS AND PLAYGROUNDS,207,BRONX,WM-0011,2776,2635,73,0,0,0,0,0,2708,2635,73,0,0,0,0,0,2708,5270,146,0,0,0,0,0,5416,PROJECT DELAYED PENDING RESOLUTION OF LEGAL ISSUES,BX,ADDITIONAL FACILITIES TO BE DEVELOPED WITH PLAYGROUND RC,cpd11-20bx.pdf
P-1CRPOFW,Crotona Park -Recon pool perimeter fence & wall X010-314M,846,DEPT OF PARKS AND RECREATION,"LARGE, MAJOR AND REGIONAL PARK RECONSTRUCTION",200,BRONX,P-1018,2448,3151,233,0,0,0,0,0,3384,3151,233,0,0,0,0,0,3384,6302,466,0,0,0,0,0,6768,PROJECT DELAYED DUE TO CHANGES IN SCOPE/DESIGN,,"DEMOLITION OF EXISTING STEEL FENCE WITH WELDED STEEL PLATED AND BARBED WIRE,",cpd11-20bx.pdf
P-1CRPOHS,Crotona Park - pool towers X010-210MA3,846,DEPT OF PARKS AND RECREATION,"LARGE, MAJOR AND REGIONAL PARK RECONSTRUCTION",200 203,BRONX,P-D021 P-1018,500,3190,151,0,0,0,0,0,3341,3190,151,0,0,0,0,0,3341,6380,302,0,0,0,0,0,6682,PROJECT DELAYED DUE TO UNFORESEEN SITE/FIELD CONDITION,CROTONA PARK POOL HOUSE,CROTONA PARK POOL HOUSE - RENOVATION,cpd11-20bx.pdf
P-1DEPOT,Depot Place - portion of Harlem River greenway XG-31800-106M,846,DEPT OF PARKS AND RECREATION,NEIGHBORHOOD PARKS AND PLAYGROUNDS,200 204,BRONX,P-X245 P-1018,1015,1375,11,0,0,0,0,0,1386,1375,11,0,0,0,0,0,1386,2750,22,0,0,0,0,0,2772,PROJECT DELAYED PENDING APPROVAL OF NECESSARY PERMITS,DEPOT PLACE GREENWAY PROJECT,DEPOT PLACE GREENWAY PROJECT,cpd11-20bx.pdf
P-1DEVORF,Recon of Roofing systems at Devoe Park,846,DEPT OF PARKS AND RECREATION,NEIGHBORHOOD PARKS AND PLAYGROUNDS,200,BRONX,P-1249,86,10,74,0,0,0,0,0,84,10,74,0,0,0,0,0,84,20,148,0,0,0,0,0,168,,BRONX,RECON OF ROOFING SYSTEMS AT DEVOE PARK,cpd11-20bx.pdf
P-1ECHOPK,Echo Park Playground and Sports Fields- X017-117M,846,DEPT OF PARKS AND RECREATION,NEIGHBORHOOD PARKS AND PLAYGROUNDS,205,BRONX,P-0245X P-D021 P-1018,5452,4538,743,0,0,0,0,0,5281,4538,743,0,0,0,0,0,5281,9076,1486,0,0,0,0,0,10562,,,RECONSTRUCTION OF THE PLAYGROUND AND SPORTS FIELDS AT ECHO PARK IN THE BRONX.,cpd11-20bx.pdf
P-1ECHORF,Recon of Roofing systems at Echo,846,DEPT OF PARKS AND RECREATION,NEIGHBORHOOD PARKS AND PLAYGROUNDS,200,BRONX,P-1249,86,10,74,0,0,0,0,0,84,10,74,0,0,0,0,0,84,20,148,0,0,0,0,0,168,,BRONX,RECON OF ROOFING SYSTEMS AT ECHO,cpd11-20bx.pdf
P-1EDENPG,Edenwald PLGD - basketball & handball crts (X165-116MA),846,DEPT OF PARKS AND RECREATION,NEIGHBORHOOD PARKS AND PLAYGROUNDS,200 212,BRONX,P-X245 P-0245X P-1018 P-1008,700,382,0,0,3986,0,0,0,4368,382,0,0,3986,0,0,0,4368,764,0,0,7972,0,0,0,8736,PROJECT DELAYED DUE TO CHANGES IN SCOPE/DESIGN,"EDENWALD PLAYGROUND, BRONX",EDENWALD PLAYGROUND - PHASE1 RECONSTRUCT BASKETBALL & HANDBALL COURTS,cpd11-20bx.pdf
P-1EWENPK,Ewen Park - construct playground X019-112M,846,DEPT OF PARKS AND RECREATION,NEIGHBORHOOD PARKS AND PLAYGROUNDS,208,BRONX,P-D021,735,1792,0,135,0,0,0,0,1927,1792,0,135,0,0,0,0,1927,3584,0,270,0,0,0,0,3854,PROJECT DELAYED DUE TO CHANGES IN SCOPE/DESIGN,"JOHNSON AVE, W 232 ST, RIVERDALE AVE",CONSTRUCT NEW PLAY AREA,cpd11-20bx.pdf
P-1FERPNT,Ferry Point Community Park - Adult Fitness Area,846,DEPT OF PARKS AND RECREATION,NEIGHBORHOOD PARKS AND PLAYGROUNDS,200,BRONX,P-X245,400,0,400,0,0,0,0,0,400,0,400,0,0,0,0,0,400,0,800,0,0,0,0,0,800,,,CONSTRUCTION OF ADULT FITNESS AREA - FERRY POINT COMMUNITY PARK - THEBRONX,cpd11-20bx.pdf
P-1FERRY8,Ferry Point Park - Waterfront Park X126-116M,846,DEPT OF PARKS AND RECREATION,"LARGE, MAJOR AND REGIONAL PARK RECONSTRUCTION",200 210,BRONX,P-0720 P-1018,20656,12878,3685,0,0,0,0,0,16563,12878,3685,0,0,0,0,0,16563,25756,7370,0,0,0,0,0,33126,PROJECT DELAYED DUE TO CHANGES IN SCOPE/DESIGN,FERRY POINT WATERFRONT,FERRY POINT WATERFRONT,cpd11-20bx.pdf
P-1GHPCSR,Grove Hill Playground-Comfort Station Reconstruction,846,DEPT OF PARKS AND RECREATION,NEIGHBORHOOD PARKS AND PLAYGROUNDS,200,BRONX,P-0505,2114,1507,185,0,0,0,0,0,1692,1507,185,0,0,0,0,0,1692,3014,370,0,0,0,0,0,3384,,,RECONSTRUCTION OF GROVE HILL PLAYGROUND COMFORT STATION,cpd11-20bx.pdf
P-1GIGP01,St. Mary's Park & Rec Ctr Green Infrastructure XG-413M,846,DEPT OF PARKS AND RECREATION,LAND ACQUISITION AND TREE PLANTING,200,BRONX,P-1018 WP-0169,563,1126,0,34,0,0,0,0,1160,1126,0,34,0,0,0,0,1160,2252,0,68,0,0,0,0,2320,PROJECT DELAYED DUE TO UNFORESEEN SITE/FIELD CONDITION,,FY13 GREEN INNOVATIONS GRANT PROGRAM - BX,cpd11-20bx.pdf
P-1GRAUER,Conrad Grauer field - demo & const of 20 ft fence X150-113M,846,DEPT OF PARKS AND RECREATION,NEIGHBORHOOD PARKS AND PLAYGROUNDS,200 208,BRONX,P-D021,150,515,24,0,36,0,0,0,575,515,24,0,36,0,0,0,575,1030,48,0,72,0,0,0,1150,PROJECT DELAYED DUE TO CHANGES IN SCOPE/DESIGN,"W 233 STREET, BAILEY AVE, W 234TH ST",FENCING HEIGHTENING,cpd11-20bx.pdf
P-1HAFFPT,HAFFEN PARK - CONSTRUCT ADULT FITNESS AREA,846,DEPT OF PARKS AND RECREATION,NEIGHBORHOOD PARKS AND PLAYGROUNDS,200,BRONX,P-X245 P-D021,6020,100,0,1230,6500,0,0,0,7830,100,0,1230,6500,0,0,0,7830,200,0,2460,13000,0,0,0,15660,,,CONSTRUCTION OF ADULT FITNESS AREA - HAFFEN PARK - THE BRONX,cpd11-20bx.pdf
P-1HCMARI,Hammond Cove Marina,846,DEPT OF PARKS AND RECREATION,NEIGHBORHOOD PARKS AND PLAYGROUNDS,200,BRONX,P-D021 P-D721,14020,0,63,357,0,0,0,0,420,0,63,357,0,0,0,0,420,0,126,714,0,0,0,0,840,,,HAMMOND COVE MARIA,cpd11-20bx.pdf
P-1HGCVPR,PWOB-Hugh Grant Circle & Virginia Pk. Recon. XG-117MA,846,DEPT OF PARKS AND RECREATION,NEIGHBORHOOD PARKS AND PLAYGROUNDS,200,BRONX,P-1018,7624,9747,1081,0,151,0,0,0,10979,9747,1081,0,151,0,0,0,10979,19494,2162,0,302,0,0,0,21958,PROJECT DELAYED DUE TO CHANGES IN SCOPE/DESIGN,,HUGH GRANT CIRCLE & VIRGINIA PK. RECON.,cpd11-20bx.pdf
P-1HUNTPT,HUNTS POINT RECREATION CENTER - REPLACE GYMNASIUM FLOOR,846,DEPT OF PARKS AND RECREATION,MAJOR RECREATIONAL FACILITIES AND FACILITY RECONSTRUCTION,200,BRONX,P-X245 P-D021,600,0,500,0,0,100,0,0,600,0,500,0,0,100,0,0,600,0,1000,0,0,200,0,0,1200,,,REPLACEMENT OF GYMNASIUM FLOOR AT HUNTS POINT RECREATION CENTER - THEBRONX,cpd11-20bx.pdf
P-1HVMRCS,Havemeyer Playground C.S.,846,DEPT OF PARKS AND RECREATION,NEIGHBORHOOD PARKS AND PLAYGROUNDS,200,BRONX,P-0505,1698,136,7,0,1487,0,0,0,1630,136,7,0,1487,0,0,0,1630,272,14,0,2974,0,0,0,3260,,,HAVEMEYER PLAYGROUND COMFORT STATION,cpd11-20bx.pdf
P-1IRRIG,Golf Course Irrigation - XG-200M,846,DEPT OF PARKS AND RECREATION,VEHICLES AND EQUIPMENT,200,BRONX,WM-0011,5962,12583,122,0,0,0,0,0,12705,12583,122,0,0,0,0,0,12705,25166,244,0,0,0,0,0,25410,PROJECT DELAYED DUE TO UNFORESEEN SITE/FIELD CONDITION,"VAN CORTLANDT, PELHAM BAY, SPLIT ROCK","VAN CORTLANDT, PELHAM BAY, SPLIT ROCK",cpd11-20bx.pdf
P-1JASPBB,JASPER BASEBALL STADIUM,846,DEPT OF PARKS AND RECREATION,NEIGHBORHOOD PARKS AND PLAYGROUNDS,200,BRONX,P-D021,500,0,0,0,3000,0,0,0,3000,0,0,0,3000,0,0,0,3000,0,0,0,6000,0,0,0,6000,,,"JASPER BASEBALL STADIUM CONSTRUCTION, BRONX",cpd11-20bx.pdf
P-1MELCOM,CPI PH 1- Melrose Commons Site 32 - XG3200-111M,846,DEPT OF PARKS AND RECREATION,NEIGHBORHOOD PARKS AND PLAYGROUNDS,200 201,BRONX,P-1018,4550,6997,2,41,0,0,0,0,7040,6997,2,41,0,0,0,0,7040,13994,4,82,0,0,0,0,14080,PROJECT DELAYED DUE TO UNFORESEEN SITE/FIELD CONDITION,BX,MELROSE COMMONS SITE 32,cpd11-20bx.pdf
P-1MELRO,Melrose Commons URA Site 62 Park Development (X350-119M),846,DEPT OF PARKS AND RECREATION,NEIGHBORHOOD PARKS AND PLAYGROUNDS,200,BRONX,P-0245X,5987,1204,677,0,7774,0,0,0,9655,1204,677,0,7774,0,0,0,9655,2408,1354,0,15548,0,0,0,19310,PROJECT DELAYED DUE TO UNFORESEEN SITE/FIELD CONDITION,,MELROSE COMMONS URA SITE 62 PARK DEVELOPMENT,cpd11-20bx.pdf
P-1OWEND2,OWEN F. DOLEN PK GOLDEN AGE CTR X016-114M,846,DEPT OF PARKS AND RECREATION,NEIGHBORHOOD PARKS AND PLAYGROUNDS,200 209,BRONX,P-X245 P-D021 P-1018,2485,2173,0,631,0,0,0,0,2804,2173,0,631,0,0,0,0,2804,4346,0,1262,0,0,0,0,5608,PROJECT DELAYED DUE TO CHANGES IN SCOPE/DESIGN,"OWEN DOLAN REC CRT, BOROUGH OF THE BRONX",INSTALL NEW ROOF AND WATERPROOF OWEN DOLAN RECREATION CENTER,cpd11-20bx.pdf
P-1OWEND3,OWEN DOLEN RECREATION CENTER - X016-118M,846,DEPT OF PARKS AND RECREATION,NEIGHBORHOOD PARKS AND PLAYGROUNDS,200,BRONX,P-X245 P-D021 P-0506,1364,191,0,0,2343,0,0,0,2534,191,0,0,2343,0,0,0,2534,382,0,0,4686,0,0,0,5068,,,OWEN DOLEN RECREATION CENTER,cpd11-20bx.pdf
P-1PAVMOS,Mosholu Parkway Greenway Pavement Reconstruction (SoGR),846,DEPT OF PARKS AND RECREATION,NEIGHBORHOOD PARKS AND PLAYGROUNDS,200,BRONX,P-1018,1350,10,200,1150,0,0,0,0,1360,10,200,1150,0,0,0,0,1360,20,400,2300,0,0,0,0,2720,,THE BRONX,MOSHOLU PARKWAY GREENWAY PAVEMENT RECONSTRUCTION (SOGR),cpd11-20bx.pdf
P-1PDSMRC,PDF -St. Mary's Rec Ctr RC X045-115M,846,DEPT OF PARKS AND RECREATION,MAJOR RECREATIONAL FACILITIES AND FACILITY RECONSTRUCTION,200,BRONX,P-1018 P-0506,4000,886,1,0,6214,0,0,0,7101,886,1,0,6214,0,0,0,7101,1772,2,0,12428,0,0,0,14202,PROJECT DELAYED DUE TO CHANGES IN SCOPE/DESIGN,BRONX,ST. MARY'S REC CTR,cpd11-20bx.pdf
P-1PELBRV,Pelham parkway -connection to Bronx river greenwayX002-211M,846,DEPT OF PARKS AND RECREATION,NEIGHBORHOOD PARKS AND PLAYGROUNDS,200 211,BRONX,P-0245X,300,999,0,0,0,0,0,0,999,999,0,0,0,0,0,0,999,1998,0,0,0,0,0,0,1998,PROJECT DELAYED DUE TO CHANGES IN SCOPE/DESIGN,PELHAM BAY PARKWAY CONNECTION TO BRONX RIVER GREENWAY,PELHAM BAY PARKWAY CONNECTION TO BRONX RIVER GREENWAY,cpd11-20bx.pdf
P-1PELSHO,Pelham Bay Park- Shoreline Recons. (X039-116M),846,DEPT OF PARKS AND RECREATION,BEACHES AND BOARDWALKS,200,BRONX,WM-0011,2867,3195,536,0,0,0,0,0,3731,3195,536,0,0,0,0,0,3731,6390,1072,0,0,0,0,0,7462,,,THIS PROJECT WILL REMOVE INTRUSIVE INFRASTRUCTURE FROM THE NATURAL ROCKY SHORE OF,cpd11-20bx.pdf
P-1PLG10B,FY10 Playground Requirements (XG-410M),846,DEPT OF PARKS AND RECREATION,NEIGHBORHOOD PARKS AND PLAYGROUNDS,200,BRONX,P-D021,1471,1794,0,0,93,0,0,0,1887,1794,0,0,93,0,0,0,1887,3588,0,0,186,0,0,0,3774,PROJECT DELAYED DUE TO UNFORESEEN SITE/FIELD CONDITION,BRONX,FY10 PLAYGROUND REQUIREMENTS,cpd11-20bx.pdf
P-1PLG11B,FY11 Playground Requirements (XG-415M),846,DEPT OF PARKS AND RECREATION,NEIGHBORHOOD PARKS AND PLAYGROUNDS,200,BRONX,P-1018 P-D021,900,2627,1,114,0,0,0,0,2742,2627,1,114,0,0,0,0,2742,5254,2,228,0,0,0,0,5484,PROJECT DELAYED PENDING APPROVAL OF STATE REQ CONTRACT,BOROUGH OF BRONX XG-311M,FY19 JAN PLAN $250K P-1018 & $84K P-D021 ROLL TO FY20...FY20 APRIL PLAN ROLL $587K P-1018 & $114K,cpd11-20bx.pdf
P-1PNYFL5,PlaNYC- Coop City ballfield - Irrigation Install X251-116M,846,DEPT OF PARKS AND RECREATION,NEIGHBORHOOD PARKS AND PLAYGROUNDS,200 210,BRONX,P-0705,360,897,74,0,0,0,0,0,971,897,74,0,0,0,0,0,971,1794,148,0,0,0,0,0,1942,PROJECT DELAYED DUE TO UNFORESEEN SITE/FIELD CONDITION,"COOP CITY BALLFIELD, THE BRONX","COOP CITY BALLFIELD PATH, BLEACHER & GREEN AREA",cpd11-20bx.pdf
P-1PNYR07,PLANYC- BX PK CHANNEL RESTORATION X002-214M,846,DEPT OF PARKS AND RECREATION,NEIGHBORHOOD PARKS AND PLAYGROUNDS,200,BRONX,P-0822,1150,257,0,0,1956,0,0,0,2213,257,0,0,1956,0,0,0,2213,514,0,0,3912,0,0,0,4426,PROJECT DELAYED DUE TO UNFORESEEN SITE/FIELD CONDITION,BOROUGH OF THE BRONX,TO REHABILITATE THE CHANNEL AROUND THE ISLAND IN THE BRONX FOREST TO FACILITATE TREE,cpd11-20bx.pdf
P-1POECOT,POE COTTAGE - INSTALLATION OF ROOF & EXTERIOR RENOVATIONS,846,DEPT OF PARKS AND RECREATION,MAJOR RECREATIONAL FACILITIES AND FACILITY RECONSTRUCTION,200,BRONX,P-X245 P-D021,450,45,450,0,0,450,0,0,945,45,450,0,0,450,0,0,945,90,900,0,0,900,0,0,1890,,,INSTALLATION OF ROOF & EXTERIOR RENOVATIONS AT POE COTTAGE IN THE BRONX,cpd11-20bx.pdf
P-1PTSNPK,Patterson Park (X155-116M,846,DEPT OF PARKS AND RECREATION,NEIGHBORHOOD PARKS AND PLAYGROUNDS,200,BRONX,P-1018 P-D021,2200,4739,756,0,0,0,0,0,5495,4739,756,0,0,0,0,0,5495,9478,1512,0,0,0,0,0,10990,PROJECT DELAYED DUE TO UNFORESEEN SITE/FIELD CONDITION,,PATTERSON PARK,cpd11-20bx.pdf
P-1PUGSLY,PUGSLEY CREEK & SOUNDVIEW PARKS INSTALLATION OF BLUE LIGHT,846,DEPT OF PARKS AND RECREATION,NEIGHBORHOOD PARKS AND PLAYGROUNDS,200,BRONX,P-X245,122,0,0,90,0,0,0,0,90,0,0,90,0,0,0,0,90,0,0,180,0,0,0,0,180,,PUGSLEY CREEK/ SOUNDVIEW PARK,PUGSLEY CREEK & SOUNDVIEW PARKS  INSTALLATION OF BLUE LIGHT HELP & FLASHCAMS,cpd11-20bx.pdf
P-1PUTNAM,Putnam Greenway- X092-508M,846,DEPT OF PARKS AND RECREATION,"LARGE, MAJOR AND REGIONAL PARK RECONSTRUCTION",211 212 209,BRONX,P-0245X P-1018 P-D021,3420,2690,781,0,0,0,0,0,3471,2690,781,0,0,0,0,0,3471,5380,1562,0,0,0,0,0,6942,PROJECT DELAYED DUE TO UNFORESEEN SITE/FIELD CONDITION,BRONX,GREENWAY - PUTNAM RAIL TRAIL,cpd11-20bx.pdf
P-1RNQARF,Ranaqua Roof Reconstruction,846,DEPT OF PARKS AND RECREATION,NEIGHBORHOOD PARKS AND PLAYGROUNDS,200,BRONX,P-1249 P-1018,2500,227,0,0,4000,0,0,0,4227,227,0,0,4000,0,0,0,4227,454,0,0,8000,0,0,0,8454,,"RANAQUA, BOROUGH OF THE BRONX",RECONSTRUCTION OF RNAQUA ROOF,cpd11-20bx.pdf
P-1RNQRMP,Reconstruction of Ranaqua M&O Storehouse Ramp,846,DEPT OF PARKS AND RECREATION,NEIGHBORHOOD PARKS AND PLAYGROUNDS,200,BRONX,P-1018,3275,426,20,327,3262,0,0,0,4035,426,20,327,3262,0,0,0,4035,852,40,654,6524,0,0,0,8070,,,RECONSTRUCTION OF RANAQUA M&O STOREHOUSE RAMP,cpd11-20bx.pdf
P-1SHOEB1,Shoelace Park-BX Green Infrastructure Constr.X004-,846,DEPT OF PARKS AND RECREATION,LAND ACQUISITION AND TREE PLANTING,200,BRONX,P-1018,0,0,0,0,0,0,0,0,0,0,0,0,0,0,0,0,0,0,0,0,0,0,0,0,0,,SHOELACE PARK-BX GREEN INFRASTRUCTURE CONSTR.X004-,SHOELACE PARK-BX GREEN INFRASTRUCTURE CONSTR.X004-,cpd11-20bx.pdf
P-1SPACET,SpaceTime Playgroun Reconstruction,846,DEPT OF PARKS AND RECREATION,NEIGHBORHOOD PARKS AND PLAYGROUNDS,200,BRONX,P-D021,500,0,0,0,1500,0,0,0,1500,0,0,0,1500,0,0,0,1500,0,0,0,3000,0,0,0,3000,,,"SPACE TIME PLAYGROUND RENOOVATION OF SYNTHETIC TURF, BRONX",cpd11-20bx.pdf
P-1STFPEL,Synthetic Turf Field Reconstruction at Pelham Bay,846,DEPT OF PARKS AND RECREATION,NEIGHBORHOOD PARKS AND PLAYGROUNDS,200,BRONX,P-0510,485,0,485,0,0,0,0,0,485,0,485,0,0,0,0,0,485,0,970,0,0,0,0,0,970,,"PELHAM BAY PARK, BRONX",SYNTHETIC TURF FIELD RECONSTRUCTION AT PELHAM BAY,cpd11-20bx.pdf
P-1STJMPK,St. James Park,846,DEPT OF PARKS AND RECREATION,NEIGHBORHOOD PARKS AND PLAYGROUNDS,200,BRONX,P-1018,400,0,0,0,400,0,0,0,400,0,0,0,400,0,0,0,400,0,0,0,800,0,0,0,800,,BRONX,ST. JAMES PARK,cpd11-20bx.pdf
P-1TRAILX,West Farms Park - Construction Continuation X288-114M,846,DEPT OF PARKS AND RECREATION,"LARGE, MAJOR AND REGIONAL PARK RECONSTRUCTION",200,BRONX,P-1018,3045,2635,220,1,0,0,0,0,2856,2635,220,1,0,0,0,0,2856,5270,440,2,0,0,0,0,5712,PROJECT DELAYED DUE TO UNFORESEEN SITE/FIELD CONDITION,BRONX RIVER PARK - WEST FARMS ON 179TH STREET BETWEEN 180TH AND EAST TREMONT / 180TH TO,"CONSTRUCTION CONTINUATION OF WEST FARMS PARK INCLUDING CURBS, PAVEMENT, LIGHTING, AND",cpd11-20bx.pdf
P-1TRE18B,"FY 18 Street Trees Bronx CB's 9-12, XG-",846,DEPT OF PARKS AND RECREATION,LAND ACQUISITION AND TREE PLANTING,200,BRONX,P-0822,1432,186,0,815,0,0,0,0,1001,186,0,815,0,0,0,0,1001,372,0,1630,0,0,0,0,2002,,"FY 18 STREET TREES BRONX CB'S 9-12,","FY 18 STREET TREES BRONX CB'S 9-12,",cpd11-20bx.pdf
P-1TRE20A,"FY20 Street Trees Bronx CB's 1-4, XG-119M",846,DEPT OF PARKS AND RECREATION,LAND ACQUISITION AND TREE PLANTING,200,BRONX,P-0822 ED-0075 ED-0409 P-X822 P-1018,2260,155,2269,0,0,0,0,0,2424,155,2269,0,0,0,0,0,2424,310,4538,0,0,0,0,0,4848,,"FY20 STREET TREES BRONX CB'S 1-4,","FY20 STREET TREES BRONX CB'S 1-4,",cpd11-20bx.pdf
P-1TRE20B,FY20 Street Trees Bronx CB's 5-8 XG-219M,846,DEPT OF PARKS AND RECREATION,LAND ACQUISITION AND TREE PLANTING,200,BRONX,WM-0011 P-1018 P-0822 P-D822,2800,155,12,2788,0,0,0,0,2955,155,12,2788,0,0,0,0,2955,310,24,5576,0,0,0,0,5910,,FY20 STREET TREES BRONX CB'S 5-8 XG-219M,FY20 STREET TREES BRONX CB'S 5-8 XG-219M,cpd11-20bx.pdf
P-1TRE21A,"FY21 Street Trees Bronx CB's 1-4,9,10 XG-",846,DEPT OF PARKS AND RECREATION,LAND ACQUISITION AND TREE PLANTING,200,BRONX,P-0822,2631,30,2631,0,0,0,0,0,2661,30,2631,0,0,0,0,0,2661,60,5262,0,0,0,0,0,5322,,BOROWIDE,"FY21 STREET TREES BRONX CB'S 1-4,9,10",cpd11-20bx.pdf
P-1TREL21,"FY21 Street Trees BX CB's5-8,11,12 (3Y)",846,DEPT OF PARKS AND RECREATION,LAND ACQUISITION AND TREE PLANTING,200,BRONX,P-1018 P-0822,6719,30,6395,0,0,0,0,0,6425,30,6395,0,0,0,0,0,6425,60,12790,0,0,0,0,0,12850,,BRONX,"FY21 STREET TREES BX CB'S5-8,11,12 (3Y)",cpd11-20bx.pdf
P-1VCSHND,"Van Cortlandt Park, Shandler Rec. Area, all 3 Priorities",846,DEPT OF PARKS AND RECREATION,NEIGHBORHOOD PARKS AND PLAYGROUNDS,200,BRONX,P-1018,1000,0,0,1000,0,0,0,0,1000,0,0,1000,0,0,0,0,1000,0,0,2000,0,0,0,0,2000,,BRONX,"VAN CORTLANDT PARK, SHANDLER REC. AREA, ALL 3 PRIORITIES",cpd11-20bx.pdf
P-1VCSTDM,Pavement,846,DEPT OF PARKS AND RECREATION,NEIGHBORHOOD PARKS AND PLAYGROUNDS,200,BRONX,P-1018,250,0,250,0,0,0,0,0,250,0,250,0,0,0,0,0,250,0,500,0,0,0,0,0,500,,BRONX,PAVEMENT,cpd11-20bx.pdf
P-1VCTRAL,Van Cortlandt's Tail,846,DEPT OF PARKS AND RECREATION,NEIGHBORHOOD PARKS AND PLAYGROUNDS,200,BRONX,P-1018,700,0,0,0,700,0,0,0,700,0,0,0,700,0,0,0,700,0,0,0,1400,0,0,0,1400,,BRONX,VAN CORTLANDT'S TAIL,cpd11-20bx.pdf
P-1VNFPOL,Van Nest Flag Pole X093-116M,846,DEPT OF PARKS AND RECREATION,NEIGHBORHOOD PARKS AND PLAYGROUNDS,200,BRONX,P-1018 P-X245,60,646,19,30,0,0,0,0,695,646,19,30,0,0,0,0,695,1292,38,60,0,0,0,0,1390,PROJECT DELAYED DUE TO UNFORESEEN SITE/FIELD CONDITION,,VAN NEST FLAG POLE,cpd11-20bx.pdf
P-1WDLNCS,Woodlawn Playground C.S X092-119M,846,DEPT OF PARKS AND RECREATION,NEIGHBORHOOD PARKS AND PLAYGROUNDS,200,BRONX,P-0505 P-D021,1554,215,0,0,1579,0,0,0,1794,215,0,0,1579,0,0,0,1794,430,0,0,3158,0,0,0,3588,,,WOODLAWN PLAYGROUND COMFORT STATIONS,cpd11-20bx.pdf
P-1WDLNSS,Woodlawn Plgd- Recon of Spray Shower X092-118M,846,DEPT OF PARKS AND RECREATION,"LARGE, MAJOR AND REGIONAL PARK RECONSTRUCTION",200,BRONX,P-X245 P-0935 P-D021,1296,202,0,1002,0,0,0,0,1204,202,0,1002,0,0,0,0,1204,404,0,2004,0,0,0,0,2408,,"WOODLAWN PLAYGROUND, VAN CORTLANDT PARK",WOODLAWN PLAYGROUND - SPRAY SHOWER,cpd11-20bx.pdf
P-1WPSOTO,Sotomayor Houses - Construction of Open Space,846,DEPT OF PARKS AND RECREATION,NEIGHBORHOOD PARKS AND PLAYGROUNDS,200,BRONX,P-1018,1900,22,190,0,1710,0,0,0,1922,22,190,0,1710,0,0,0,1922,44,380,0,3420,0,0,0,3844,,,NYCHA SOTOMAYOR HOUSES OPEN SPACE CONSTRUCTION,cpd11-20bx.pdf
P-1WPWATS,Watson Houses - Construction of Open Space,846,DEPT OF PARKS AND RECREATION,MAJOR RECREATIONAL FACILITIES AND FACILITY RECONSTRUCTION,200,BRONX,P-1018,2500,57,250,0,2250,0,0,0,2557,57,250,0,2250,0,0,0,2557,114,500,0,4500,0,0,0,5114,,,NYCHA WATSON HOUSES OPEN SPACE CONSTRUCTION,cpd11-20bx.pdf
P-6CYANK4,YANKEE STADIUM - REQUIREMENTS - X237-104M,846,DEPT OF PARKS AND RECREATION,VEHICLES AND EQUIPMENT,204,BRONX,P-0882,360,139,163,0,0,0,0,0,302,139,163,0,0,0,0,0,302,278,326,0,0,0,0,0,604,,YANKEE STADIUM REQUIRMENTS,YANKEE STADIUM REQUIRMENTS,cpd11-20bx.pdf
SANDY1-03,SANDY - Bronx Type 2 Playgrounds R/C,846,DEPT OF PARKS AND RECREATION,NEIGHBORHOOD PARKS AND PLAYGROUNDS,200,BRONX,P-1018,311,0,0,0,0,31,0,0,31,0,0,0,0,31,0,0,31,0,0,0,0,62,0,0,62,PROJECT DELAYED DUE TO CHANGES IN SCOPE/DESIGN,BOROUGH OF THE BRONX,SUPERVISION OF BRONX DAMAGED SITES,cpd11-20bx.pdf
SANDY1-06,SANDY - Ferry Point Park Type 3 X126-115M,846,DEPT OF PARKS AND RECREATION,"LARGE, MAJOR AND REGIONAL PARK RECONSTRUCTION",200,BRONX,P-1018,1924,284,13,357,0,0,0,0,654,284,13,357,0,0,0,0,654,568,26,714,0,0,0,0,1308,PROJECT DELAYED DUE TO UNFORESEEN SITE/FIELD CONDITION,BRONX,FERRY PT PK TYPE 3,cpd11-20bx.pdf
SANDY1-09,SANDY Type 3 Pelham Bay Park - Recon seawall X039-215M,846,DEPT OF PARKS AND RECREATION,"LARGE, MAJOR AND REGIONAL PARK RECONSTRUCTION",200,BRONX,P-1018,1598,9,0,0,0,159,0,0,168,9,0,0,0,159,0,0,168,18,0,0,0,318,0,0,336,PROJECT DELAYED DUE TO CHANGES IN SCOPE/DESIGN,BOROUGH OF THE BRONX,CNYG-514M,cpd11-20bx.pdf
SANDY1-10,Hammond Cove Marina X310-117M,846,DEPT OF PARKS AND RECREATION,NEIGHBORHOOD PARKS AND PLAYGROUNDS,200,BRONX,P-1018,1187,252,420,4,0,0,0,0,676,252,420,4,0,0,0,0,676,504,840,8,0,0,0,0,1352,PROJECT DELAYED DUE TO CHANGES IN SCOPE/DESIGN,,HAMMOND'S COVE MARINA,cpd11-20bx.pdf
SANDY1-11,Pelham Bay Landfill,846,DEPT OF PARKS AND RECREATION,"LARGE, MAJOR AND REGIONAL PARK RECONSTRUCTION",200,BRONX,P-1018,10750,235,15,791,78,106,0,0,1225,235,15,791,78,106,0,0,1225,470,30,1582,156,212,0,0,2450,PROJECT DELAYED DUE TO CHANGES IN SCOPE/DESIGN,"HUTCHINSON RIVER, LONG ISLAND SOUND BET. BRONC COUNTY LINE AND MIDDLETOWN RD., WATT",SANDY - PELHAM BAY LANDFILL,cpd11-20bx.pdf
SANDY6-11,SANDY - Park reconstruction (Type 3 ) (Non - Emergency),846,DEPT OF PARKS AND RECREATION,"LARGE, MAJOR AND REGIONAL PARK RECONSTRUCTION",200,BRONX,P-1018,60019,3,0,0,0,65,0,0,68,3,0,0,0,65,0,0,68,6,0,0,0,130,0,0,136,PROJECT DELAYED DUE TO UNFORESEEN SITE/FIELD CONDITION,BRONX,SANDY - PARK RECONSTRUCTION (NON-EMERGENCY),cpd11-20bx.pdf
BBJ-X,Borough Based Jails New Bronx Detention Facility,850,DEPT OF DESIGN & CONSTRUCTION,New Jail Facilities,,BRONX,C-0114,0,0,289,45248,260511,442649,436311,638650,1823658,0,289,45248,260511,442649,436311,638650,1823658,0,578,90496,521022,885298,872622,1277300,3647316,,,CONSTRUCTION OF NEW BRONX FACILITY,cpd11-20bx.pdf
C75-FCAD,"FACADE RECONSTRUCTION AT EMTC, NIC,QDC, MDC, and GRVC",850,DEPT OF DESIGN & CONSTRUCTION,BUILDING SYSTEMS AND INFRASTRUCTURE,200,BRONX,C-0075,1650,18070,0,127,0,0,0,0,18197,18070,0,127,0,0,0,0,18197,36140,0,254,0,0,0,0,36394,PROJECT DELAYED DUE TO BUDGETARY CONSTRAINTS,,"FACADE RECONSTRUCTION AT NIC,QDC,BBKC,BKDC",cpd11-20bx.pdf
CO290BCHJ,BCHJ-Post Construction Work,850,DEPT OF DESIGN & CONSTRUCTION,RECONSTRUCTION/RENOVATION OF COURT FACILITIES,204,BRONX,CO-0290 CO-0284,44000,40583,533,1937,0,0,0,0,43053,40583,533,1937,0,0,0,0,43053,81166,1066,3874,0,0,0,0,86106,PROJECT DELAYED DUE TO UNFORESEEN SITE/FIELD CONDITION,,BCHJ-POST CONSTRUCTION WORK,cpd11-20bx.pdf
CO290XSB1,DASNY - BRONX CRIMINAL CT COMPLEX,850,DEPT OF DESIGN & CONSTRUCTION,CONSTRUCTION OF NEW COURT FACILITIES,204,BRONX,PW-0077 CO-0290,415163,204631,-597,2774,0,11787,0,0,218595,204631,-597,2774,0,11787,0,0,218595,409262,-1194,5548,0,23574,0,0,437190,PROJECT DELAYED DUE TO BUDGETARY CONSTRAINTS,,TO CONSTRUCT A NEW BUILDING TO HOUSE THE SUPREME COURT/CRIMINAL TERM24 COURT ROOMS,cpd11-20bx.pdf
CO293LL11,851 GRAND CONCOURSE - FACADE RECONSTRUCTION,850,DEPT OF DESIGN & CONSTRUCTION,RECONSTRUCTION/RENOVATION OF COURT FACILITIES,201,BRONX,CO-0293,13057,1047,0,0,0,0,14085,0,15132,1047,0,0,0,0,14085,0,15132,2094,0,0,0,0,28170,0,30264,PROJECT DELAYED DUE TO BUDGETARY CONSTRAINTS,,851 GRAND CONCOURSE - FAÝADE REPAIRS LOCAL LAW 11,cpd11-20bx.pdf
CO293SP,851 GRAND CONCOURSE - FIRE PROTECTION/SPRINKLERS,850,DEPT OF DESIGN & CONSTRUCTION,RECONSTRUCTION/RENOVATION OF COURT FACILITIES,200,BRONX,CO-0293,44850,7650,0,0,0,39836,0,0,47486,7650,0,0,0,39836,0,0,47486,15300,0,0,0,79672,0,0,94972,PROJECT DELAYED DUE TO BUDGETARY CONSTRAINTS,,851 GRAND CONCOURSE - FIRE PROTECTION/SPRINKLERS,cpd11-20bx.pdf
CO294RF,215 E161 ST.- ROOF,850,DEPT OF DESIGN & CONSTRUCTION,RECONSTRUCTION/RENOVATION OF COURT FACILITIES,204,BRONX,CO-0294,6305,0,568,0,6864,0,0,0,7432,0,568,0,6864,0,0,0,7432,0,1136,0,13728,0,0,0,14864,,,215 E161 ST.- ROOF,cpd11-20bx.pdf
CO295EV,1118 GRAND CONCOURSE - ELEVATORS,850,DEPT OF DESIGN & CONSTRUCTION,RECONSTRUCTION/RENOVATION OF COURT FACILITIES,201,BRONX,CO-0295,9855,777,116,0,0,9315,0,0,10208,777,116,0,0,9315,0,0,10208,1554,232,0,0,18630,0,0,20416,PROJECT DELAYED DUE TO UNFORESEEN SITE/FIELD CONDITION,,1118 GRAND CONCOURSE - ELEVATORS,cpd11-20bx.pdf
CRO-AGS,CROTON ABOVE-GROUND STRUCTURE AND LANDSCAPING,850,DEPT OF DESIGN & CONSTRUCTION,CROTON FILTER PROJECT,207 208,BRONX,WM-0011,58786,81849,1501,0,0,0,0,0,83350,81849,1501,0,0,0,0,0,83350,163698,3002,0,0,0,0,0,166700,PROJECT DELAYED DUE TO BUDGETARY CONSTRAINTS,,CONSTRUCTION OF THE ABOVE GROUND STRUCTURES FOR THE DPR PORTION OF THE MOSHULU GOLF,cpd11-20bx.pdf
CV19COETR,Centers of Excellence,850,DEPT OF DESIGN & CONSTRUCTION,NEW FACILITIES,,BRONX,HO-0214,28627,15844,4115,0,0,0,0,0,19959,15844,4115,0,0,0,0,0,19959,31688,8230,0,0,0,0,0,39918,,"BUILDING IS A NEWLY LEASED SPACE LOCATED AT 1920 WEBSTER AVENUE, BRONX, NY 11372.","THE WORK TO BE DONE WILL INCLUDE GENERAL CONSTRUCTION, NEW LOW- FLOW PLUMBING",cpd11-20bx.pdf
HED-553,WATER MAIN IN SOUTHERN BLVD - WESTCHESTER AV & BOSTON RD,850,DEPT OF DESIGN & CONSTRUCTION,TRUNK AND DISTRIBUTION MAIN REPLACEMENT,202 203,BRONX,WM-0001 HW-0200 HW-0001X,16885,60232,912,0,0,0,0,818,61962,60232,912,0,0,0,0,818,61962,120464,1824,0,0,0,0,1636,123924,PROJECT DELAYED DUE TO UNFORESEEN SITE/FIELD CONDITION,WATER MAIN IN SOUTHERN BLVD - WESTCHESTER AV & BOSTON RD,WATER MAIN IN SOUTHERN BLVD - WESTCHESTER AV & BOSTON RD,cpd11-20bx.pdf
HED-556A,UPGRADE WATER MAINS AT NY BOTANICAL GARDENS (BX),850,DEPT OF DESIGN & CONSTRUCTION,TRUNK AND DISTRIBUTION MAIN REPLACEMENT,200 206 207 211 212,BRONX,WM-0006,1789,115,0,0,0,0,1650,0,1765,115,0,0,0,0,1650,0,1765,230,0,0,0,0,3300,0,3530,PROJECT DELAYED DUE TO UNFORESEEN SITE/FIELD CONDITION,,"CLEANING, SURVEYIN, LINING AND REPLACING 36"" AND 48"" WATER MAINS, ANDUPGRADE EXISTING",cpd11-20bx.pdf
HED-560,RECON WM IN WEST FARMS SQUARE (HWXP2007),850,DEPT OF DESIGN & CONSTRUCTION,TRUNK AND DISTRIBUTION MAIN REPLACEMENT,206,BRONX,SE-0002X WM-0006 WM-0001,8096,0,0,8096,0,0,0,0,8096,0,0,8096,0,0,0,0,8096,0,0,16192,0,0,0,0,16192,PROJECT DELAYED DUE TO UNFORESEEN SITE/FIELD CONDITION,,RECON WM IN WEST FARMS SQUARE,cpd11-20bx.pdf
HED-562,"New 46"" Trunk Water Main in E.233rd St. Bronx",850,DEPT OF DESIGN & CONSTRUCTION,AUGMENTATION OF WATER SUPPLY SYSTEMS,212,BRONX,WM-0006 WM-0001 SE-0002X,8234,1017,0,0,31143,0,0,0,32160,1017,0,0,31143,0,0,0,32160,2034,0,0,62286,0,0,0,64320,PROJECT DELAYED DUE TO UNFORESEEN SITE/FIELD CONDITION,,"NEW 46"" TRUNK WATER MAIN IN E.233RD ST. BRONX, BETWEEN BRONXWOOD AVENUE AND",cpd11-20bx.pdf
HED-564,"NEW 20"" SUB-AQUEOUS WATER MAIN TO CITY ISLAND",850,DEPT OF DESIGN & CONSTRUCTION,EXTENSIONS,210,BRONX,WM-0001,23334,34365,5399,0,0,0,0,0,39764,34365,5399,0,0,0,0,0,39764,68730,10798,0,0,0,0,0,79528,PROJECT DELAYED DUE TO CHANGES IN SCOPE/DESIGN,,"NEW 20"" SUB-AQUEOUS WATER MAIN TO CITY ISLAND",cpd11-20bx.pdf
HED-568,"New 20"" sub-aqueous water main extension to Randall's Island",850,DEPT OF DESIGN & CONSTRUCTION,EXTENSIONS,201,BRONX,WM-0001 SE-1000,6243,39822,233,0,0,0,0,0,40055,39822,233,0,0,0,0,0,40055,79644,466,0,0,0,0,0,80110,PROJECT DELAYED DUE TO CHANGES IN SCOPE/DESIGN,,"NEW 20"" SUB-AQUEOUS WATER MAIN EXTENSION TO RANDALL'S ISLAND",cpd11-20bx.pdf
HED-569,Replacement of Trunk WM in Bainbridge Ave,850,DEPT OF DESIGN & CONSTRUCTION,AUGMENTATION OF WATER SUPPLY SYSTEMS,208,BRONX,WM-0006 WM-0001 SE-0002X,19229,58176,1465,0,0,0,0,0,59641,58176,1465,0,0,0,0,0,59641,116352,2930,0,0,0,0,0,119282,PROJECT DELAYED DUE TO UNFORESEEN SITE/FIELD CONDITION,,"REPLACEMENT OF TRUNK WM IN BAINBRIDGE AVE BETWEEN GUN HILL RD & HOLLYLA, AND IN JEROME",cpd11-20bx.pdf
HED-570,"Trunk & Dist WM & Comb. Sewer Replacement, bx",850,DEPT OF DESIGN & CONSTRUCTION,TRUNK AND DISTRIBUTION MAIN REPLACEMENT,205,BRONX,WM-0006 WM-0001 SE-0002X,12384,225,0,11589,0,0,0,0,11814,225,0,11589,0,0,0,0,11814,450,0,23178,0,0,0,0,23628,,,"RUNK & DISTRIBUTION WM & COMBINED SEWER REPLACEMENT IN UNIVERSITY AVENUE, BX",cpd11-20bx.pdf
HED-578,Replcmt of Dist WM In Mundy Lane btwn Cranford & Nereid Ave,850,DEPT OF DESIGN & CONSTRUCTION,TRUNK AND DISTRIBUTION MAIN REPLACEMENT,212,BRONX,WM-0001,6391,100,0,5557,0,0,0,0,5657,100,0,5557,0,0,0,0,5657,200,0,11114,0,0,0,0,11314,,,REPLACEMENT OF DISTRIBUTION WATER MAIN IN MUNDY LANE BETWEEN CRANFORDAVENUE AND,cpd11-20bx.pdf
HEDA-002,Accelerated Distribution WM replcmnt & sewer rehab,850,DEPT OF DESIGN & CONSTRUCTION,TRUNK AND DISTRIBUTION MAIN REPLACEMENT,200,BRONX,WM-0001,21446,20142,250,0,0,0,0,0,20392,20142,250,0,0,0,0,0,20392,40284,500,0,0,0,0,0,40784,PROJECT DELAYED DUE TO UNFORESEEN SITE/FIELD CONDITION,,"ACCELERATED DISTRIBUTION WATER MAIN REPLCMNT & SEWER REHAB/REPLACEMENT, BRONX",cpd11-20bx.pdf
HEDA-003,Accelerated Distribution WM replcmnt & sewer rehab,850,DEPT OF DESIGN & CONSTRUCTION,TRUNK AND DISTRIBUTION MAIN REPLACEMENT,200,BRONX,WM-0001 SE-0002X SE-0200X,19516,21386,4147,0,0,0,0,0,25533,21386,4147,0,0,0,0,0,25533,42772,8294,0,0,0,0,0,51066,PROJECT DELAYED DUE TO UNFORESEEN SITE/FIELD CONDITION,,"ACCELERATED DISTRIBUTION WATER MAIN REPLCMNT & SEWER REHAB/REPLACEMENT, BRONX",cpd11-20bx.pdf
HH112CWFR,COMMONWEALTH AVENUE FIRE SAFETY SYSTEM,850,DEPT OF DESIGN & CONSTRUCTION,SHELTERS FOR HOMELESS INDIVIDUALS,,BRONX,HH-0112,650,1962,363,0,0,0,0,0,2325,1962,363,0,0,0,0,0,2325,3924,726,0,0,0,0,0,4650,,,COMMONWEALTH AVENUE FIRE SAFETY SYSTEM,cpd11-20bx.pdf
HH112WLFA,WILLOW AVE FIRE SAFETY,850,DEPT OF DESIGN & CONSTRUCTION,SHELTERS FOR HOMELESS INDIVIDUALS,,BRONX,HH-0112,750,782,83,0,0,0,0,0,865,782,83,0,0,0,0,0,865,1564,166,0,0,0,0,0,1730,PROJECT DELAYED DUE TO BUDGETARY CONSTRAINTS,,FIRE SAFETY SYSTEM,cpd11-20bx.pdf
HH115FRFA,FREEMAN FAMILY RESIDENCE - FIRE ALARM SYSTEM UPGRADE,850,DEPT OF DESIGN & CONSTRUCTION,SHELTERS FOR HOMELESS FAMILIES,,BRONX,HH-0115,256,745,322,0,0,0,0,0,1067,745,322,0,0,0,0,0,1067,1490,644,0,0,0,0,0,2134,,,FREEMAN FAMILY RESIDENCE - FIRE ALARM SYSTEM UPGRADE,cpd11-20bx.pdf
HH115JCFS,JACKSON FAMILY FIRE SAFETY,850,DEPT OF DESIGN & CONSTRUCTION,SHELTERS FOR HOMELESS FAMILIES,,BRONX,HH-0115,1485,1051,0,416,0,0,0,0,1467,1051,0,416,0,0,0,0,1467,2102,0,832,0,0,0,0,2934,PROJECT DELAYED DUE TO BUDGETARY CONSTRAINTS,,JACKSON FAMILY FIRE SAFETY,cpd11-20bx.pdf
HH115SNEC,SENECA HOUSES - ELECTRICAL AND KITCHEN UPGRADE,850,DEPT OF DESIGN & CONSTRUCTION,SHELTERS FOR HOMELESS FAMILIES,,BRONX,HH-0115,1480,31,0,0,318,0,2634,0,2983,31,0,0,318,0,2634,0,2983,62,0,0,636,0,5268,0,5966,PROJECT DELAYED DUE TO CHANGES IN SCOPE/DESIGN,,SENECA HOUSES - ELECTRICAL AND KITCHEN UPGRADE,cpd11-20bx.pdf
HH115UNFA,UNIVERSITY FAMILY RESIDENCE - FIRE ALARM SYSTEM UPGRADE,850,DEPT OF DESIGN & CONSTRUCTION,SHELTERS FOR HOMELESS FAMILIES,,BRONX,HH-0115,646,1637,1,0,0,0,3293,0,4931,1637,1,0,0,0,3293,0,4931,3274,2,0,0,0,6586,0,9862,PROJECT DELAYED DUE TO BUDGETARY CONSTRAINTS,,UNIVERSITY FAMILY RESIDENCE - FIRE ALARM SYSTEM UPGRADE,cpd11-20bx.pdf
HL82BRONX,Bronx Animal Care Center and Veterinary Clinic,850,DEPT OF DESIGN & CONSTRUCTION,ANIMAL CARE,,BRONX,HL-0082,5000,12655,1880,5000,31729,32218,0,0,83482,12655,1880,5000,31729,32218,0,0,83482,25310,3760,10000,63458,64436,0,0,166964,PROJECT DELAYED DUE TO BUDGETARY CONSTRAINTS,,CONSTRUCTION,cpd11-20bx.pdf
HWCSCHPBX,SAFE ROUTES TO SCHOOLS- BRONX,850,DEPT OF DESIGN & CONSTRUCTION,PRIMARY STREET RECONSTRUCTION,200,BRONX,HW-0988 HW-D105,9628,1464,0,0,9017,0,0,0,10481,1464,0,0,9017,0,0,0,10481,2928,0,0,18034,0,0,0,20962,PROJECT DELAYED DUE TO CHANGES IN SCOPE/DESIGN,SAFE ROUTES TO SCHOOLS- BRONX,SAFE ROUTES TO SCHOOLS- BRONX,cpd11-20bx.pdf
HWD105-01,METROPOLITAN AVE & UNIONPORT ROAD IN PARKCHESTER -CENTER IS.,850,DEPT OF DESIGN & CONSTRUCTION,PRIMARY STREET RECONSTRUCTION,200 209,BRONX,HW-X001,4488,7767,0,0,0,182,0,0,7949,7767,0,0,0,182,0,0,7949,15534,0,0,0,364,0,0,15898,PROJECT DELAYED DUE TO UNFORESEEN SITE/FIELD CONDITION,METROPOLITAN AVE & UNIONPORT ROAD IN PARCHESTER CENTER ISLAND MALL,MATROPOLITAN AVE & UNIOPORT ROAD PARCHESTER-CENTER ISLAND MALL,cpd11-20bx.pdf
HWD105-03,LIBRARY LANE PROJECT,850,DEPT OF DESIGN & CONSTRUCTION,PRIMARY STREET RECONSTRUCTION,200 210,BRONX,HW-0061 HW-D105 HW-0001X HW-0200 WM-0001,600,1486,2261,4024,0,0,0,0,7771,1486,2261,4024,0,0,0,0,7771,2972,4522,8048,0,0,0,0,15542,PROJECT DELAYED DUE TO UNFORESEEN SITE/FIELD CONDITION,LIBRARY LANE PROJECT,LIBRARY LANE PROJECT,cpd11-20bx.pdf
HWPLZ004X,Morrison Avenue Plaza (HED-572),850,DEPT OF DESIGN & CONSTRUCTION,PRIMARY STREET RECONSTRUCTION,200,BRONX,HW-1684,2700,4134,0,753,0,0,0,0,4887,4134,0,753,0,0,0,0,4887,8268,0,1506,0,0,0,0,9774,PROJECT DELAYED DUE TO UNFORESEEN SITE/FIELD CONDITION,MORRISON AVENUE PLAZA,MORRISON AVENUE PLAZA,cpd11-20bx.pdf
HWPR19X,Pedestrian Ramp Rehabilitation - The Bronx,850,DEPT OF DESIGN & CONSTRUCTION,PEDESTRIAN RAMP CONSTRUCTION,200,BRONX,HW-0200,12472,7532,5064,1275,0,0,0,0,13871,7532,5064,1275,0,0,0,0,13871,15064,10128,2550,0,0,0,0,27742,PROJECT DELAYED DUE TO BUDGETARY CONSTRAINTS,,PEDESTRIAN RAMP REHABILITATION - THE BRONX,cpd11-20bx.pdf
HWS20000X,PRIOR NOTICE SIDEWALKS - BRONX,850,DEPT OF DESIGN & CONSTRUCTION,SIDEWALK RECONSTRUCTION,200,BRONX,WM-0001,2426,2236,188,0,0,0,0,0,2424,2236,188,0,0,0,0,0,2424,4472,376,0,0,0,0,0,4848,PROJECT DELAYED DUE TO UNFORESEEN SITE/FIELD CONDITION,PRIOR NOTICE SIDEWALKS - BRONX,PRIOR NOTICE SIDEWALKS - BRONX,cpd11-20bx.pdf
HWS2006X,PRIOR NOTICE SIDEWALKS - BRONX,850,DEPT OF DESIGN & CONSTRUCTION,SIDEWALK RECONSTRUCTION,200,BRONX,HW-0200,0,2213,0,0,0,0,0,379,2592,2213,0,0,0,0,0,379,2592,4426,0,0,0,0,0,758,5184,,PRIOR NOTICE SIDEWALKS - BRONX,PRIOR NOTICE SIDEWALKS - BRONX,cpd11-20bx.pdf
HWS2014X,PRIOR NOTICE SIDEWALKS - BRONX,850,DEPT OF DESIGN & CONSTRUCTION,SIDEWALK RECONSTRUCTION,200,BRONX,HA-D001,3971,3721,179,0,0,0,0,0,3900,3721,179,0,0,0,0,0,3900,7442,358,0,0,0,0,0,7800,PROJECT DELAYED DUE TO UNFORESEEN SITE/FIELD CONDITION,PRIOR NOTICE SIDEWALKS - BRONX,PRIOR NOTICE SIDEWALKS - BRONX,cpd11-20bx.pdf
HWX006-01,Henwood Place Step Street,850,DEPT OF DESIGN & CONSTRUCTION,PRIMARY STREET RECONSTRUCTION,200,BRONX,HW-0211,9700,1239,0,0,326,8315,0,0,9880,1239,0,0,326,8315,0,0,9880,2478,0,0,652,16630,0,0,19760,PROJECT DELAYED DUE TO BUDGETARY CONSTRAINTS,HENWOOD PLACE STEP STREET,HENWOOD PLACE STEP STREET,cpd11-20bx.pdf
HWX100SBC,South Bronx East-West Crosstown SBS,850,DEPT OF DESIGN & CONSTRUCTION,PRIMARY STREET RECONSTRUCTION,200,BRONX,HW-1684,7750,2023,0,0,47085,0,0,0,49108,2023,0,0,47085,0,0,0,49108,4046,0,0,94170,0,0,0,98216,PROJECT DELAYED DUE TO BUDGETARY CONSTRAINTS,SOUTH BRONX EAST-WEST CROSSTOWN SBS,SOUTH BRONX EAST-WEST CROSSTOWN SBS,cpd11-20bx.pdf
HWX100SBS,Webster Ave SBS,850,DEPT OF DESIGN & CONSTRUCTION,TRAFFIC WORK IN CONJUNCTION WITH HIGHWAY RECONSTRUCTION,200,BRONX,TF-0777 EP-0007 SE-087HW WM-0001 TF-0002,16058,12661,2393,618,0,1668,0,0,17340,12661,2393,618,0,1668,0,0,17340,25322,4786,1236,0,3336,0,0,34680,PROJECT DELAYED DUE TO UNFORESEEN SITE/FIELD CONDITION,WEBSTER AVE SBS - PLANYC,WEBSTER AVE SBS - PLANYC,cpd11-20bx.pdf
HWX402,Bruner and Ely,850,DEPT OF DESIGN & CONSTRUCTION,PRIMARY STREET RECONSTRUCTION,200,BRONX,HW-0001X,12506,1154,0,0,0,11851,0,0,13005,1154,0,0,0,11851,0,0,13005,2308,0,0,0,23702,0,0,26010,PROJECT DELAYED DUE TO BUDGETARY CONSTRAINTS,BRUNER AND ELY,BRUNER AND ELY,cpd11-20bx.pdf
HWX404,Southern Bronx Multi-Site Safety Improvements,850,DEPT OF DESIGN & CONSTRUCTION,PRIMARY STREET RECONSTRUCTION,200,BRONX,HW-0001X,5128,0,1049,0,0,6553,0,0,7602,0,1049,0,0,6553,0,0,7602,0,2098,0,0,13106,0,0,15204,PROJECT DELAYED DUE TO BUDGETARY CONSTRAINTS,SOUTHERN BRONX MULTI-SITE SAFETY IMPROVEMENTS,SOUTHERN BRONX MULTI-SITE SAFETY IMPROVEMENTS,cpd11-20bx.pdf
HWX406,Northwest Bronx School Safety Improvements,850,DEPT OF DESIGN & CONSTRUCTION,PRIMARY STREET RECONSTRUCTION,200,BRONX,HW-0988,13930,20,1525,0,0,0,10131,0,11676,20,1525,0,0,0,10131,0,11676,40,3050,0,0,0,20262,0,23352,PROJECT DELAYED DUE TO BUDGETARY CONSTRAINTS,NORHEAST BRONX SCHOOL SAFETY IMPROVEMENTS,NORHEAST BRONX SCHOOL SAFETY IMPROVEMENTS,cpd11-20bx.pdf
HWX710A,Pelham Pkwy - West & East and North & South Bounds (Phase A),850,DEPT OF DESIGN & CONSTRUCTION,PRIMARY STREET RECONSTRUCTION,211,BRONX,TF-0002 TF-0502 WM-0006 HW-0710 SE-0002X WM-0001 HW-0944 HW-1684,25093,131630,5551,0,3055,0,0,1473,141709,131630,5551,0,3055,0,0,1473,141709,263260,11102,0,6110,0,0,2946,283418,PROJECT DELAYED DUE TO UNFORESEEN SITE/FIELD CONDITION,PELHAM PKWY-WEST & EAST AND NORTH & SOUTH BOUNDS (PHASE A),PELHAM PKWY-WEST & EAST AND NORTH & SOUTH BOUNDS (PHASE A),cpd11-20bx.pdf
HWXF2000B,1400 WILLIAMSBRIDGE RD - HVAC AND FIRE ALARM SYS,850,DEPT OF DESIGN & CONSTRUCTION,FACILITY RECONSTRUCTION,211,BRONX,HW-0003,1340,8329,239,660,0,0,0,0,9228,8329,239,660,0,0,0,0,9228,16658,478,1320,0,0,0,0,18456,PROJECT DELAYED DUE TO UNFORESEEN SITE/FIELD CONDITION,1400 WILLIAMSBRIDGE ROAD - UPGRADES,1400 WILLIAMSBRIDGE ROAD - UPGRADES,cpd11-20bx.pdf
HWXF2144W,Replacement of HVAC Unit,850,DEPT OF DESIGN & CONSTRUCTION,FACILITY RECONSTRUCTION,200,BRONX,HW-0003,220,693,52,0,0,0,0,0,745,693,52,0,0,0,0,0,745,1386,104,0,0,0,0,0,1490,PROJECT DELAYED DUE TO CHANGES IN SCOPE/DESIGN,REPLACEMENT OF HVAC UNIT,REPLACEMENT OF HVAC UNIT,cpd11-20bx.pdf
HWXP132,RECON JOHNSON/IRWIN AVES-RET WALL,850,DEPT OF DESIGN & CONSTRUCTION,RECONSTRUCTION OF RETAINING WALLS,208,BRONX,HW-0001X,7567,7134,147,0,0,0,0,0,7281,7134,147,0,0,0,0,0,7281,14268,294,0,0,0,0,0,14562,,JOHNSON AVE /IRWIN AVE RETAINING WALL,RECONSTRUCTION OF THE EXISTING RETAINING WALLSRETAINING WALL RECONSTRUCTION SHALL,cpd11-20bx.pdf
HWXP136A,GRAND CONCOURSE RECON SERVICE ROAD E.166 TO E171ST,850,DEPT OF DESIGN & CONSTRUCTION,PRIMARY STREET RECONSTRUCTION,204,BRONX,HW-1672 TF-0002 HW-1678,13588,12203,0,211,0,0,0,0,12414,12203,0,211,0,0,0,0,12414,24406,0,422,0,0,0,0,24828,PROJECT DELAYED DUE TO UNFORESEEN SITE/FIELD CONDITION,,RECON SERVICE ROAD WITH WIDENED MALL,cpd11-20bx.pdf
HWXP136B,Grand Concourse Phase 3,850,DEPT OF DESIGN & CONSTRUCTION,PRIMARY STREET RECONSTRUCTION,200,BRONX,TF-0002 HW-0001X,21136,12713,20,1972,2,0,0,0,14707,12713,20,1972,2,0,0,0,14707,25426,40,3944,4,0,0,0,29414,PROJECT DELAYED DUE TO UNFORESEEN SITE/FIELD CONDITION,GRAND CONCOURSE PHASE 3,GRAND CONCOURSE PHASE 3,cpd11-20bx.pdf
HWXP136C,Grand Concourse Phase 4 (SEX002268),850,DEPT OF DESIGN & CONSTRUCTION,PRIMARY STREET RECONSTRUCTION,200,BRONX,HW-0001X HW-0944,64599,46904,6171,0,99,0,0,0,53174,46904,6171,0,99,0,0,0,53174,93808,12342,0,198,0,0,0,106348,PROJECT DELAYED DUE TO UNFORESEEN SITE/FIELD CONDITION,GRAND CONCOURSE PHASE 4,GRAND CONCOURSE PHASE 4,cpd11-20bx.pdf
HWXP136D,Grand Concourse Phase 5,850,DEPT OF DESIGN & CONSTRUCTION,PRIMARY STREET RECONSTRUCTION,200,BRONX,HW-0001X,54000,2606,0,0,0,52234,0,0,54840,2606,0,0,0,52234,0,0,54840,5212,0,0,0,104468,0,0,109680,,GRAND CONCOURSE PHASE 5,GRAND CONCOURSE PHASE 5,cpd11-20bx.pdf
HWXP2007,E177TH ST/DEVOE AVE BT SHERIDAN (I-895) /E.TREMONT HED-560,850,DEPT OF DESIGN & CONSTRUCTION,PRIMARY STREET RECONSTRUCTION,206,BRONX,HW-0001X HW-0200 TF-0502 TF-0002 HW-X006,4939,2597,0,15992,0,0,0,0,18589,2597,0,15992,0,0,0,0,18589,5194,0,31984,0,0,0,0,37178,PROJECT DELAYED DUE TO CHANGES IN SCOPE/DESIGN,"NTERSECTION OF E.177TH ST., DEVOE AVE. AND I-895. INTERSECTION OF DEVOE AVE. AND E. TREMONT","INTERSECTION OF E.177TH ST., DEVOE AVE. AND I-895. INTERSECTION OF DEVOE AVE. AND E.",cpd11-20bx.pdf
HWXPRATT,Pratt Ave Reconstruction and Retaining Wall,850,DEPT OF DESIGN & CONSTRUCTION,PRIMARY STREET RECONSTRUCTION,200,BRONX,HW-0001X,8750,1548,0,0,0,6522,0,0,8070,1548,0,0,0,6522,0,0,8070,3096,0,0,0,13044,0,0,16140,PROJECT DELAYED DUE TO BUDGETARY CONSTRAINTS,,PRATT AVE AND RETAINING WALL,cpd11-20bx.pdf
HWXRCPLZ,ROBERTO CLEMENTE PLAZA & HUB REDESIGN AND RECONSTRUCTION,850,DEPT OF DESIGN & CONSTRUCTION,PRIMARY STREET RECONSTRUCTION,200 205,BRONX,TF-0502 WM-0001 HW-0001X,2550,13983,2494,0,18,0,0,0,16495,13983,2494,0,18,0,0,0,16495,27966,4988,0,36,0,0,0,32990,PROJECT DELAYED DUE TO UNFORESEEN SITE/FIELD CONDITION,,RECON OF PLAZA & HUB,cpd11-20bx.pdf
HWXS311V1,CLIFFORD PLACE STEP STREET,850,DEPT OF DESIGN & CONSTRUCTION,RECONSTRUCTION OF STEP STREETS,200 205,BRONX,HW-0211,3248,7903,268,221,0,0,0,0,8392,7903,268,221,0,0,0,0,8392,15806,536,442,0,0,0,0,16784,PROJECT DELAYED DUE TO CHANGES IN SCOPE/DESIGN,CLIFFORD PALCE STEP STREET,CLIFFORD PLACE STEP STREET,cpd11-20bx.pdf
HWXS411,West 229th St Step Street,850,DEPT OF DESIGN & CONSTRUCTION,RECONSTRUCTION OF STEP STREETS,200 208,BRONX,HW-0211,3725,10717,50,0,31,0,0,0,10798,10717,50,0,31,0,0,0,10798,21434,100,0,62,0,0,0,21596,PROJECT DELAYED DUE TO UNFORESEEN SITE/FIELD CONDITION,WEST 229TH ST STEP STREET,WEST 229TH ST STEP STREET,cpd11-20bx.pdf
HWXS511,West Tremont Ave Step Street,850,DEPT OF DESIGN & CONSTRUCTION,RECONSTRUCTION OF STEP STREETS,200 205,BRONX,TF-0502 HW-0211 SE-0002X SE-087HW,1617,8912,11,0,380,0,0,0,9303,8912,11,0,380,0,0,0,9303,17824,22,0,760,0,0,0,18606,PROJECT DELAYED DUE TO UNFORESEEN SITE/FIELD CONDITION,WEST TREMONT AVE STEP STREET,WEST TREMONT AVE STEP STREET,cpd11-20bx.pdf
HWXS711,RECONSTRUCTION OF STEP STREET AT DAVIDSON AVE,850,DEPT OF DESIGN & CONSTRUCTION,RECONSTRUCTION OF STEP STREETS,200,BRONX,HW-0211,7260,1553,0,5816,0,0,0,0,7369,1553,0,5816,0,0,0,0,7369,3106,0,11632,0,0,0,0,14738,PROJECT DELAYED DUE TO UNFORESEEN SITE/FIELD CONDITION,RECONSTRUCTION OF STEP STREET AT DAVIDSON AVE,RECONSTRUCTION OF STEP STREET AT DAVIDSON AVE,cpd11-20bx.pdf
LN18ALELE,ALLERTON - Elevator Replacement - 3 stop,850,DEPT OF DESIGN & CONSTRUCTION,ESSENTIAL RECONSTRUCTION OF FACILITIES,211,BRONX,LN-0008,2071,0,1898,0,0,0,0,0,1898,0,1898,0,0,0,0,0,1898,0,3796,0,0,0,0,0,3796,,,*NEW* -ELEVATOR REPLACEMENT - 3 STOP,cpd11-20bx.pdf
LN18SVBOI,SOUNDVIEW - New Boiler,850,DEPT OF DESIGN & CONSTRUCTION,ESSENTIAL RECONSTRUCTION OF FACILITIES,209,BRONX,LN-0008,846,0,116,657,0,0,0,0,773,0,116,657,0,0,0,0,773,0,232,1314,0,0,0,0,1546,,,NEW BOILER,cpd11-20bx.pdf
LNBXA08LS,BRONX - Life Safety Projects @ 8   Branch Libraries,850,DEPT OF DESIGN & CONSTRUCTION,ESSENTIAL RECONSTRUCTION OF FACILITIES,200,BRONX,LN-0101X LN-D008 LN-D004 LN-X001,2570,1952,405,0,0,0,0,0,2357,1952,405,0,0,0,0,0,2357,3904,810,0,0,0,0,0,4714,PROJECT DELAYED DUE TO CHANGES IN SCOPE/DESIGN,,LIFE SAFETY PROJECTS @ 12 BRANCH LIBRARIES - BRONX,cpd11-20bx.pdf
LNC4WLEX,WOODLAWN - Branch Expansion,850,DEPT OF DESIGN & CONSTRUCTION,IMPROVEMENTS TO EXISTING FACILITIES,212,BRONX,LN-0008 LN-X001 LN-D004 LN-D008,2312,1011,477,7990,0,0,0,0,9478,1011,477,7990,0,0,0,0,9478,2022,954,15980,0,0,0,0,18956,PROJECT DELAYED DUE TO CHANGES IN SCOPE/DESIGN,"4355 KATONAH AVENUE, BRONX, NY 10470",LIBRARY EXPANSION,cpd11-20bx.pdf
LNCA11BEL,BELMONT - Upper and Lower Roof,850,DEPT OF DESIGN & CONSTRUCTION,ESSENTIAL RECONSTRUCTION OF FACILITIES,208,BRONX,LN-0008,400,2100,177,0,0,0,0,0,2277,2100,177,0,0,0,0,0,2277,4200,354,0,0,0,0,0,4554,PROJECT DELAYED DUE TO CHANGES IN SCOPE/DESIGN,,ROOF REPLACEMENT,cpd11-20bx.pdf
LNCA11SNV,SOUNDVIEW - Interior/Exterior Renovation,850,DEPT OF DESIGN & CONSTRUCTION,ESSENTIAL RECONSTRUCTION OF FACILITIES,209,BRONX,LN-D008,350,692,46,0,0,0,0,0,738,692,46,0,0,0,0,0,738,1384,92,0,0,0,0,0,1476,PROJECT DELAYED DUE TO BUDGETARY CONSTRAINTS,,FIRE ALARM,cpd11-20bx.pdf
LNCA13ECH,EASTCHESTER,850,DEPT OF DESIGN & CONSTRUCTION,ESSENTIAL RECONSTRUCTION OF FACILITIES,200 212,BRONX,LN-D008 LN-0008,1010,1878,228,0,0,0,0,0,2106,1878,228,0,0,0,0,0,2106,3756,456,0,0,0,0,0,4212,PROJECT DELAYED PENDING RESOLUTION OF LEGAL ISSUES,,HVAC REPLACEMENT,cpd11-20bx.pdf
LNCA13MOR,MORRISANIA,850,DEPT OF DESIGN & CONSTRUCTION,ESSENTIAL RECONSTRUCTION OF FACILITIES,203,BRONX,LN-0008,569,2202,344,0,0,0,0,0,2546,2202,344,0,0,0,0,0,2546,4404,688,0,0,0,0,0,5092,PROJECT DELAYED PENDING RESOLUTION OF LEGAL ISSUES,,HVAC AND ROOF,cpd11-20bx.pdf
LNCA13MOT,MOTT HAVEN,850,DEPT OF DESIGN & CONSTRUCTION,ESSENTIAL RECONSTRUCTION OF FACILITIES,200 201,BRONX,LN-0008 LN-D008,390,2936,243,0,0,0,0,0,3179,2936,243,0,0,0,0,0,3179,5872,486,0,0,0,0,0,6358,PROJECT DELAYED DUE TO BUDGETARY CONSTRAINTS,,HVAC,cpd11-20bx.pdf
LNCA15EDW,HVAC Replacement @ Edenwald,850,DEPT OF DESIGN & CONSTRUCTION,ESSENTIAL RECONSTRUCTION OF FACILITIES,200,BRONX,LN-D008 LN-0008,965,510,1299,0,0,0,0,0,1809,510,1299,0,0,0,0,0,1809,1020,2598,0,0,0,0,0,3618,PROJECT DELAYED DUE TO BUDGETARY CONSTRAINTS,,HVAC,cpd11-20bx.pdf
LNCA15MOT,Window Replacement,850,DEPT OF DESIGN & CONSTRUCTION,ESSENTIAL RECONSTRUCTION OF FACILITIES,200,BRONX,LN-0008,944,3470,325,0,0,0,0,0,3795,3470,325,0,0,0,0,0,3795,6940,650,0,0,0,0,0,7590,PROJECT DELAYED DUE TO UNFORESEEN SITE/FIELD CONDITION,,WINDOW REPLACEMENT,cpd11-20bx.pdf
LNCA15RSD,RIVERDALE BRANCH Exterior / Facades/ Retaining Wall / HVAC,850,DEPT OF DESIGN & CONSTRUCTION,ESSENTIAL RECONSTRUCTION OF FACILITIES,208,BRONX,LN-D008,1303,405,1160,0,0,0,0,0,1565,405,1160,0,0,0,0,0,1565,810,2320,0,0,0,0,0,3130,PROJECT DELAYED DUE TO UNFORESEEN SITE/FIELD CONDITION,,REHABILITATION TO EXTERIOR AND FACADES & RETAINING WALL,cpd11-20bx.pdf
LNCL15CAS,CASTLE HILL,850,DEPT OF DESIGN & CONSTRUCTION,ESSENTIAL RECONSTRUCTION OF FACILITIES,200,BRONX,LN-D008 LN-X001 LN-D004 LN-0008 LN-0101X,5191,909,0,6879,5,0,0,0,7793,909,0,6879,5,0,0,0,7793,1818,0,13758,10,0,0,0,15586,PROJECT DELAYED DUE TO UNFORESEEN SITE/FIELD CONDITION,,CASTLE HILL,cpd11-20bx.pdf
LNCM10WCH,WESTCHESTER SQUARE - Replacement Branch Construction,850,DEPT OF DESIGN & CONSTRUCTION,EXPANSION AND CONSTRUCTION OF FACILITIES,211,BRONX,PU-0025 LN-D004 LN-D008 LN-X001 LN-0008,9300,3773,0,812,29437,0,0,0,34022,3773,0,812,29437,0,0,0,34022,7546,0,1624,58874,0,0,0,68044,PROJECT DELAYED PENDING RESOLUTION OF LEGAL ISSUES,,NEW BRANCH CONSTRUCTION - LNCM10WCH,cpd11-20bx.pdf
LNCM12CPT,CLASON'S POINT - NEW ROOF AND DRAINS,850,DEPT OF DESIGN & CONSTRUCTION,ESSENTIAL RECONSTRUCTION OF FACILITIES,200 209,BRONX,LN-D004 LN-0101M LN-D008 LN-X001,600,1237,758,0,0,0,0,0,1995,1237,758,0,0,0,0,0,1995,2474,1516,0,0,0,0,0,3990,PROJECT DELAYED DUE TO UNFORESEEN SITE/FIELD CONDITION,,NEW ROOF AND DRAINS,cpd11-20bx.pdf
LNDSVRENO,SOUNDVIEW - Branch Renovation,850,DEPT OF DESIGN & CONSTRUCTION,ESSENTIAL RECONSTRUCTION OF FACILITIES,209,BRONX,LN-D004 LN-0008,460,1892,47,0,0,0,0,0,1939,1892,47,0,0,0,0,0,1939,3784,94,0,0,0,0,0,3878,PROJECT DELAYED DUE TO BUDGETARY CONSTRAINTS,SOUNDVIEWW BRANCH,BRANCH RENOVATION,cpd11-20bx.pdf
LNEA13MHU,Mosholu,850,DEPT OF DESIGN & CONSTRUCTION,ESSENTIAL RECONSTRUCTION OF FACILITIES,200 207,BRONX,LN-0008 LN-D004 LN-D008 LN-0101M,1137,851,0,8,2914,0,0,0,3773,851,0,8,2914,0,0,0,3773,1702,0,16,5828,0,0,0,7546,PROJECT DELAYED DUE TO CHANGES IN SCOPE/DESIGN,,ROOF,cpd11-20bx.pdf
LNEA13TNK,THROGS NECK,850,DEPT OF DESIGN & CONSTRUCTION,ESSENTIAL RECONSTRUCTION OF FACILITIES,200,BRONX,LN-0008,550,3786,363,0,0,0,0,0,4149,3786,363,0,0,0,0,0,4149,7572,726,0,0,0,0,0,8298,PROJECT DELAYED DUE TO UNFORESEEN SITE/FIELD CONDITION,,"NEW ROOF, HVAC",cpd11-20bx.pdf
LNEA14VNT,HVAC Replacement,850,DEPT OF DESIGN & CONSTRUCTION,ESSENTIAL RECONSTRUCTION OF FACILITIES,200 211,BRONX,LN-0008,500,681,2884,0,0,0,0,0,3565,681,2884,0,0,0,0,0,3565,1362,5768,0,0,0,0,0,7130,PROJECT DELAYED DUE TO UNFORESEEN SITE/FIELD CONDITION,,HVAC REPLACEMENT,cpd11-20bx.pdf
LNXA11WFM,WEST FARMS - New Front Entry,850,DEPT OF DESIGN & CONSTRUCTION,ESSENTIAL RECONSTRUCTION OF FACILITIES,206,BRONX,LN-X001 LN-D004 LN-D008,150,504,754,0,0,0,0,0,1258,504,754,0,0,0,0,0,1258,1008,1508,0,0,0,0,0,2516,PROJECT DELAYED DUE TO CHANGES IN SCOPE/DESIGN,,NEW FRONT ENTRY,cpd11-20bx.pdf
LNXA12GRC,GRAND CONCOURSE - ADA Compliance and Related Work,850,DEPT OF DESIGN & CONSTRUCTION,IMPROVEMENTS TO EXISTING FACILITIES,200 204,BRONX,LN-0008,750,4617,366,0,0,0,0,0,4983,4617,366,0,0,0,0,0,4983,9234,732,0,0,0,0,0,9966,PROJECT DELAYED DUE TO UNFORESEEN SITE/FIELD CONDITION,,ADA COMPLIANCE AND RELATED WORK,cpd11-20bx.pdf
LNXEA08BA,BAYCHESTER,850,DEPT OF DESIGN & CONSTRUCTION,ESSENTIAL RECONSTRUCTION OF FACILITIES,200 212,BRONX,LN-0008 LN-0101M LN-0101X,632,0,0,0,662,0,0,0,662,0,0,0,662,0,0,0,662,0,0,0,1324,0,0,0,1324,PROJECT DELAYED DUE TO UNFORESEEN SITE/FIELD CONDITION,,HVAC,cpd11-20bx.pdf
LNXEA08CP,CLASONS POINT,850,DEPT OF DESIGN & CONSTRUCTION,ESSENTIAL RECONSTRUCTION OF FACILITIES,200 209,BRONX,LN-0008,338,564,73,0,0,0,0,0,637,564,73,0,0,0,0,0,637,1128,146,0,0,0,0,0,1274,PROJECT DELAYED DUE TO UNFORESEEN SITE/FIELD CONDITION,,HAVC,cpd11-20bx.pdf
LNXEA08FN,FRANCIS MARTIN,850,DEPT OF DESIGN & CONSTRUCTION,ESSENTIAL RECONSTRUCTION OF FACILITIES,200 205,BRONX,LN-0008,975,1430,61,0,0,0,0,0,1491,1430,61,0,0,0,0,0,1491,2860,122,0,0,0,0,0,2982,PROJECT DELAYED DUE TO UNFORESEEN SITE/FIELD CONDITION,,HAVC,cpd11-20bx.pdf
P-102DELV,Del Valle Square X009-111M,850,DEPT OF DESIGN & CONSTRUCTION,PRIMARY STREET RECONSTRUCTION,200,BRONX,HW-1684 HW-0200 TF-0002,16961,2019,250,12984,0,0,0,0,15253,2019,250,12984,0,0,0,0,15253,4038,500,25968,0,0,0,0,30506,PROJECT DELAYED DUE TO UNFORESEEN SITE/FIELD CONDITION,TRSNFR $4M (HW 1684) FROM HWPLZ003X...FY'14 ADOPT. ROLLS $3.649M FROMFY'14 TO FY15...$970K,TRSNFR $4M (HW 1684) FROM HWPLZ003X...FY'14 ADOPT. ROLLS $3.649M FROMFY'14 TO FY15...$970K,cpd11-20bx.pdf
P109STARA,STARLIGHT PARK COMFORT STATION X147-111M,850,DEPT OF DESIGN & CONSTRUCTION,"LARGE, MAJOR AND REGIONAL PARK RECONSTRUCTION",209,BRONX,P-1018 P-0882 P-0450,1881,3628,732,0,0,0,0,0,4360,3628,732,0,0,0,0,0,4360,7256,1464,0,0,0,0,0,8720,PROJECT DELAYED DUE TO UNFORESEEN SITE/FIELD CONDITION,,STARLIGHT PARK,cpd11-20bx.pdf
P1CROT16A,BRONX RIVER GRWAY RIVER HOUSE IN STARLIGHT PK X147-107M/407M,850,DEPT OF DESIGN & CONSTRUCTION,"LARGE, MAJOR AND REGIONAL PARK RECONSTRUCTION",209,BRONX,WM-0011 P-0245X P-1018 P-0882,14562,14683,119,244,0,0,0,0,15046,14683,119,244,0,0,0,0,15046,29366,238,488,0,0,0,0,30092,PROJECT DELAYED DUE TO UNFORESEEN SITE/FIELD CONDITION,,BX RIVER,cpd11-20bx.pdf
P-1ORCHMO,Orchard Beach M&O Facility Reconstruction,850,DEPT OF DESIGN & CONSTRUCTION,BEACHES AND BOARDWALKS,200,BRONX,P-D021 P-1018 P-0715,35500,0,0,0,39900,0,0,0,39900,0,0,0,39900,0,0,0,39900,0,0,0,79800,0,0,0,79800,,,FY17 JAN PLAN NN SUBMISSION $4M IN FY 19 AND $12.4M IN FY20...,cpd11-20bx.pdf
P-1PBSTAR,Starlight Park Pedestrian Bridge (P-1SAND01),850,DEPT OF DESIGN & CONSTRUCTION,NEIGHBORHOOD PARKS AND PLAYGROUNDS,200 209,BRONX,P-1018,16400,13817,3576,0,0,0,0,0,17393,13817,3576,0,0,0,0,0,17393,27634,7152,0,0,0,0,0,34786,PROJECT DELAYED DUE TO UNFORESEEN SITE/FIELD CONDITION,BRONX,RECONSTRUCTION OF PEDESTRIAN BRIDGES IN STARLIGHT PARK,cpd11-20bx.pdf
P-1STARLP,BRONX RIVER GREENWAY,850,DEPT OF DESIGN & CONSTRUCTION,NEIGHBORHOOD PARKS AND PLAYGROUNDS,200,BRONX,P-1018,658,8748,2943,0,0,0,0,0,11691,8748,2943,0,0,0,0,0,11691,17496,5886,0,0,0,0,0,23382,PROJECT DELAYED DUE TO UNFORESEEN SITE/FIELD CONDITION,,BX RIVER ALLIANCE STARLIGHT PARK (DDC),cpd11-20bx.pdf
P-1VCPDBR,Vancortlandt Park pedestrian bridge,850,DEPT OF DESIGN & CONSTRUCTION,"LARGE, MAJOR AND REGIONAL PARK RECONSTRUCTION",200,BRONX,P-0245X P-0508,9800,3070,0,7636,0,0,0,0,10706,3070,0,7636,0,0,0,0,10706,6140,0,15272,0,0,0,0,21412,PROJECT DELAYED DUE TO CHANGES IN SCOPE/DESIGN,,VANCORTLANDT PARK PEDESTRIAN BRIDGE,cpd11-20bx.pdf
P1YANK15A,Bronx Children's Museum Fitout,850,DEPT OF DESIGN & CONSTRUCTION,MAJOR RECREATIONAL FACILITIES AND FACILITY RECONSTRUCTION,204,BRONX,PV-X467 P-D021 P-1018 PV-D467 PV-0467,5892,11130,2379,0,0,0,0,0,13509,11130,2379,0,0,0,0,0,13509,22260,4758,0,0,0,0,0,27018,PROJECT DELAYED DUE TO UNFORESEEN SITE/FIELD CONDITION,,YANKEE STADIUM,cpd11-20bx.pdf
PO79FDBNX,"BRONX FRONT DESK REPLACEMENT 42ND, 44TH, 46TH, 108TH",850,DEPT OF DESIGN & CONSTRUCTION,POLICE FACILITIES,200,BRONX,PO-0079,1011,420,1812,181,0,0,0,0,2413,420,1812,181,0,0,0,0,2413,840,3624,362,0,0,0,0,4826,PROJECT DELAYED DUE TO UNFORESEEN SITE/FIELD CONDITION,,DESK REPLACEMENT,cpd11-20bx.pdf
PO79ROD,NEW FIREARMS TRAINING FACILITY,850,DEPT OF DESIGN & CONSTRUCTION,POLICE FACILITIES,200,BRONX,PO-0079,274630,33696,1271,16348,224315,0,0,0,275630,33696,1271,16348,224315,0,0,0,275630,67392,2542,32696,448630,0,0,0,551260,PROJECT DELAYED DUE TO BUDGETARY CONSTRAINTS,"NEW TRAINING FACILITY AT RODMAN'S NECK, BRNX",NEW TRAINING FACILITY,cpd11-20bx.pdf
PV176CESU,WCS - Bronx Zoo - Con Ed Switchgear Upgrade,850,DEPT OF DESIGN & CONSTRUCTION,ESSENTIAL RECONSTRUCTION OF FACILITIES,,BRONX,PV-D176 PV-0176,5909,2133,12999,0,0,0,0,0,15132,2133,12999,0,0,0,0,0,15132,4266,25998,0,0,0,0,0,30264,PROJECT DELAYED PENDING RESOLUTION OF LEGAL ISSUES,"2300 SOUTHERN BLVD, FORDAM ROAD BRONX NY",ELECTRICAL SWITCHGEAR UPGRADE AT BRONX ZOO.,cpd11-20bx.pdf
PV176ITF1,WCS - Bronx Zoo Parking Lot Improvements,850,DEPT OF DESIGN & CONSTRUCTION,ESSENTIAL RECONSTRUCTION OF FACILITIES,206 207 211,BRONX,PV-0545,10440,5538,0,0,0,0,0,0,5538,5538,0,0,0,0,0,0,5538,11076,0,0,0,0,0,0,11076,PROJECT DELAYED PENDING RESOLUTION OF LEGAL ISSUES,"2300 SOUTHERN BLVD. BRONX, NY",PARKING LOT IMPROVEMENTS,cpd11-20bx.pdf
PV205CONS,NYBG - NY Botanical Garden - Conservatory Dome/Boiler Rep.,850,DEPT OF DESIGN & CONSTRUCTION,ESSENTIAL RECONSTRUCTION OF FACILITIES,206 207 211 212,BRONX,PV-0205,8000,10843,0,0,0,0,0,0,10843,10843,0,0,0,0,0,0,10843,21686,0,0,0,0,0,0,21686,PROJECT DELAYED DUE TO BUDGETARY CONSTRAINTS,,NY BOTANICAL GARDEN - CONSERVATORY DOME,cpd11-20bx.pdf
PV464PRKG,WH - Wave Hill - Parking Lot Improvements,850,DEPT OF DESIGN & CONSTRUCTION,ESSENTIAL RECONSTRUCTION OF FACILITIES,,BRONX,PV-0464,1581,4795,372,0,0,0,0,0,5167,4795,372,0,0,0,0,0,5167,9590,744,0,0,0,0,0,10334,PROJECT DELAYED PENDING RESOLUTION OF LEGAL ISSUES,"675 WEST 252ND STREET, BRONX, NY",PARKING LOT IMPROVEMENTS,cpd11-20bx.pdf
PWXTNLLRE,Throgs Neck Little League- Infrastructure Rehabilitation,850,DEPT OF DESIGN & CONSTRUCTION,MISCELLANEOUS CONSTRUCTION,210,BRONX,PW-X078,453,0,0,0,0,0,0,400,400,0,0,0,0,0,0,400,400,0,0,0,0,0,0,800,800,PROJECT DELAYED DUE TO BUDGETARY CONSTRAINTS,,THROGS NECK LITTLE LEAGUE INFRASTRUCTURE REHABILITATION,cpd11-20bx.pdf
REG-HP06,RECONSTRUCTION OF REGULATOR HP-06,850,DEPT OF DESIGN & CONSTRUCTION,WATER QUALITY MANDATES,200,BRONX,WP-0169,25000,0,691,24516,0,0,0,0,25207,0,691,24516,0,0,0,0,25207,0,1382,49032,0,0,0,0,50414,,,RECONSTRUCTION OF REGULATOR HP-06,cpd11-20bx.pdf
SANDBOMB,Reconstruct Hurricane Sandy Damaged Bomb Sq bldg,850,DEPT OF DESIGN & CONSTRUCTION,POLICE FACILITIES,210,BRONX,PO-0079 PU-0025,5000,853,0,1718,0,0,0,0,2571,853,0,1718,0,0,0,0,2571,1706,0,3436,0,0,0,0,5142,PROJECT DELAYED DUE TO UNFORESEEN SITE/FIELD CONDITION,,RECONSTRUCT MULTIPURPOSE BUILDING FOR THE BOMB SQUAD IN RODMAN'S NECKDAMAGED BY,cpd11-20bx.pdf
SANDBULK2,Reconstruction of Vincent Ave Bulkhead - Hurricane Sandy,850,DEPT OF DESIGN & CONSTRUCTION,PRIMARY STREET RECONSTRUCTION,200,BRONX,HW-0001X,104,0,0,0,0,12,0,0,12,0,0,0,0,12,0,0,12,0,0,0,0,24,0,0,24,PROJECT DELAYED DUE TO BUDGETARY CONSTRAINTS,RECONSTRUCTION OF VINCENT AVE BULKHEAD - HURRICANE SANDY,RECONSTRUCTION OF VINCENT AVE BULKHEAD - HURRICANE SANDY,cpd11-20bx.pdf
SEX002266,"Repl & Rehab of Combined swrs 171 to 175 sts, bx",850,DEPT OF DESIGN & CONSTRUCTION,REPLACEMENT OF CHRONICALLY FAILING COMPONENTS,200,BRONX,SE-0002K,153,0,153,0,0,0,0,0,153,0,153,0,0,0,0,0,153,0,306,0,0,0,0,0,306,PROJECT DELAYED DUE TO UNFORESEEN SITE/FIELD CONDITION,,"REPL AND REHAB OF COMB SWRS FROM E. 171 ST TO E 175 ST., BRONX",cpd11-20bx.pdf
SEX002268,Reconstruction of Grand Concourse - Phase 4 (HWXP136C),850,DEPT OF DESIGN & CONSTRUCTION,REPLACEMENT OF CHRONICALLY FAILING COMPONENTS,204,BRONX,SE-0002X,4258,3862,0,618,0,0,0,0,4480,3862,0,618,0,0,0,0,4480,7724,0,1236,0,0,0,0,8960,,,RECONSTRUCTION OF GRAND CONCOURSE - PHASE 4( HWXP136C) - COMBINED SEWER REPLACEMENT,cpd11-20bx.pdf
SEX002271,Upgrade combined sewer Franklin ave- other Locs HWTRQX1,850,DEPT OF DESIGN & CONSTRUCTION,REPLACEMENT OR AUGMENTATION OF EXISTING SYSTEMS,200,BRONX,SE-0002X WM-0001,2970,0,0,2706,0,0,0,0,2706,0,0,2706,0,0,0,0,2706,0,0,5412,0,0,0,0,5412,,,UPGRADE COMBINED SEWER IN FRANKLIN AVENUE AND OTHER LOCATIONS IDENTIFIED ON SHEET,cpd11-20bx.pdf
SEX200400,STORM & SAN SEWERS REPL & EXT IN MININIEFORD AVE AREA,850,DEPT OF DESIGN & CONSTRUCTION,EXTENSIONS TO ACCOMMODATE NEW DEVELOPMENT,210,BRONX,SE-0200X SE-0002X HW-0001X,1378,920,0,1868,686,0,0,0,3474,920,0,1868,686,0,0,0,3474,1840,0,3736,1372,0,0,0,6948,PROJECT DELAYED DUE TO CHANGES IN SCOPE/DESIGN,,STORM & SAN SEWERS REPL & EXT IN MININIEFORD AVE AREA,cpd11-20bx.pdf
SEX20042,STRM SWR IN WILLIAM AVE B/T DITMARS ST AND TIER ST,850,DEPT OF DESIGN & CONSTRUCTION,EXTENSIONS TO ACCOMMODATE NEW DEVELOPMENT,200 210,BRONX,SE-0200X,413,91,413,0,0,0,0,0,504,91,413,0,0,0,0,0,504,182,826,0,0,0,0,0,1008,PROJECT DELAYED DUE TO UNFORESEEN SITE/FIELD CONDITION,,STRM SWR IN WILLIAM AVE B/T DITMARS ST AND TIER ST,cpd11-20bx.pdf
SEX20047,Replacement of combined sewer in Burr Ave,850,DEPT OF DESIGN & CONSTRUCTION,REPLACEMENT OF CHRONICALLY FAILING COMPONENTS,210,BRONX,SE-0200X WM-0001,12149,18834,2117,0,0,0,0,0,20951,18834,2117,0,0,0,0,0,20951,37668,4234,0,0,0,0,0,41902,,,"REPLACEMENT OF COMBINED SEWER IN BURR AVE BET. PELHAM PKWY S. AND WESTCHESTER AVE,",cpd11-20bx.pdf
SEX20049,Replacing deteriorating retain wall along Pratt Ave in BX,850,DEPT OF DESIGN & CONSTRUCTION,REPLACEMENT OR AUGMENTATION OF EXISTING SYSTEMS,212,BRONX,SE-0002X,1254,0,0,0,1114,0,0,0,1114,0,0,0,1114,0,0,0,1114,0,0,0,2228,0,0,0,2228,,,REPLACEMENT OF DETERIORATING RETAINING WALL ALONG PRATT AVENUE. NEW COMBINED SEWER,cpd11-20bx.pdf
SEX-SURV4,SURVEYS FOR SEWERS IN BRONX,850,DEPT OF DESIGN & CONSTRUCTION,REPLACEMENT OF CHRONICALLY FAILING COMPONENTS,200,BRONX,HW-0348 SE-0002X SE-0432,10564,7717,1394,167,0,0,0,0,9278,7717,1394,167,0,0,0,0,9278,15434,2788,334,0,0,0,0,18556,PROJECT DELAYED DUE TO UNFORESEEN SITE/FIELD CONDITION,BOROUGH WIDE,SURVEYS FOR SEWER CONSTRUCTION/ RECONSTRUCTION,cpd11-20bx.pdf
ACEDOE703,DOE - STEAM TRAPS,856,DEPT OF CITYWIDE ADMIN SERVS,"BUILDING CONSTRUCTION, RECONSTRUCTION OR RETROFIT",201,BRONX,PU-0025,228,0,0,228,0,0,0,0,228,0,0,228,0,0,0,0,228,0,0,456,0,0,0,0,456,,,DOE - STEAM TRAPS,cpd11-20bx.pdf
ACEHHC901,HHC - Energy Upgrades at Lincoln Hospital Phase 2,856,DEPT OF CITYWIDE ADMIN SERVS,"BUILDING CONSTRUCTION, RECONSTRUCTION OR RETROFIT",201,BRONX,PU-0025,27000,0,27000,0,0,0,0,0,27000,0,27000,0,0,0,0,0,27000,0,54000,0,0,0,0,0,54000,,,ENERGY UPGRADES AT LINCOLN HOSPITAL PHASE 2,cpd11-20bx.pdf
C75TURB,REPLACEMENT OF CO-GENERATION PLANT TURBINES,856,DEPT OF CITYWIDE ADMIN SERVS,BUILDING SYSTEMS AND INFRASTRUCTURE,200,BRONX,C-0075,6120,0,8163,0,0,0,0,0,8163,0,8163,0,0,0,0,0,8163,0,16326,0,0,0,0,0,16326,,,REPLACEMENT OF CO-GENERATION PLANT TURBINES,cpd11-20bx.pdf
CO293201A,DASNY - 851 GRAND CONCOURSE- RENOVATIONS,856,DEPT OF CITYWIDE ADMIN SERVS,RECONSTRUCTION/RENOVATION OF COURT FACILITIES,204,BRONX,CO-0293,40475,1751,0,2621,0,0,0,0,4372,1751,0,2621,0,0,0,0,4372,3502,0,5242,0,0,0,0,8744,PROJECT DELAYED DUE TO CHANGES IN SCOPE/DESIGN,"851 GRAND CONCOURSE BRONX, NY 10451",INTERIOR RENOVATIONS; ELECTRICAL & HVAC DISTRIBUTION; INITIAL OUTFITTING OF NEWLY,cpd11-20bx.pdf
CO293CTR,851 GRAND CONCOURSE -COOLING TOWER REPLACEMENT,856,DEPT OF CITYWIDE ADMIN SERVS,RECONSTRUCTION/RENOVATION OF COURT FACILITIES,201,BRONX,CO-0293,1140,0,0,85,0,0,0,945,1030,0,0,85,0,0,0,945,1030,0,0,170,0,0,0,1890,2060,,,851 GRAND CONCOURSE - COOLING TOWER REPLACEMENT,cpd11-20bx.pdf
CO293EV,851 GRAND CONCOURSE - ELEVATORS,856,DEPT OF CITYWIDE ADMIN SERVS,RECONSTRUCTION/RENOVATION OF COURT FACILITIES,201,BRONX,CO-0293,13000,0,0,0,1000,0,0,12000,13000,0,0,0,1000,0,0,12000,13000,0,0,0,2000,0,0,24000,26000,,,851 GRAND CONCOURSE - ELEVATORS,cpd11-20bx.pdf
CO293HO,851 GRAND CONCOURSE - HOUSING COURT RELOCATION,856,DEPT OF CITYWIDE ADMIN SERVS,RECONSTRUCTION/RENOVATION OF COURT FACILITIES,204,BRONX,CO-0264,19684,1171,0,17171,0,0,0,0,18342,1171,0,17171,0,0,0,0,18342,2342,0,34342,0,0,0,0,36684,,,INTERIOR BUILDOUT,cpd11-20bx.pdf
CO293SA,851 GRAND CONCOURSE - SAFE ACCESS TO MECHANICAL SYSTEM,856,DEPT OF CITYWIDE ADMIN SERVS,RECONSTRUCTION/RENOVATION OF COURT FACILITIES,201,BRONX,CO-0293,176,43,0,0,0,0,71,0,114,43,0,0,0,0,71,0,114,86,0,0,0,0,142,0,228,PROJECT DELAYED DUE TO CHANGES IN SCOPE/DESIGN,,851 GRAND CONCOURSE - SAFE ACCESS TO MECHANICAL SYSTEM,cpd11-20bx.pdf
CO294BACK,DASNY - 215 E. 161ST ST.- BACKFILL,856,DEPT OF CITYWIDE ADMIN SERVS,RECONSTRUCTION/RENOVATION OF COURT FACILITIES,204,BRONX,CS-0003 CO-0294,63456,1857,926,3725,0,0,0,0,6508,1857,926,3725,0,0,0,0,6508,3714,1852,7450,0,0,0,0,13016,PROJECT DELAYED DUE TO CHANGES IN SCOPE/DESIGN,"215 E. 161ST ST. BRONX, NY",EXTENSIVE INTERIOR RENOVATIONS; INITIAL OUTFITTING; VOICE & DATA CABLING,cpd11-20bx.pdf
CO294BOIL,215 EAST161ST STREET- REPLACEMENT OF BOILER,856,DEPT OF CITYWIDE ADMIN SERVS,RECONSTRUCTION/RENOVATION OF COURT FACILITIES,204,BRONX,CO-0294,3523,403,0,0,0,3060,0,0,3463,403,0,0,0,3060,0,0,3463,806,0,0,0,6120,0,0,6926,,,215 EAST161ST STREET- REPLACEMENT OF BOILER,cpd11-20bx.pdf
CO295FIRE,1118 GRAND CONCOURSE - FIRE ALARM UPGRADE,856,DEPT OF CITYWIDE ADMIN SERVS,RECONSTRUCTION/RENOVATION OF COURT FACILITIES,201,BRONX,CO-0295,5815,0,0,534,0,5181,0,0,5715,0,0,534,0,5181,0,0,5715,0,0,1068,0,10362,0,0,11430,,,1118 GRAND CONCOURSE - FIRE ALARM DESIGN & REPLACEMENT,cpd11-20bx.pdf
CO295ROOF,1118 GRAND CONCOURSE - ROOF,856,DEPT OF CITYWIDE ADMIN SERVS,RECONSTRUCTION/RENOVATION OF COURT FACILITIES,201,BRONX,CO-0295,172,0,0,0,20,0,132,0,152,0,0,0,20,0,132,0,152,0,0,0,40,0,264,0,304,,,1118 GRAND CONCOURSE -ROOF,cpd11-20bx.pdf
COD294CBG,BRONX CENTRAL BOOKING /BRONX COURT SECTION - FITNESS CENTER,856,DEPT OF CITYWIDE ADMIN SERVS,RECONSTRUCTION/RENOVATION OF COURT FACILITIES,201,BRONX,CO-D294,50,0,50,0,0,0,0,0,50,0,50,0,0,0,0,0,50,0,100,0,0,0,0,0,100,,,SQ/IA,cpd11-20bx.pdf
DAVIDCC,DAVIDSON COMMUNITY CENTER GYM,856,DEPT OF CITYWIDE ADMIN SERVS,MISCELLANEOUS CONSTRUCTION,203,BRONX,PW-D005,750,0,0,750,0,0,0,0,750,0,0,750,0,0,0,0,750,0,0,1500,0,0,0,0,1500,,,DAVIDSON COMMUNITY CENTER GYM,cpd11-20bx.pdf
E08-0006A,NYPD - 08-147,856,DEPT OF CITYWIDE ADMIN SERVS,"BUILDING CONSTRUCTION, RECONSTRUCTION OR RETROFIT",202,BRONX,PO-0079,410,345,39,0,0,0,0,0,384,345,39,0,0,0,0,0,384,690,78,0,0,0,0,0,768,,,"ENERGY EFFICIENCY UPGRADE AT OLD 41ST PRECINCT, 1086 SIMPSON STREET",cpd11-20bx.pdf
E14-0002,DCAS - BRONX COUNTY COURT COMP ENERGY UPGRADE,856,DEPT OF CITYWIDE ADMIN SERVS,"BUILDING CONSTRUCTION, RECONSTRUCTION OR RETROFIT",200 204,BRONX,PU-0025,6179,5537,200,459,0,0,0,0,6196,5537,200,459,0,0,0,0,6196,11074,400,918,0,0,0,0,12392,PROJECT DELAYED DUE TO CHANGES IN SCOPE/DESIGN,,ENERGY UPGRADE,cpd11-20bx.pdf
EO26-0040,CUNY - Bronx Community College Campus,856,DEPT OF CITYWIDE ADMIN SERVS,"BUILDING CONSTRUCTION, RECONSTRUCTION OR RETROFIT",201,BRONX,PU-0025,700,0,5760,0,0,0,0,0,5760,0,5760,0,0,0,0,0,5760,0,11520,0,0,0,0,0,11520,,,CUNY - BRONX COMMUNITY COLLEGE CAMPUS,cpd11-20bx.pdf
EO26-0042,CUNY - Bronx Community College Campus,856,DEPT OF CITYWIDE ADMIN SERVS,"BUILDING CONSTRUCTION, RECONSTRUCTION OR RETROFIT",201,BRONX,PU-0025,300,0,0,300,0,0,0,0,300,0,0,300,0,0,0,0,300,0,0,600,0,0,0,0,600,,,CUNY - BRONX COMMUNITY COLLEGE CAMPUS,cpd11-20bx.pdf
EO26-0043,CUNY - Bronx Community College Campus,856,DEPT OF CITYWIDE ADMIN SERVS,"BUILDING CONSTRUCTION, RECONSTRUCTION OR RETROFIT",201,BRONX,PU-0025,375,0,0,375,0,0,0,0,375,0,0,375,0,0,0,0,375,0,0,750,0,0,0,0,750,,,CUNY - BRONX COMMUNITY COLLEGE CAMPUS,cpd11-20bx.pdf
EO26-0044,CUNY - Bronx Community College Campus,856,DEPT OF CITYWIDE ADMIN SERVS,"BUILDING CONSTRUCTION, RECONSTRUCTION OR RETROFIT",201,BRONX,PU-0025,375,0,0,375,0,0,0,0,375,0,0,375,0,0,0,0,375,0,0,750,0,0,0,0,750,,,CUNY - BRONX COMMUNITY COLLEGE CAMPUS,cpd11-20bx.pdf
EO26-0045,CUNY - Bronx Community College Campus,856,DEPT OF CITYWIDE ADMIN SERVS,"BUILDING CONSTRUCTION, RECONSTRUCTION OR RETROFIT",201,BRONX,PU-0025,375,0,0,375,0,0,0,0,375,0,0,375,0,0,0,0,375,0,0,750,0,0,0,0,750,,,CUNY - BRONX COMMUNITY COLLEGE CAMPUS,cpd11-20bx.pdf
EO26-0063,NYPD - 40th Precinct,856,DEPT OF CITYWIDE ADMIN SERVS,"BUILDING CONSTRUCTION, RECONSTRUCTION OR RETROFIT",201,BRONX,PU-0025,300,0,0,300,0,0,0,0,300,0,0,300,0,0,0,0,300,0,0,600,0,0,0,0,600,PROJECT DELAYED DUE TO CHANGES IN SCOPE/DESIGN,,40TH PRECINCT,cpd11-20bx.pdf
EO26-0064,NYPD - 52nd Precinct,856,DEPT OF CITYWIDE ADMIN SERVS,"BUILDING CONSTRUCTION, RECONSTRUCTION OR RETROFIT",201,BRONX,PU-0025,300,0,0,300,0,0,0,0,300,0,0,300,0,0,0,0,300,0,0,600,0,0,0,0,600,PROJECT DELAYED DUE TO CHANGES IN SCOPE/DESIGN,,52ND PRECINCT,cpd11-20bx.pdf
EO26-0075,NYPD - 44TH PRECINCT,856,DEPT OF CITYWIDE ADMIN SERVS,"BUILDING CONSTRUCTION, RECONSTRUCTION OR RETROFIT",201,BRONX,PU-0025,300,0,241,0,0,0,0,0,241,0,241,0,0,0,0,0,241,0,482,0,0,0,0,0,482,PROJECT DELAYED DUE TO CHANGES IN SCOPE/DESIGN,,IA/SQ,cpd11-20bx.pdf
EO26-0080,DHS - FRANKLIN WOMEN'S SHELTER,856,DEPT OF CITYWIDE ADMIN SERVS,"BUILDING CONSTRUCTION, RECONSTRUCTION OR RETROFIT",201,BRONX,PU-0025,500,0,0,415,0,0,0,0,415,0,0,415,0,0,0,0,415,0,0,830,0,0,0,0,830,PROJECT DELAYED DUE TO CHANGES IN SCOPE/DESIGN,,IA/SQ,cpd11-20bx.pdf
EO26-0089,DPR - BRONX PARKS HEADQUARTERS AND SHOPS,856,DEPT OF CITYWIDE ADMIN SERVS,"BUILDING CONSTRUCTION, RECONSTRUCTION OR RETROFIT",201,BRONX,PU-0025,500,0,0,213,0,0,0,0,213,0,0,213,0,0,0,0,213,0,0,426,0,0,0,0,426,PROJECT DELAYED DUE TO CHANGES IN SCOPE/DESIGN,,IA/SQ,cpd11-20bx.pdf
NDF-DAVID,NDF - DAVIDSON AVE COMMUNITY CENTER,856,DEPT OF CITYWIDE ADMIN SERVS,NEIGHBORHOOD REVITALIZATION,205,BRONX,ED-0384,1875,0,1875,0,0,0,0,0,1875,0,1875,0,0,0,0,0,1875,0,3750,0,0,0,0,0,3750,,,BLDG CONS,cpd11-20bx.pdf
PW293198X,198 E 161ST STREET - FIRE ALARM UPGRADE,856,DEPT OF CITYWIDE ADMIN SERVS,LEGAL MANDATES AND CORRECTION OF UNSAFE CONDITIONS,201,BRONX,PW-0293,4655,0,350,700,3500,0,0,0,4550,0,350,700,3500,0,0,0,4550,0,700,1400,7000,0,0,0,9100,,,198 E 161ST STREET - FIRE ALARM DESIGN,cpd11-20bx.pdf
PW77198CT,198 E 161 ST.- COOLING TOWER REPLACEMENT,856,DEPT OF CITYWIDE ADMIN SERVS,REHABILITATION OF CITY-OWNED OFFICE SPACE,204,BRONX,PW-0077,878,0,0,77,0,0,711,0,788,0,0,77,0,0,711,0,788,0,0,154,0,0,1422,0,1576,,,UNIT,cpd11-20bx.pdf
PW77198EV,"198 E 161 ST - ELEVATOR ,MODERNIZATION",856,DEPT OF CITYWIDE ADMIN SERVS,REHABILITATION OF CITY-OWNED OFFICE SPACE,201,BRONX,PW-0077,16306,0,1156,0,13877,0,0,0,15033,0,1156,0,13877,0,0,0,15033,0,2312,0,27754,0,0,0,30066,,,IA/SQ,cpd11-20bx.pdf
PW772076,1932 ARTHUR AVE.- 7th FLOOR BUILDOUT,856,DEPT OF CITYWIDE ADMIN SERVS,REHABILITATION OF CITY-OWNED OFFICE SPACE,206,BRONX,PW-0077,9200,0,0,764,7600,0,0,0,8364,0,0,764,7600,0,0,0,8364,0,0,1528,15200,0,0,0,16728,,,$490 PER SQ FT,cpd11-20bx.pdf
PW77207DC,1932 ARTHUR AVENUE RENOVATION - 5TH FLOOR - DOB,856,DEPT OF CITYWIDE ADMIN SERVS,REHABILITATION OF CITY-OWNED OFFICE SPACE,201,BRONX,PW-0077,6716,0,0,0,550,0,6166,0,6716,0,0,0,550,0,6166,0,6716,0,0,0,1100,0,12332,0,13432,,,SQ/IA,cpd11-20bx.pdf
PW77207EL,1932 ARTHUR AVE.- ELECTRICAL UPGRADES,856,DEPT OF CITYWIDE ADMIN SERVS,REHABILITATION OF CITY-OWNED OFFICE SPACE,201,BRONX,PW-0077,3510,0,0,688,0,8261,0,0,8949,0,0,688,0,8261,0,0,8949,0,0,1376,0,16522,0,0,17898,PROJECT DELAYED DUE TO BUDGETARY CONSTRAINTS,,1932 ARTHUR AVE.- ELECTRICAL UPGRADES,cpd11-20bx.pdf
PW77207RF,1932 ARTHUR AVE.- ROOF,856,DEPT OF CITYWIDE ADMIN SERVS,REHABILITATION OF CITY-OWNED OFFICE SPACE,206,BRONX,PW-0077,1482,0,0,123,0,1225,0,0,1348,0,0,123,0,1225,0,0,1348,0,0,246,0,2450,0,0,2696,,1932 ARTHUR AVE BRONX,RECONSTRUCT ROOF,cpd11-20bx.pdf
PW77207TU,1932 ARTHUR AVENUE- CODE COMPLIANT TOILET UPGRADES,856,DEPT OF CITYWIDE ADMIN SERVS,REHABILITATION OF CITY-OWNED OFFICE SPACE,201,BRONX,PW-0077,1550,0,0,0,150,0,1400,0,1550,0,0,0,150,0,1400,0,1550,0,0,0,300,0,2800,0,3100,PROJECT DELAYED DUE TO BUDGETARY CONSTRAINTS,,CODE COMPLIANT TOILET UPGRADES,cpd11-20bx.pdf
PW77207W,1932 ARTHUR AVE.- WINDOWS AND FACADE,856,DEPT OF CITYWIDE ADMIN SERVS,REHABILITATION OF CITY-OWNED OFFICE SPACE,201,BRONX,PW-0077,7995,0,0,662,0,6606,0,0,7268,0,0,662,0,6606,0,0,7268,0,0,1324,0,13212,0,0,14536,,,1932 ARTHUR AVE - WINDOWS AND FACADE,cpd11-20bx.pdf
PW77CTCX4,2556 BAINBRIDGE AVE- CIVIL SERVICE EXAM TESTING CENTER,856,DEPT OF CITYWIDE ADMIN SERVS,REHABILITATION OF CITY-OWNED OFFICE SPACE,201,BRONX,PW-0077,18675,0,0,0,0,0,2000,28201,30201,0,0,0,0,0,2000,28201,30201,0,0,0,0,0,4000,56402,60402,,,2556 BAINBRIDGE AVE- CIVIL SERVICE EXAM TESTING CENTER,cpd11-20bx.pdf
PW77X215,215 E161 ST.- OFFICE RENOVATIONS,856,DEPT OF CITYWIDE ADMIN SERVS,REHABILITATION OF CITY-OWNED OFFICE SPACE,201,BRONX,PW-0077,628,0,0,0,0,0,2494,0,2494,0,0,0,0,0,2494,0,2494,0,0,0,0,0,4988,0,4988,PROJECT DELAYED DUE TO BUDGETARY CONSTRAINTS,,COMPLAINT PROCESSING AREA RELOCATION TO 4TH FLR ANNEX.,cpd11-20bx.pdf
PWD5BA1,2556 Bainbridge Ave. Community Ctr.,856,DEPT OF CITYWIDE ADMIN SERVS,REHABILITATION OF CITY-OWNED OFFICE SPACE,202,BRONX,PW-D005,2500,0,0,0,0,2500,0,0,2500,0,0,0,0,2500,0,0,2500,0,0,0,0,5000,0,0,5000,,,2556 BAINBRIDGE AVE. COMMUNITY CTR.,cpd11-20bx.pdf
PWD5BA2,2556 Bainbridge Ave - Fordham Library renovation,856,DEPT OF CITYWIDE ADMIN SERVS,REHABILITATION OF CITY-OWNED OFFICE SPACE,202,BRONX,PW-D005,1128,0,0,0,0,2000,0,0,2000,0,0,0,0,2000,0,0,2000,0,0,0,0,4000,0,0,4000,PROJECT DELAYED DUE TO BUDGETARY CONSTRAINTS,,DCAS - OLD FORDHAM LIBRARY RENOVATION -- FUNDS WILL GO TO DCAS TO RENOVATE THE OLD,cpd11-20bx.pdf
PWXDAVDCC,DCAS/DAVIDSON COMMUNITY CENTER - CONSTRUCT 2 ADDITIONAL FLOO,856,DEPT OF CITYWIDE ADMIN SERVS,MISCELLANEOUS CONSTRUCTION,203,BRONX,PW-X078,500,0,0,500,0,0,0,0,500,0,0,500,0,0,0,0,500,0,0,1000,0,0,0,0,1000,,,"DCAS/DAVIDSON COMMUNITY CENTER - CONSTRUCT 2 ADDITIONAL FLOORS & ELEVATOR, FY20 EXE",cpd11-20bx.pdf
S136-434,DSNY - 720-780 E132 St - Bronx 1 3 4 Garage Rehab,856,DEPT OF CITYWIDE ADMIN SERVS,GARAGES AND FACILITIES,201,BRONX,S-0136,3214,0,7959,0,0,0,0,0,7959,0,7959,0,0,0,0,0,7959,0,15918,0,0,0,0,0,15918,PROJECT DELAYED DUE TO BUDGETARY CONSTRAINTS,,REHABILITATION,cpd11-20bx.pdf
SOLARDOS5,DSNY - PV Installation on Garage - Bronx 9/10/11,856,DEPT OF CITYWIDE ADMIN SERVS,DISTRIBUTED GENERATION,201,BRONX,PU-0025,4016,0,0,0,3716,0,0,0,3716,0,0,0,3716,0,0,0,3716,0,0,0,7432,0,0,0,7432,,,DSNY - PV INSTALLATION ON GARAGE - BRONX,cpd11-20bx.pdf
SOLARPQL2,DCAS PQL Round 2 (EdEn),856,DEPT OF CITYWIDE ADMIN SERVS,"BUILDING CONSTRUCTION, RECONSTRUCTION OR RETROFIT",201,BRONX,PU-0025,4300,0,0,4300,0,0,0,0,4300,0,0,4300,0,0,0,0,4300,0,0,8600,0,0,0,0,8600,,,DCAS PQL ROUND 2 (EDEN),cpd11-20bx.pdf
CA207-006,CUNY Incubator Network,042,CITY UNIVERSITY,MISCELLANEOUS RECONSTRUCTION,000,CITYWIDE,HN-0206,7500,0,0,0,0,0,7160,0,7160,0,0,0,0,0,7160,0,7160,0,0,0,0,0,14320,0,14320,PROJECT DELAYED DUE TO CHANGES IN SCOPE/DESIGN,,PROVIDE SPACE IN EACH COMMUNITY COLLEGE TO OFFER RESOURCES FOR SMALL BUSINESS,cpd11-20cw.pdf
PO79-ADA,ADA COMPLIANCE RENOVATIONS AT NYPD PRECINCTS,056,POLICE DEPARTMENT,POLICE FACILITIES,000,CITYWIDE,PO-0079,29337,0,5300,20000,4037,0,0,0,29337,0,5300,20000,4037,0,0,0,29337,0,10600,40000,8074,0,0,0,58674,,,ADA COMPLIANCE RENOVATION AT NYPD PRECINTS,cpd11-20cw.pdf
PO79BATH,CITYWIDE BATHROOM RENOVATION,056,POLICE DEPARTMENT,POLICE FACILITIES,000,CITYWIDE,PO-0079,346,36575,543,0,0,0,0,0,37118,36575,543,0,0,0,0,0,37118,73150,1086,0,0,0,0,0,74236,PROJECT DELAYED DUE TO CHANGES IN SCOPE/DESIGN,,BATHROOM RENOVATION,cpd11-20cw.pdf
PO79BMAHD,"BATHROOM RENO AT 67TH, 77TH AND TRAFFIC CONTROL DIVISION",056,POLICE DEPARTMENT,POLICE FACILITIES,000,CITYWIDE,PO-0079,1407,1354,53,0,0,0,0,0,1407,1354,53,0,0,0,0,0,1407,2708,106,0,0,0,0,0,2814,PROJECT DELAYED DUE TO CHANGES IN SCOPE/DESIGN,,BATHROOM RENOVATION,cpd11-20cw.pdf
PO79BMAHI,"BOILER REPLACEMENT AT 68TH, 76TH AND 102ND PCTS",056,POLICE DEPARTMENT,POLICE FACILITIES,000,CITYWIDE,PO-0079,1430,105,2325,0,0,0,0,0,2430,105,2325,0,0,0,0,0,2430,210,4650,0,0,0,0,0,4860,PROJECT DELAYED DUE TO CHANGES IN SCOPE/DESIGN,,BOILER REPLACEMENTS,cpd11-20cw.pdf
PO79BMAHY,"BOILERS AT 26TH, 42ND & 46TH PRECINCTS",056,POLICE DEPARTMENT,POLICE FACILITIES,000,CITYWIDE,PO-0079,1258,137,136,985,0,0,0,0,1258,137,136,985,0,0,0,0,1258,274,272,1970,0,0,0,0,2516,PROJECT DELAYED DUE TO CHANGES IN SCOPE/DESIGN,,BOILER REPLACEMENT,cpd11-20cw.pdf
PO79BMAJZ,49TH & 115TH & MTN PCT HVAC REPLACEMENT,056,POLICE DEPARTMENT,POLICE FACILITIES,000,CITYWIDE,PO-0079,2755,0,2372,0,0,0,0,0,2372,0,2372,0,0,0,0,0,2372,0,4744,0,0,0,0,0,4744,,,ESTIMATES,cpd11-20cw.pdf
PO79BMAKF,CAC BATHROOM RENOVATION,056,POLICE DEPARTMENT,POLICE FACILITIES,000,CITYWIDE,PO-0079,487,0,487,0,0,0,0,0,487,0,487,0,0,0,0,0,487,0,974,0,0,0,0,0,974,,,ESTIMATE,cpd11-20cw.pdf
PO79BMAKI,"BOILERS AT MTS, HWY 3, 75 & 77 PRECINCTS",056,POLICE DEPARTMENT,POLICE FACILITIES,000,CITYWIDE,PO-0079,3268,0,392,2876,0,0,0,0,3268,0,392,2876,0,0,0,0,3268,0,784,5752,0,0,0,0,6536,,,ESTIMATE,cpd11-20cw.pdf
PO79BMAKM,PSA4 HVAC,056,POLICE DEPARTMENT,POLICE FACILITIES,000,CITYWIDE,PO-0079,2908,0,500,0,2408,0,0,0,2908,0,500,0,2408,0,0,0,2908,0,1000,0,4816,0,0,0,5816,,,ESTIMATE,cpd11-20cw.pdf
PO79BMAKN,BOILERS REPLACEMENT AT BMS & SRG4,056,POLICE DEPARTMENT,POLICE FACILITIES,000,CITYWIDE,PO-0079,3000,0,300,2700,0,0,0,0,3000,0,300,2700,0,0,0,0,3000,0,600,5400,0,0,0,0,6000,,,ESTIMATE,cpd11-20cw.pdf
PO79CWAC,CITYWIDE HVAC PROGRAM,056,POLICE DEPARTMENT,POLICE FACILITIES,000,CITYWIDE,PO-0079,20800,354,11000,6731,215,2500,0,0,20800,354,11000,6731,215,2500,0,0,20800,708,22000,13462,430,5000,0,0,41600,PROJECT DELAYED DUE TO CHANGES IN SCOPE/DESIGN,CITYWIDE,HVAC,cpd11-20cw.pdf
PO79FATS,FIREARMS TACTICAL TRAINING CENTERS,056,POLICE DEPARTMENT,POLICE FACILITIES,000,CITYWIDE,PO-0079,9614,4175,126,0,0,0,0,0,4301,4175,126,0,0,0,0,0,4301,8350,252,0,0,0,0,0,8602,PROJECT DELAYED DUE TO UNFORESEEN SITE/FIELD CONDITION,CITYWIDE,TRAINING CENTERS,cpd11-20cw.pdf
PO79LOCK,CITYWIDE LOCKER ROOM RENOVATION,056,POLICE DEPARTMENT,POLICE FACILITIES,000,CITYWIDE,PO-0079,59699,37128,14121,0,3700,4751,0,0,59700,37128,14121,0,3700,4751,0,0,59700,74256,28242,0,7400,9502,0,0,119400,PROJECT DELAYED DUE TO UNFORESEEN SITE/FIELD CONDITION,CITYWIDE,LOCKER ROOMS,cpd11-20cw.pdf
PO79TIME,TIMES SQUARE STATION RENOVATION,056,POLICE DEPARTMENT,POLICE FACILITIES,000,CITYWIDE,PO-0079,1500,5256,127,0,0,0,0,0,5383,5256,127,0,0,0,0,0,5383,10512,254,0,0,0,0,0,10766,PROJECT DELAYED DUE TO UNFORESEEN SITE/FIELD CONDITION,TIMES SQUARE,RENOVATION,cpd11-20cw.pdf
SANDCONDT,ELECTRICAL CONDUIT REPLACEMENT (SANDY),056,POLICE DEPARTMENT,POLICE FACILITIES,,CITYWIDE,PO-0079,30329,0,404,0,0,0,0,0,404,0,404,0,0,0,0,0,404,0,808,0,0,0,0,0,808,PROJECT DELAYED DUE TO CHANGES IN SCOPE/DESIGN,,ELECTRICAL,cpd11-20cw.pdf
F175BFMAC,Replacement of the exiting Roof Top Air Conditioning unit,057,FIRE DEPARTMENT,NEW FACILITIES AND RENOVATIONS,000,CITYWIDE,F-0175,0,0,220,0,0,0,0,0,220,0,220,0,0,0,0,0,220,0,440,0,0,0,0,0,440,,,REPLACEMENT OF THE EXITING ROOF TOP AIR CONDITIONING UNIT (RTU),cpd11-20cw.pdf
F175EMS20,EMS 20 EXPANSION AND RENOVATON,057,FIRE DEPARTMENT,NEW FACILITIES AND RENOVATIONS,000,CITYWIDE,F-0175,3000,8197,502,0,0,0,0,0,8699,8197,502,0,0,0,0,0,8699,16394,1004,0,0,0,0,0,17398,PROJECT DELAYED DUE TO BUDGETARY CONSTRAINTS,,EMS 20 EXPANSION AND RENOVATON,cpd11-20cw.pdf
F175EMS4M,MULTI COMPONENT RENOVATIONS - EMS 4,057,FIRE DEPARTMENT,NEW FACILITIES AND RENOVATIONS,000,CITYWIDE,F-0175,3576,523,0,3214,0,0,0,0,3737,523,0,3214,0,0,0,0,3737,1046,0,6428,0,0,0,0,7474,PROJECT DELAYED DUE TO BUDGETARY CONSTRAINTS,,MULTI COMPONENT RENOVATIONS - EMS 4,cpd11-20cw.pdf
F175MC153,MULTI COMPONENT RENOVATIONS - EC153,057,FIRE DEPARTMENT,NEW FACILITIES AND RENOVATIONS,000,CITYWIDE,F-0175,3070,1151,3,1844,0,0,0,0,2998,1151,3,1844,0,0,0,0,2998,2302,6,3688,0,0,0,0,5996,PROJECT DELAYED DUE TO BUDGETARY CONSTRAINTS,,MULTI COMPONENT RENOVATIONS - EC153,cpd11-20cw.pdf
F175MC253,MULTI COMPONENT RENOVATIONS - EC253,057,FIRE DEPARTMENT,NEW FACILITIES AND RENOVATIONS,000,CITYWIDE,F-0175,4471,8730,1575,0,0,0,0,0,10305,8730,1575,0,0,0,0,0,10305,17460,3150,0,0,0,0,0,20610,PROJECT DELAYED DUE TO BUDGETARY CONSTRAINTS,,MULTI COMPONENT RENOVATIONS - EC253,cpd11-20cw.pdf
F175TOI24,Female Firefighter Toilet Upgrade - EC24,057,FIRE DEPARTMENT,NEW FACILITIES AND RENOVATIONS,000,CITYWIDE,F-0175,1348,3701,328,0,0,0,0,0,4029,3701,328,0,0,0,0,0,4029,7402,656,0,0,0,0,0,8058,PROJECT DELAYED DUE TO BUDGETARY CONSTRAINTS,,FEMALE FIREFIGHTER TOILET UPGRADE - EC24,cpd11-20cw.pdf
F175WPE46,Roof and Waterproofing Project - EC46,057,FIRE DEPARTMENT,NEW FACILITIES AND RENOVATIONS,000,CITYWIDE,F-0175,1698,233,0,1504,0,0,0,0,1737,233,0,1504,0,0,0,0,1737,466,0,3008,0,0,0,0,3474,PROJECT DELAYED DUE TO BUDGETARY CONSTRAINTS,,ROOF AND WATERPROOFING PROJECT - EC46,cpd11-20cw.pdf
F175WU299,Cellar Reconstruction - EC299,057,FIRE DEPARTMENT,NEW FACILITIES AND RENOVATIONS,000,CITYWIDE,F-0175,994,157,0,163,700,0,0,0,1020,157,0,163,700,0,0,0,1020,314,0,326,1400,0,0,0,2040,,,WATER UTILITIES- EC299,cpd11-20cw.pdf
F1GAZ2001,Gazebo - Manholes Project at Engine Co. 323 in Brooklyn,057,FIRE DEPARTMENT,COMMUNICATIONS,000,CITYWIDE,F-0001,0,0,92,0,0,0,0,0,92,0,92,0,0,0,0,0,92,0,184,0,0,0,0,0,184,,,GAZEBO - MANHOLES PROJECT AT ENGINE CO. 323 IN BROOKLYN,cpd11-20cw.pdf
F1GAZ2002,Gazebo - Manholes Project at Ave. S & Haring St in Brooklyn,057,FIRE DEPARTMENT,COMMUNICATIONS,000,CITYWIDE,F-0001,92,0,92,0,0,0,0,0,92,0,92,0,0,0,0,0,92,0,184,0,0,0,0,0,184,,,GAZEBO - MANHOLES PROJECT AT AVE. S & HARING ST IN BROOKLYN,cpd11-20cw.pdf
F204-DEMO,FORT TOTEN DEMOLITION,057,FIRE DEPARTMENT,NEW FACILITIES AND RENOVATIONS,000,CITYWIDE,F-0204,600,1066,1912,0,0,0,0,0,2978,1066,1912,0,0,0,0,0,2978,2132,3824,0,0,0,0,0,5956,PROJECT DELAYED DUE TO BUDGETARY CONSTRAINTS,,FORT TOTEN DEMOLITION,cpd11-20cw.pdf
F204WATER,Randall's Island Water Tank Replacement,057,FIRE DEPARTMENT,NEW FACILITIES AND RENOVATIONS,000,CITYWIDE,F-0204,1395,193,6895,0,0,0,0,0,7088,193,6895,0,0,0,0,0,7088,386,13790,0,0,0,0,0,14176,PROJECT DELAYED DUE TO BUDGETARY CONSTRAINTS,,RANDALL'S ISLAND WATER TANK REPLACEMENT,cpd11-20cw.pdf
F212-COOL,Power and Cooling for Data Center 11 MetroTech,057,FIRE DEPARTMENT,ELECTRONICS AND DATA PROCESSING,000,CITYWIDE,F-0212,845,0,0,845,0,0,0,0,845,0,0,845,0,0,0,0,845,0,0,1690,0,0,0,0,1690,,,,cpd11-20cw.pdf
FD175G157,Generator - EC157,057,FIRE DEPARTMENT,NEW FACILITIES AND RENOVATIONS,000,CITYWIDE,F-D175,0,0,100,310,0,0,0,0,410,0,100,310,0,0,0,0,410,0,200,620,0,0,0,0,820,,,GENERATOR - EC157,cpd11-20cw.pdf
FD175G158,Generator - EC158,057,FIRE DEPARTMENT,NEW FACILITIES AND RENOVATIONS,000,CITYWIDE,F-D175,0,0,100,310,0,0,0,0,410,0,100,310,0,0,0,0,410,0,200,620,0,0,0,0,820,,,GENERATOR - EC158,cpd11-20cw.pdf
FD175WASH,"WASHERS, DRYER, DISHWASHER REPLACEMENTS IN FIRE HOUSES",057,FIRE DEPARTMENT,NEW FACILITIES AND RENOVATIONS,000,CITYWIDE,F-D175,0,0,75,0,0,0,0,0,75,0,75,0,0,0,0,0,75,0,150,0,0,0,0,0,150,,,"WASHERS, DRYER, DISHWASHER REPLACEMENTS IN FIRE HOUSES",cpd11-20cw.pdf
SANDHM265,HURRICANE SANDY HAZMAT MITIGATION-EC265,057,FIRE DEPARTMENT,NEW FACILITIES AND RENOVATIONS,000,CITYWIDE,F-0175,1216,20,0,173,0,0,0,0,193,20,0,173,0,0,0,0,193,40,0,346,0,0,0,0,386,PROJECT DELAYED PENDING NON-CITY GRANT APPROVAL,,HURRICANE SANDY HAZMAT MITIGATION-EC265,cpd11-20cw.pdf
SANDHM266,HURRICANE SANDY HAZMAT MITIGATION - EC266,057,FIRE DEPARTMENT,NEW FACILITIES AND RENOVATIONS,000,CITYWIDE,F-0175,946,10,0,85,0,0,0,0,95,10,0,85,0,0,0,0,95,20,0,170,0,0,0,0,190,PROJECT DELAYED PENDING NON-CITY GRANT APPROVAL,,HURRICANE SANDY HAZMAT MITIGATION - EC266,cpd11-20cw.pdf
ACSPDF,Renovation projects for field offices,068,ADMIN FOR CHILDREN'S SERVICES,SOCIAL SERVICE BUILDINGS,000,CITYWIDE,CS-0003,14821,0,303,0,0,1332,0,5149,6784,0,303,0,0,1332,0,5149,6784,0,606,0,0,2664,0,10298,13568,PROJECT DELAYED DUE TO CHANGES IN SCOPE/DESIGN,,RENOVATION PROJECTS FOR FIELD OFFICES,cpd11-20cw.pdf
HH-MRBU,MAJOR REPAIRS AND BLD UPGRADES,071,DEPT OF HOMELESS SERVICES,SHELTERS FOR HOMELESS INDIVIDUALS,000,CITYWIDE,HH-0112 HH-0115,0,0,9212,13779,11418,21372,26969,144508,227258,0,9212,13779,11418,21372,26969,144508,227258,0,18424,27558,22836,42744,53938,289016,454516,,,,cpd11-20cw.pdf
HRCN100VA,Volunteers of America,071,DEPT OF HOMELESS SERVICES,SHELTERS FOR HOMELESS FAMILIES,000,CITYWIDE,HH-D025,908,0,0,908,0,0,0,0,908,0,0,908,0,0,0,0,908,0,0,1816,0,0,0,0,1816,PROJECT DELAYED DUE TO BUDGETARY CONSTRAINTS,,IMPROVEMENTS TO VARIOUS DOMESTIC VIOLENCE SHELTERS. (CONSTRUCTION COSTS),cpd11-20cw.pdf
C114ACADY,Construction of a New Training Academy,072,DEPARTMENT OF CORRECTION,SUPPORT SPACE,000,CITYWIDE,C-0114,100600,0,0,0,10000,0,90000,0,100000,0,0,0,10000,0,90000,0,100000,0,0,0,20000,0,180000,0,200000,,,CONSTRUCTION OF NEW ACADEMY BUILDING,cpd11-20cw.pdf
C75GENREP,"Installation of Replacement Generators RNDC, EMTC,GMDC,RMSC",072,DEPARTMENT OF CORRECTION,EQUIPMENT,,CITYWIDE,C-0075,12540,705,0,0,0,0,0,10753,11458,705,0,0,0,0,0,10753,11458,1410,0,0,0,0,0,21506,22916,PROJECT DELAYED DUE TO BUDGETARY CONSTRAINTS,,,cpd11-20cw.pdf
C-75MISC,MISC INFRASTRUCTURE RECON,072,DEPARTMENT OF CORRECTION,BUILDING SYSTEMS AND INFRASTRUCTURE,000,CITYWIDE,C-0075,425881,480,0,57354,22095,34094,334810,137724,586557,480,0,57354,22095,34094,334810,137724,586557,960,0,114708,44190,68188,669620,275448,1173114,,CITYWIDE,MISCELLANIOUS ITEMSMISCELLANIOUS PROJECETS FOR C-75 BUDGET LINE,cpd11-20cw.pdf
C75POWRF,Replace 5 and 27 KV Feeders,072,DEPARTMENT OF CORRECTION,BUILDING SYSTEMS AND INFRASTRUCTURE,,CITYWIDE,C-0075,5950,397,0,12888,0,0,0,0,13285,397,0,12888,0,0,0,0,13285,794,0,25776,0,0,0,0,26570,PROJECT DELAYED DUE TO BUDGETARY CONSTRAINTS,,REPLACE 5 AND 27 KV ELECTRICAL POWER FEEDERS AT RI.,cpd11-20cw.pdf
HR25EFOY,HRA FACILITIES & EQUIPMENT OUTYEARS FOR UPGRADES,096,HUMAN RESOURCES ADMINISTRATION,SOCIAL SERVICES BUILDINGS,000,CITYWIDE,HR-0025,35921,0,0,0,0,31,2836,16938,19805,0,0,0,0,31,2836,16938,19805,0,0,0,0,62,5672,33876,39610,PROJECT DELAYED DUE TO CHANGES IN SCOPE/DESIGN,CITYWIDE,CITYWIDE FACILITIES AND EQUIPMENT UPGRADES IN OUT YEARS,cpd11-20cw.pdf
PV467-EMR,DCA - EMERGENCY CAPITAL FUND FOR DCA,126,DEPARTMENT OF CULTURAL AFFAIRS,ESSENTIAL RECONSTRUCTION OF FACILITIES,099,CITYWIDE,PV-0467,30478,0,214,1206,0,2864,11177,25940,41401,0,214,1206,0,2864,11177,25940,41401,0,428,2412,0,5728,22354,51880,82802,PROJECT DELAYED DUE TO CHANGES IN SCOPE/DESIGN,DEPARTMENT OF CULTURAL AFFAIRS/ALL CULTURAL INSTITUTIONS                             2 COLUMBUS CIRCLE,EMERGENCY CAPITAL FUNDS TO BE USED FOR EMERGENCY REPAIRS AT INSTITUTIOREMOVE,cpd11-20cw.pdf
ACQFUND,Acquistion Fund,801,DEPT OF SMALL BUSINESS SERVICES,NEIGHBORHOOD REVITALIZATION,000,CITYWIDE,ED-0075,68500,0,1000,0,0,0,0,51625,52625,0,1000,0,0,0,0,51625,52625,0,2000,0,0,0,0,103250,105250,PROJECT DELAYED DUE TO CHANGES IN SCOPE/DESIGN,,ACQUISITION FUND,cpd11-20cw.pdf
C5234,Pier 11 Intermodal Ferry,801,DEPT OF SMALL BUSINESS SERVICES,RECONSTRUCTION OF FERRY TERMINAL FACILITIES,000,CITYWIDE,FA-0027,19350,1223,43,0,0,0,0,0,1266,1223,43,0,0,0,0,0,1266,2446,86,0,0,0,0,0,2532,PROJECT DELAYED DUE TO CHANGES IN SCOPE/DESIGN,,,cpd11-20cw.pdf
C5234A,Pier 11 Intermodal Ferry,801,DEPT OF SMALL BUSINESS SERVICES,RECONSTRUCTION OF FERRY TERMINAL FACILITIES,000,CITYWIDE,FA-0027,600,508,0,92,0,0,0,0,600,508,0,92,0,0,0,0,600,1016,0,184,0,0,0,0,1200,PROJECT DELAYED DUE TO CHANGES IN SCOPE/DESIGN,"PIER 11, MANHATTAN","ADA RELATED WORK,PLUMBING",cpd11-20cw.pdf
CLEANYC,CleaNYC - Graffiti Free Trucks,801,DEPT OF SMALL BUSINESS SERVICES,MISCELLANEOUS,000,CITYWIDE,ED-0075,2500,1953,0,0,0,0,603,204,2760,1953,0,0,0,0,603,204,2760,3906,0,0,0,0,1206,408,5520,PROJECT DELAYED DUE TO CHANGES IN SCOPE/DESIGN,,CLEANYC - GRAFFITI FREE TRUCKS,cpd11-20cw.pdf
CWFSBARGE,New York City Ferry Barges,801,DEPT OF SMALL BUSINESS SERVICES,WATERFRONT DEVELOPMENT,000,CITYWIDE,ED-0409,55000,88130,43016,0,0,0,0,0,131146,88130,43016,0,0,0,0,0,131146,176260,86032,0,0,0,0,0,262292,,,CITYIWDE FERRY SERVICE BARGES,cpd11-20cw.pdf
CWFSFERRY,New York City Ferry - Ferry Purchase and Upgrade,801,DEPT OF SMALL BUSINESS SERVICES,WATERFRONT DEVELOPMENT,000,CITYWIDE,ED-0409,11600,6000,0,0,5600,0,0,0,11600,6000,0,0,5600,0,0,0,11600,12000,0,0,11200,0,0,0,23200,PROJECT DELAYED DUE TO CHANGES IN SCOPE/DESIGN,,CITYWIDE FERRY SERVICE FERRY PURCHASE (4),cpd11-20cw.pdf
FSHELTER,East River Ferry Service Passenger Shelters,801,DEPT OF SMALL BUSINESS SERVICES,MISCELLANEOUS,000,CITYWIDE,FA-D001 FA-0027,100,81,18,400,0,0,0,0,499,81,18,400,0,0,0,0,499,162,36,800,0,0,0,0,998,PROJECT DELAYED DUE TO CHANGES IN SCOPE/DESIGN,,WILLIAMSBURG FERRY SHELTERS,cpd11-20cw.pdf
IDF-SPOFF,Spofford Redevelopment,801,DEPT OF SMALL BUSINESS SERVICES,INDUSTRIAL DEVELOPMENT,,CITYWIDE,ED-0404,15000,0,15000,0,0,0,0,0,15000,0,15000,0,0,0,0,0,15000,0,30000,0,0,0,0,0,30000,,,SPOFFORD REDEVELOPMENT,cpd11-20cw.pdf
INDUSFUND,Industrial Fund,801,DEPT OF SMALL BUSINESS SERVICES,INDUSTRIAL DEVELOPMENT,000,CITYWIDE,ED-0404,41000,0,0,0,0,0,10200,1000,11200,0,0,0,0,0,10200,1000,11200,0,0,0,0,0,20400,2000,22400,PROJECT DELAYED DUE TO CHANGES IN SCOPE/DESIGN,,INDUSTRIAL FUND,cpd11-20cw.pdf
INFRAHOUS,Housing Fund,801,DEPT OF SMALL BUSINESS SERVICES,NEIGHBORHOOD REVITALIZATION,000,CITYWIDE,ED-0075,512172,0,0,0,0,25482,85871,195644,306997,0,0,0,0,25482,85871,195644,306997,0,0,0,0,50964,171742,391288,613994,PROJECT DELAYED DUE TO CHANGES IN SCOPE/DESIGN,,HOUSING FUND,cpd11-20cw.pdf
INFRANEIG,Neighborhood Fund,801,DEPT OF SMALL BUSINESS SERVICES,NEIGHBORHOOD REVITALIZATION,000,CITYWIDE,ED-0384,630821,0,0,0,0,0,0,144657,144657,0,0,0,0,0,0,144657,144657,0,0,0,0,0,0,289314,289314,PROJECT DELAYED DUE TO CHANGES IN SCOPE/DESIGN,,NEIGHBORHOOD FUND,cpd11-20cw.pdf
LOWMANHUD,East River Waterfront,801,DEPT OF SMALL BUSINESS SERVICES,COMMERCIAL DEVELOPMENT,000,CITYWIDE,ED-0075 SE-0002M HW-0001M WM-0001,137980,8695,2037,0,0,0,0,0,10732,8695,2037,0,0,0,0,0,10732,17390,4074,0,0,0,0,0,21464,PROJECT DELAYED DUE TO CHANGES IN SCOPE/DESIGN,,REDEVELOPMENT,cpd11-20cw.pdf
PASSSHIP2,Passenger Ship Terminal - Cruise Industry Develp.,801,DEPT OF SMALL BUSINESS SERVICES,PORT DEVELOPMENT,000,CITYWIDE,ED-0409,148871,194789,0,0,0,0,18,0,194807,194789,0,0,0,0,18,0,194807,389578,0,0,0,0,36,0,389614,PROJECT DELAYED DUE TO CHANGES IN SCOPE/DESIGN,MANHATTAN,DEVELOPMENT,cpd11-20cw.pdf
PFLANDING,Rehabilitation of Ferry Landings,801,DEPT OF SMALL BUSINESS SERVICES,RECONSTRUCTION OF FERRY TERMINAL FACILITIES,000,CITYWIDE,FA-0027,3600,2949,15,0,0,0,35,0,2999,2949,15,0,0,0,35,0,2999,5898,30,0,0,0,70,0,5998,PROJECT DELAYED DUE TO CHANGES IN SCOPE/DESIGN,,ADA REHAB,cpd11-20cw.pdf
PSG6-7,Port Security Grant Funds,801,DEPT OF SMALL BUSINESS SERVICES,MISCELLANEOUS,000,CITYWIDE,ED-0075,5469,0,0,0,0,0,0,0,0,0,0,0,0,0,0,0,0,0,0,0,0,0,0,0,0,PROJECT DELAYED DUE TO CHANGES IN SCOPE/DESIGN,,PORT SECURITY GRANT FUNDS ROUND 6 & 7,cpd11-20cw.pdf
RBWTRMAIN,Rockaway Boardwalk - Water Main Improvement,801,DEPT OF SMALL BUSINESS SERVICES,MISCELLANEOUS,,CITYWIDE,WM-0006,1390,1390,0,0,0,0,1390,0,2780,1390,0,0,0,0,1390,0,2780,2780,0,0,0,0,2780,0,5560,PROJECT DELAYED DUE TO CHANGES IN SCOPE/DESIGN,,ROCKAWAY BOARDWALK - WATER MAIN IMPROVEMENT,cpd11-20cw.pdf
RS-PH1,Raise Shoreline- Phase 1,801,DEPT OF SMALL BUSINESS SERVICES,MISCELLANEOUS ENERGY EFFICIENCY AND SUSTAINABILITY,000,CITYWIDE,PU-0100 HW-0001,17883,0,4941,21000,0,0,0,0,25941,0,4941,21000,0,0,0,0,25941,0,9882,42000,0,0,0,0,51882,PROJECT DELAYED DUE TO CHANGES IN SCOPE/DESIGN,,RAISE SHORELINE PHASE 1,cpd11-20cw.pdf
SAND000,Project Management for NYC Health + Hospitals Sandy Projects,801,DEPT OF SMALL BUSINESS SERVICES,MISCELLANEOUS,,CITYWIDE,HO-0214,57008,0,0,0,0,0,0,0,0,0,0,0,0,0,0,0,0,0,0,0,0,0,0,0,0,PROJECT DELAYED DUE TO CHANGES IN SCOPE/DESIGN,,H+H SANDY MITIGATION,cpd11-20cw.pdf
SANDEDCAM,EDC - Hurricane Sandy - Asset Management,801,DEPT OF SMALL BUSINESS SERVICES,MISCELLANEOUS,000,CITYWIDE,ED-0075,94081,0,0,0,11570,0,0,0,11570,0,0,0,11570,0,0,0,11570,0,0,0,23140,0,0,0,23140,PROJECT DELAYED DUE TO CHANGES IN SCOPE/DESIGN,,REPAIRS TO EDC-MANAGED CITY-OWNED PROPERTY CAUSED BY HURRICANE SANDY,cpd11-20cw.pdf
SANDY4-03,Sandy - Rockaway Beach,801,DEPT OF SMALL BUSINESS SERVICES,MISCELLANEOUS,000,CITYWIDE,P-1018,341379,2,0,0,0,0,0,0,2,2,0,0,0,0,0,0,2,4,0,0,0,0,0,0,4,PROJECT DELAYED DUE TO CHANGES IN SCOPE/DESIGN,,SANDY - ROCKAWAY BEACH,cpd11-20cw.pdf
TENANTIMP,Tenant Improvement Fund,801,DEPT OF SMALL BUSINESS SERVICES,INDUSTRIAL DEVELOPMENT,,CITYWIDE,ED-0380,7500,0,0,0,929,0,1481,4819,7229,0,0,0,929,0,1481,4819,7229,0,0,0,1858,0,2962,9638,14458,PROJECT DELAYED DUE TO CHANGES IN SCOPE/DESIGN,,TENANT IMPROVEMENT FUND - 100K JOBS PLAN,cpd11-20cw.pdf
HAM11IHWH,INSTANTANEOUS HOT WATER HEATERS,806,HOUSING PRESERVATION AND DEVEL,LOW TO MODERATE INCOME PUBLIC HOUSING UPGRADE,,CITYWIDE,HA-0001,25000,3953,25518,0,0,0,0,0,29471,3953,25518,0,0,0,0,0,29471,7906,51036,0,0,0,0,0,58942,PROJECT DELAYED DUE TO CHANGES IN SCOPE/DESIGN,,INSTALL INSTANTANEOUS HOT WATER HEATERS AT VARIOUS DEVELOPMENTS,cpd11-20cw.pdf
HAM13GCON,GENERAL CONSTRUCTION CITYWIDE,806,HOUSING PRESERVATION AND DEVEL,LOW TO MODERATE INCOME PUBLIC HOUSING REHAB/RECONSTRUCTION,000,CITYWIDE,HA-0001,4551,0,41598,10000,19700,10000,10000,20000,111298,0,41598,10000,19700,10000,10000,20000,111298,0,83196,20000,39400,20000,20000,40000,222596,PROJECT DELAYED DUE TO CHANGES IN SCOPE/DESIGN,,GENERAL CONSTRUCTION CITYWIDE,cpd11-20cw.pdf
HAM13VAEL,CITYWIDE ELEVATOR REPAIRS,806,HOUSING PRESERVATION AND DEVEL,LOW TO MODERATE INCOME PUBLIC HOUSING UPGRADE,000,CITYWIDE,HA-D001 HA-0001,10000,9871,1213,0,0,0,0,0,11084,9871,1213,0,0,0,0,0,11084,19742,2426,0,0,0,0,0,22168,PROJECT DELAYED DUE TO CHANGES IN SCOPE/DESIGN,,CITYWIDE REPAIRS,cpd11-20cw.pdf
HAM14VAUP,Major Renovations-Brickwork and Roofs at Sotomayer Houses,806,HOUSING PRESERVATION AND DEVEL,LOW TO MODERATE INCOME PUBLIC HOUSING UPGRADE,000,CITYWIDE,HA-0001 HA-D001,10000,27008,10963,0,0,0,0,0,37971,27008,10963,0,0,0,0,0,37971,54016,21926,0,0,0,0,0,75942,PROJECT DELAYED DUE TO CHANGES IN SCOPE/DESIGN,,OPERATIONS AND MAINTENANCE,cpd11-20cw.pdf
HAM15HMLS,HOMELESS INITIATIVE,806,HOUSING PRESERVATION AND DEVEL,LOW TO MODERATE INCOME PUBLIC HOUSING UPGRADE,000,CITYWIDE,HA-0001,16940,11913,8341,0,0,0,0,0,20254,11913,8341,0,0,0,0,0,20254,23826,16682,0,0,0,0,0,40508,PROJECT DELAYED DUE TO BUDGETARY CONSTRAINTS,,REHABILITATE 200 NYCHA UNITS,cpd11-20cw.pdf
HAM15SCVA,SECURITY ENHANCEMENTS AT VARIOUS LOCATIONS,806,HOUSING PRESERVATION AND DEVEL,LOW TO MODERATE INCOME PUBLIC HOUSING UPGRADE,,CITYWIDE,HA-D001,10000,7855,2145,0,0,0,0,0,10000,7855,2145,0,0,0,0,0,10000,15710,4290,0,0,0,0,0,20000,PROJECT DELAYED DUE TO BUDGETARY CONSTRAINTS,,SECURITY ENHANCEMENTS AT VARIOUS LOCATIONS,cpd11-20cw.pdf
HAM15SLVA,SECURITY INITIATIVES - LIGHTING AT VARIOUS DEVELOPMENTS,806,HOUSING PRESERVATION AND DEVEL,LOW TO MODERATE INCOME PUBLIC HOUSING UPGRADE,000,CITYWIDE,HA-0001,25000,44365,10161,0,0,0,0,0,54526,44365,10161,0,0,0,0,0,54526,88730,20322,0,0,0,0,0,109052,PROJECT DELAYED DUE TO CHANGES IN SCOPE/DESIGN,,EXTERIOR SITE LIGHTING UPGRADES AT VARIOUS DEVELOPMENTS,cpd11-20cw.pdf
HAM16FACD,BUILDING FACADES,806,HOUSING PRESERVATION AND DEVEL,LOW TO MODERATE INCOME PUBLIC HOUSING REHAB/RECONSTRUCTION,,CITYWIDE,HA-0001,75000,40025,77,0,0,0,0,0,40102,40025,77,0,0,0,0,0,40102,80050,154,0,0,0,0,0,80204,PROJECT DELAYED DUE TO BUDGETARY CONSTRAINTS,,BUILDING FACADE WORK AT VARIOUS DEVELOPMENTS,cpd11-20cw.pdf
HAM16MRVR,ROOF WORK TO PREVENT MOLD AT VARIOUS DEVELOPMENTS,806,HOUSING PRESERVATION AND DEVEL,LOW TO MODERATE INCOME PUBLIC HOUSING UPGRADE,,CITYWIDE,HA-0001,300000,442311,261689,111000,111000,111000,111000,223000,1371000,442311,261689,111000,111000,111000,111000,223000,1371000,884622,523378,222000,222000,222000,222000,446000,2742000,,,MOLD REMOVAL AT VARIOUS DEVELOPMENTS,cpd11-20cw.pdf
HAM18BOIL,MOBLE BOILERS AT VARIOUS NYCHA DEVELOPMENTS,806,HOUSING PRESERVATION AND DEVEL,LOW TO MODERATE INCOME PUBLIC HOUSING UPGRADE,,CITYWIDE,HA-0001,9300,1500,7800,0,0,0,0,0,9300,1500,7800,0,0,0,0,0,9300,3000,15600,0,0,0,0,0,18600,PROJECT DELAYED DUE TO CHANGES IN SCOPE/DESIGN,CITIWIDE,MOBLE BOILERS AT VARIOUS NYCHA DEVELOPMENTS CITIWIDE,cpd11-20cw.pdf
HAM18CDCP,BUILDING IMPROVEMENTS,806,HOUSING PRESERVATION AND DEVEL,LOW TO MODERATE INCOME PUBLIC HOUSING UPGRADE,,CITYWIDE,HA-0001,2200000,0,750000,250000,200000,200000,200000,600000,2200000,0,750000,250000,200000,200000,200000,600000,2200000,0,1500000,500000,400000,400000,400000,1200000,4400000,,,FUNDING FOR REHABILITATION AND CAPITAL REPAIRS TO NYCHA DEVELOPMENTS,cpd11-20cw.pdf
HAM18CSVA,CONCRETE SLABS AT VARIOUS DEVELOPMENTS,806,HOUSING PRESERVATION AND DEVEL,LOW TO MODERATE INCOME PUBLIC HOUSING UPGRADE,000,CITYWIDE,HA-0001,17941,12469,3841,0,0,0,0,0,16310,12469,3841,0,0,0,0,0,16310,24938,7682,0,0,0,0,0,32620,,,CONCRETE SLABS,cpd11-20cw.pdf
HAM18HEAT,HEATING SYSTEM IMPROVEMENTS AT NYCHA DEVELOPMENTS CITYWIDE,806,HOUSING PRESERVATION AND DEVEL,LOW TO MODERATE INCOME PUBLIC HOUSING UPGRADE,000,CITYWIDE,HA-0001,200000,155069,44093,0,0,0,0,0,199162,155069,44093,0,0,0,0,0,199162,310138,88186,0,0,0,0,0,398324,,,HEATING SYSTEM IMPROVEMENTS AT NYCHA DEVELOPMENTS CITYWIDE,cpd11-20cw.pdf
HAM18IHWH,INSTANTANEOUS HOT WATER HEATERS,806,HOUSING PRESERVATION AND DEVEL,LOW TO MODERATE INCOME PUBLIC HOUSING UPGRADE,000,CITYWIDE,HA-0001,7642,0,7642,0,0,0,0,0,7642,0,7642,0,0,0,0,0,7642,0,15284,0,0,0,0,0,15284,,,INSTALL INSTANTANEOUS HOT WATER HEATERS,cpd11-20cw.pdf
HAM18PNAP,Gas Risers,806,HOUSING PRESERVATION AND DEVEL,LOW TO MODERATE INCOME PUBLIC HOUSING UPGRADE,,CITYWIDE,HA-0001,9558,0,8689,0,0,0,0,0,8689,0,8689,0,0,0,0,0,8689,0,17378,0,0,0,0,0,17378,,,GAS RISERS,cpd11-20cw.pdf
HAM18RAEX,EXTERNAL COMPACTORS-BULK CRUSHERS,806,HOUSING PRESERVATION AND DEVEL,LOW TO MODERATE INCOME PUBLIC HOUSING UPGRADE,,CITYWIDE,HA-0001,10982,6220,3830,0,0,0,0,0,10050,6220,3830,0,0,0,0,0,10050,12440,7660,0,0,0,0,0,20100,,,INSTALL EXTERNAL COMPACTORS AND BULK CRUSHERS,cpd11-20cw.pdf
HAM18RSPL,"Citywide Gas Risers, Steam Distribution, Condensate Lines",806,HOUSING PRESERVATION AND DEVEL,LOW TO MODERATE INCOME PUBLIC HOUSING UPGRADE,000,CITYWIDE,HA-0001,73533,6001,67532,0,0,0,0,0,73533,6001,67532,0,0,0,0,0,73533,12002,135064,0,0,0,0,0,147066,,,"GAS RISERS, STEAM DISTRIBUTION, CONDENSATE LINES, CITYWIDE",cpd11-20cw.pdf
HAM19DGV2,DIGITAL VAN,806,HOUSING PRESERVATION AND DEVEL,LOW TO MODERATE INCOME PUBLIC HOUSING UPGRADE,000,CITYWIDE,HA-M001,160,0,160,0,0,0,0,0,160,0,160,0,0,0,0,0,160,0,320,0,0,0,0,0,320,,,FUNDING FOR DIGITAL VAN,cpd11-20cw.pdf
HAM19MOCJ,Installation of LED Exterior Lighting Citywide,806,HOUSING PRESERVATION AND DEVEL,LOW TO MODERATE INCOME PUBLIC HOUSING UPGRADE,000,CITYWIDE,HA-0001,12478,0,12478,0,0,0,0,0,12478,0,12478,0,0,0,0,0,12478,0,24956,0,0,0,0,0,24956,,,"AS PART OF THE MAYOR'S ACTION PLAN FOR NEIGHBORHOOD SAFETY, NYCHA IS REPLACING",cpd11-20cw.pdf
HAM20DMSC,SENIOR CENTER RENOVATION- DYCKMAN AND MARBLE HILL,806,HOUSING PRESERVATION AND DEVEL,LOW TO MODERATE INCOME PUBLIC HOUSING UPGRADE,000,CITYWIDE,HA-D001,2000,0,2000,0,0,0,0,0,2000,0,2000,0,0,0,0,0,2000,0,4000,0,0,0,0,0,4000,,,NYCHA - RENOVATION OF DYCKMAN HOUSE AND MARBLE HILL SENIOR CENTERS --CONSTRUCTION OR,cpd11-20cw.pdf
HAM20ECFL,ELLIOTT CHELSEA AND FULTON LIGHTING FOR PARKS,806,HOUSING PRESERVATION AND DEVEL,LOW TO MODERATE INCOME PUBLIC HOUSING UPGRADE,000,CITYWIDE,HA-D001,600,0,600,0,0,0,0,0,600,0,600,0,0,0,0,0,600,0,1200,0,0,0,0,0,1200,,,IMPROVED LIGHTING FOR NYCHA PARKS -- LIGHTING IN THE PARK AREAS OF ELLIOT-CHELSEA AND,cpd11-20cw.pdf
HAM20QWGR,BEAUTIFICATION OF QUEENSBRIDGE HOUSES AND WOODSIDE HOUSES,806,HOUSING PRESERVATION AND DEVEL,LOW TO MODERATE INCOME PUBLIC HOUSING UPGRADE,000,CITYWIDE,HA-D001,600,0,600,0,0,0,0,0,600,0,600,0,0,0,0,0,600,0,1200,0,0,0,0,0,1200,PROJECT DELAYED DUE TO CHANGES IN SCOPE/DESIGN,,BEAUTIFICATION OF QUEENSBRIDGE HOUSES AND WOODSIDE HOUSES -- FUNDING FOR ADDITIONAL,cpd11-20cw.pdf
HAM20SCD8,SECURITY CAMERAS AT NYCHA FACILITY IN DISTRICT 8,806,HOUSING PRESERVATION AND DEVEL,LOW TO MODERATE INCOME PUBLIC HOUSING UPGRADE,000,CITYWIDE,HA-D001,0,0,250,0,0,0,0,0,250,0,250,0,0,0,0,0,250,0,500,0,0,0,0,0,500,,,NYCHA SECURITY CAMERAS -- SECURITY CAMERAS AT A NYCHA FACILITY IN DISTRICT 8.,cpd11-20cw.pdf
HAM20WMEX,WASTE MANAGEMENT EXTERIOR COMPACTORS,806,HOUSING PRESERVATION AND DEVEL,LOW TO MODERATE INCOME PUBLIC HOUSING UPGRADE,000,CITYWIDE,HA-D001 HA-0001,1303,0,1303,0,0,0,0,0,1303,0,1303,0,0,0,0,0,1303,0,2606,0,0,0,0,0,2606,,,WASTE MANAGEMENT SYSTEM -- NYCHA WASTE MANAGEMENT SYSTEM THAT INCLUDELARGE,cpd11-20cw.pdf
HAM21BASK,RENOVATION OF ONE OUTDOOR BASKETBALL,806,HOUSING PRESERVATION AND DEVEL,LOW TO MODERATE INCOME PUBLIC HOUSING UPGRADE,000,CITYWIDE,HA-D001,0,0,0,320,0,0,0,0,320,0,0,320,0,0,0,0,320,0,0,640,0,0,0,0,640,,,PB,cpd11-20cw.pdf
HAM21COMM,NYCHA COMMUNITY CENTERS NYCHA COMMUNITY CENTERS,806,HOUSING PRESERVATION AND DEVEL,LOW TO MODERATE INCOME PUBLIC HOUSING UPGRADE,000,CITYWIDE,HA-0001,0,0,940,0,0,0,0,0,940,0,940,0,0,0,0,0,940,0,1880,0,0,0,0,0,1880,,,NYCHA COMMUNITY CENTERS,cpd11-20cw.pdf
HAM21EXTL,NYCHA EXTERIOR LIGHTING UPGRADES,806,HOUSING PRESERVATION AND DEVEL,LOW TO MODERATE INCOME PUBLIC HOUSING UPGRADE,000,CITYWIDE,HA-D001,0,0,300,0,0,0,0,0,300,0,300,0,0,0,0,0,300,0,600,0,0,0,0,0,600,,,PB,cpd11-20cw.pdf
HAM21RPTB,20 RAT PROOF TRASH BINS-20 RAT PROOF TRASH,806,HOUSING PRESERVATION AND DEVEL,LOW TO MODERATE INCOME PUBLIC HOUSING UPGRADE,000,CITYWIDE,HA-D001,0,0,52,0,0,0,0,0,52,0,52,0,0,0,0,0,52,0,104,0,0,0,0,0,104,,,20 RAT PROOF TRASH BINS-20 RAT PROOF TRASH,cpd11-20cw.pdf
HAM21SCD8,NYCHA - SECURITY CAMERAS- DISTRICT 8,806,HOUSING PRESERVATION AND DEVEL,LOW TO MODERATE INCOME PUBLIC HOUSING UPGRADE,000,CITYWIDE,HA-D001,0,0,50,0,0,0,0,0,50,0,50,0,0,0,0,0,50,0,100,0,0,0,0,0,100,,,NYCHA - SECURITY CAMERAS - DISTRICT 8-SECURITY CAMERAS IN DISTRICT 8,cpd11-20cw.pdf
HAM21UWMS,UPGRADED WASTE MANAGEMENT SYSTEM FOR NYCHA PROJECT,806,HOUSING PRESERVATION AND DEVEL,LOW TO MODERATE INCOME PUBLIC HOUSING UPGRADE,000,CITYWIDE,HA-D001,0,0,362,0,0,0,0,0,362,0,362,0,0,0,0,0,362,0,724,0,0,0,0,0,724,,,PB,cpd11-20cw.pdf
HAM22EMAR,EAST NY CENTER- FUNDING FOR TECH UPGRADES,806,HOUSING PRESERVATION AND DEVEL,LOW TO MODERATE INCOME PUBLIC HOUSING UPGRADE,000,CITYWIDE,HA-D001,0,0,0,1000,0,0,0,0,1000,0,0,1000,0,0,0,0,1000,0,0,2000,0,0,0,0,2000,,,EAST NEW YORK CENTER FOR MEDIA ARTS COMMUNICATIONS & TECHNOLOGY--FUNDING FOR,cpd11-20cw.pdf
HAM22ML31,PS31 SAMUEL F. DUPONT MEDIA LAB,806,HOUSING PRESERVATION AND DEVEL,LOW TO MODERATE INCOME PUBLIC HOUSING UPGRADE,000,CITYWIDE,HA-D001,0,0,0,60,0,0,0,0,60,0,0,60,0,0,0,0,60,0,0,120,0,0,0,0,120,,,PB,cpd11-20cw.pdf
HAM22P107,PS 107X-PLAYGROUND RENOVATIONS,806,HOUSING PRESERVATION AND DEVEL,LOW TO MODERATE INCOME PUBLIC HOUSING UPGRADE,000,CITYWIDE,HA-D001,0,0,0,700,0,0,0,0,700,0,0,700,0,0,0,0,700,0,0,1400,0,0,0,0,1400,,,PS 107X - PLAYGROUND RENOVATIONS-ÝBLD,cpd11-20cw.pdf
HAM22SBNC,"SOUTHEAST BRONX NEIGHBORHOOD CENTERS, INC. REPAIRS",806,HOUSING PRESERVATION AND DEVEL,LOW TO MODERATE INCOME PUBLIC HOUSING UPGRADE,000,CITYWIDE,HA-D001,0,0,0,70,0,0,0,0,70,0,0,70,0,0,0,0,70,0,0,140,0,0,0,0,140,,,"SOUTHEAST BRONX NEIGHBORHOOD CENTERS, INC.",cpd11-20cw.pdf
CMESECURE,OCME - Agencywide Physical Security System Upgrades,816,DEPARTMENT OF HEALTH AND MENTAL HYGIENE,OCME,000,CITYWIDE,HL-0083,19842,0,0,2010,8722,999,8111,0,19842,0,0,2010,8722,999,8111,0,19842,0,0,4020,17444,1998,16222,0,39684,,,,cpd11-20cw.pdf
HL82VCLIN,EMERGENCY FUNDING FOR VARIOUS CLINICS,816,DEPARTMENT OF HEALTH AND MENTAL HYGIENE,CLINIC RENOVATION AND REHABILITATION,000,CITYWIDE,HL-0082,41723,4560,0,0,0,260,0,22408,27228,4560,0,0,0,260,0,22408,27228,9120,0,0,0,520,0,44816,54456,,,RENOVATE VARIOUS HEALTH CENTERS,cpd11-20cw.pdf
02201601,HHC PRIMARY HEALTH CLINICS,819,HEALTH AND HOSPITALS CORP,ROUTINE RECONSTRUCTION,,CITYWIDE,HO-0214,104661,0,0,0,25718,0,0,0,25718,0,0,0,25718,0,0,0,25718,0,0,0,51436,0,0,0,51436,,,EXPAND CAPACITY IN EXISTING CLINICS AND BUILD NEW CLINICS IN UNDERSERVED AREAS.,cpd11-20cw.pdf
02201602,UPGRADE IDF AND MDF ROOMS (LAN ENVIRONMENTALS),819,HEALTH AND HOSPITALS CORP,ROUTINE RECONSTRUCTION,,CITYWIDE,HO-0214,8768,15216,0,0,9858,0,0,0,25074,15216,0,0,9858,0,0,0,25074,30432,0,0,19716,0,0,0,50148,PROJECT DELAYED DUE TO CHANGES IN SCOPE/DESIGN,CORPORATE-WIDE,"THIS IS A CENTRAL OFFICE INITIATIVE MANAGED BY THE OFFICE OF FACILITIES DEVELOPMENT,",cpd11-20cw.pdf
02202101,SYSTEM WIDE ELEVATOR DOOR LOCK MONITORING,819,HEALTH AND HOSPITALS CORP,ROUTINE RECONSTRUCTION,,CITYWIDE,HO-0214,3554,0,3554,0,0,0,0,0,3554,0,3554,0,0,0,0,0,3554,0,7108,0,0,0,0,0,7108,,CORPORATE-WIDE,INSTAL ELEVATOR DOOR LOCKS,cpd11-20cw.pdf
022021PM,PM/CM Services,819,HEALTH AND HOSPITALS CORP,ROUTINE RECONSTRUCTION,,CITYWIDE,HO-0214,5000,0,5000,0,0,0,0,0,5000,0,5000,0,0,0,0,0,5000,0,10000,0,0,0,0,0,10000,,,"PM/CM SERVIICES, SYSTEMWIDE",cpd11-20cw.pdf
72201602,CORRECTIONAL HEALTH,819,HEALTH AND HOSPITALS CORP,ROUTINE RECONSTRUCTION,,CITYWIDE,HO-0214,1200,0,0,0,1200,0,0,0,1200,0,0,0,1200,0,0,0,1200,0,0,0,2400,0,0,0,2400,,TBD,CORRECTIONAL HEALTH,cpd11-20cw.pdf
HL82DISHC,DISTRICT HEALTH CENTER,819,HEALTH AND HOSPITALS CORP,CLINIC RENOVATION AND REHABILITATION,,CITYWIDE,HL-0082,1600,1045,555,0,0,0,0,0,1600,1045,555,0,0,0,0,0,1600,2090,1110,0,0,0,0,0,3200,,,DISTRICT HEALTH CENTER RENOVATION,cpd11-20cw.pdf
ACEDEP504,HVAC Upgrades at Grahamsville WWTP,826,DEPT ENVIRONMENTAL PROTECTION,"BUILDING CONSTRUCTION, RECONSTRUCTION OR RETROFIT",,CITYWIDE,PU-0025,470,0,0,451,0,0,0,0,451,0,0,451,0,0,0,0,451,0,0,902,0,0,0,0,902,PROJECT DELAYED DUE TO CHANGES IN SCOPE/DESIGN,,UPSTATE,cpd11-20cw.pdf
ACEDEP505,HVAC Upgrades at Margaretville WWTP,826,DEPT ENVIRONMENTAL PROTECTION,"BUILDING CONSTRUCTION, RECONSTRUCTION OR RETROFIT",,CITYWIDE,PU-0025,730,0,0,701,0,0,0,0,701,0,0,701,0,0,0,0,701,0,0,1402,0,0,0,0,1402,PROJECT DELAYED DUE TO CHANGES IN SCOPE/DESIGN,,SQ FT,cpd11-20cw.pdf
ACEDEP701,DEP- DEMAND CONTROLLED VENTILATION UPGRADE,826,DEPT ENVIRONMENTAL PROTECTION,"BUILDING CONSTRUCTION, RECONSTRUCTION OR RETROFIT",000,CITYWIDE,PU-0025,248,0,0,248,0,0,0,0,248,0,0,248,0,0,0,0,248,0,0,496,0,0,0,0,496,,,DEP- DEMAND CONTROLLED VENTILATION UPGRADE,cpd11-20cw.pdf
AGRI-18,FAD 18-22 WAP AND FORESTRY,826,DEPT ENVIRONMENTAL PROTECTION,FILTRATION AVOIDANCE DETERMINATION,000,CITYWIDE,WM-0030,61750,40764,0,0,0,20000,0,0,60764,40764,0,0,0,20000,0,0,60764,81528,0,0,0,40000,0,0,121528,,,FAD 18-22 WAP AND FORESTRY,cpd11-20cw.pdf
AIR-MON1,Air Monitoring Analysis,826,DEPT ENVIRONMENTAL PROTECTION,FACILITY PURCHASES AND RECONSTRUCTION,,CITYWIDE,EP-0006,1500,0,1500,0,0,0,0,0,1500,0,1500,0,0,0,0,0,1500,0,3000,0,0,0,0,0,3000,,,AIR MONITORING ANALYSIS,cpd11-20cw.pdf
AIR-MON2,Air Monitoring Analysis,826,DEPT ENVIRONMENTAL PROTECTION,FACILITY PURCHASES AND RECONSTRUCTION,,CITYWIDE,EP-0006,1500,0,0,0,1500,0,0,0,1500,0,0,0,1500,0,0,0,1500,0,0,0,3000,0,0,0,3000,,,AIR MONITORING ANALYSIS,cpd11-20cw.pdf
ASB-REM,Asbestos Removal,826,DEPT ENVIRONMENTAL PROTECTION,FACILITY PURCHASES AND RECONSTRUCTION,,CITYWIDE,EP-0006,7900,1577,4175,0,1210,0,0,0,6962,1577,4175,0,1210,0,0,0,6962,3154,8350,0,2420,0,0,0,13924,PROJECT DELAYED DUE TO CHANGES IN SCOPE/DESIGN,,ASBESTOS REMOVAL,cpd11-20cw.pdf
AWT2-CARB,CONSTRUCTION OF CARBON ADDITION FACILITY AT VARIOUS WWTPs,826,DEPT ENVIRONMENTAL PROTECTION,BIOLOGICAL NUTRIENT REMOVAL,,CITYWIDE,WP-0285,123537,101942,812,0,0,0,0,0,102754,101942,812,0,0,0,0,0,102754,203884,1624,0,0,0,0,0,205508,PROJECT DELAYED DUE TO BUDGETARY CONSTRAINTS,,THIS PROJECT IS DESIGNED TO PROVIDE SUPPLEMENTAL CARBON ADDITION SYSTEMS TO ENHANCE,cpd11-20cw.pdf
C519,MODIFICATION OF CHAMBERS AT HILLVIEW,826,DEPT ENVIRONMENTAL PROTECTION,"CITY TUNNEL NO. 3, STAGE 1",000,CITYWIDE,W-0010,198184,83705,5503,0,0,200000,0,137300,426508,83705,5503,0,0,200000,0,137300,426508,167410,11006,0,0,400000,0,274600,853016,PROJECT DELAYED DUE TO BUDGETARY CONSTRAINTS,VALVE CHAMBERS AT HILL VIEW RESERVOIR (UPSTATE),MODIFICATION OF CHAMBERS AT HILL VIEW RES IN CONNECTION WITH THE CONSTOF CITY TUNNEL NO,cpd11-20cw.pdf
C529,HILLVIEW CHLORINATION BLDG,826,DEPT ENVIRONMENTAL PROTECTION,"CITY TUNNEL NO. 3, STAGE 1",000,CITYWIDE,W-0010,67641,21709,100,0,0,0,0,0,21809,21709,100,0,0,0,0,0,21809,43418,200,0,0,0,0,0,43618,PROJECT DELAYED DUE TO CHANGES IN SCOPE/DESIGN,NEW CHLORINATION BUILDING @ HILLVIEW RESERVOIR (UPSTATE),"CONSTRUCTION OF THE HILL VIEW CHLORINATION BUILDING FOR CITY TUNNEL NOSTAGE 1,",cpd11-20cw.pdf
CAN-HYDRO,Development of Hydroelectric Cannonsville Dam. incl P'wrhse,826,DEPT ENVIRONMENTAL PROTECTION,WATER QUALITY PRESERVATION,000,CITYWIDE,WM-0030,138000,0,0,0,0,0,8000,0,8000,0,0,0,0,0,8000,0,8000,0,0,0,0,0,16000,0,16000,PROJECT DELAYED DUE TO BUDGETARY CONSTRAINTS,,DEVELOPMENT OF HYDROELECTRIC CANNONSVILLE DAM. INCL P'WRHSE,cpd11-20cw.pdf
CAT-186,RESURFACING SCHOHARIE ROADS WEST AND BEARKILL BRIDGE,826,DEPT ENVIRONMENTAL PROTECTION,DAM SAFETY PROGRAM,000,CITYWIDE,WM-0030,7875,9888,93,0,0,0,0,0,9981,9888,93,0,0,0,0,0,9981,19776,186,0,0,0,0,0,19962,PROJECT DELAYED DUE TO CHANGES IN SCOPE/DESIGN,UPSTATE,RESURFACING SCHOHARIE ROADS WEST AND BEARKILL BRIDGE,cpd11-20cw.pdf
CAT-210,CAT/DEL UV LIGHT TREATMENT FACILITIES,826,DEPT ENVIRONMENTAL PROTECTION,WATER QUALITY PRESERVATION,000,CITYWIDE,WM-0030,904233,1570100,1906,0,0,0,0,0,1572006,1570100,1906,0,0,0,0,0,1572006,3140200,3812,0,0,0,0,0,3144012,PROJECT DELAYED DUE TO CHANGES IN SCOPE/DESIGN,CATSKILL & DELAWARE RESERVIORS,CATSKILL & DELAWARE ULTRAVIOLET LIGHT TREATMENT FACILITIES,cpd11-20cw.pdf
CAT-212,SCHOHARIE RESERVOIR/GILBOA DAM AND INTAKE/OUTLET CHAMBER,826,DEPT ENVIRONMENTAL PROTECTION,DAM SAFETY PROGRAM,000,CITYWIDE,WM-0030,390807,444480,-8263,432,0,31000,0,0,467649,444480,-8263,432,0,31000,0,0,467649,888960,-16526,864,0,62000,0,0,935298,PROJECT DELAYED DUE TO BUDGETARY CONSTRAINTS,SCHOLARIE RESERVIOR/GILBOA DAM,SCHOLARIE RESERVIOR/GILBOA DAM AND INTAKE/OUTLET CHAMBER,cpd11-20cw.pdf
CAT-213,ASHOKAN RESERVOIR/OLIVE BRIDGE DAM & UPPER/LOWER OUTLET& SCR,826,DEPT ENVIRONMENTAL PROTECTION,DAM SAFETY PROGRAM,000,CITYWIDE,WM-0030,110000,121927,14240,0,26000,133000,14400,586600,896167,121927,14240,0,26000,133000,14400,586600,896167,243854,28480,0,52000,266000,28800,1173200,1792334,PROJECT DELAYED DUE TO CHANGES IN SCOPE/DESIGN,UPSTATE,ASHOKAN RESERVIOR/OLIVE BRIDGE DAM & UPPER/LOWER OUTLET& SCREEN CHAMBERS,cpd11-20cw.pdf
CAT-252,REPLACEMENT OF ESOPUS AND ROUTE 28A RAILROAD BRIDGES,826,DEPT ENVIRONMENTAL PROTECTION,DAM SAFETY PROGRAM,000,CITYWIDE,WM-0030,60000,16092,65055,0,0,0,0,0,81147,16092,65055,0,0,0,0,0,81147,32184,130110,0,0,0,0,0,162294,PROJECT DELAYED PENDING RELEASE OF NEW TECHNOLOGY,REPLACEMENT OF ESOPUS AND ROUTE 28A RAILROAD BRIDGES,REPLACEMENT OF ESOPUS AND ROUTE 28A RAILROAD BRIDGES,cpd11-20cw.pdf
CAT-379,"Bureau of Police & Security Academy Renovation, Kingston",826,DEPT ENVIRONMENTAL PROTECTION,WATER QUALITY PRESERVATION,000,CITYWIDE,WM-0030,5000,0,4700,0,2300,23000,0,0,30000,0,4700,0,2300,23000,0,0,30000,0,9400,0,4600,46000,0,0,60000,,,KINGSTON FACILITY UPGRADES & REPAIRS,cpd11-20cw.pdf
CAT-390,Schoharie Reservoir road improvement- NYS Rt. 990V,826,DEPT ENVIRONMENTAL PROTECTION,WATER QUALITY PRESERVATION,000,CITYWIDE,WM-0030,585,584,0,0,1100,0,4325,0,6009,584,0,0,1100,0,4325,0,6009,1168,0,0,2200,0,8650,0,12018,PROJECT DELAYED DUE TO BUDGETARY CONSTRAINTS,,SCHOHARIE RESERVOIR ROAD IMPROVEMENT- NYS RT. 990V,cpd11-20cw.pdf
CAT-392,Energy Conservation Measures Improvement at Four WWTPs,826,DEPT ENVIRONMENTAL PROTECTION,WATER QUALITY PRESERVATION,000,CITYWIDE,WM-0030,10000,15091,87,0,0,0,0,0,15178,15091,87,0,0,0,0,0,15178,30182,174,0,0,0,0,0,30356,PROJECT DELAYED DUE TO BUDGETARY CONSTRAINTS,,ENERGY CONSERVATION MEASURES IMPROVEMENT AT GRAND GORGE AND TANNERSVILLE WWTPS,cpd11-20cw.pdf
CAT-399,CA Hudson River Drainage Chamber,826,DEPT ENVIRONMENTAL PROTECTION,WATER QUALITY PRESERVATION,000,CITYWIDE,WM-0030,2000,4710,4947,0,0,25000,0,0,34657,4710,4947,0,0,25000,0,0,34657,9420,9894,0,0,50000,0,0,69314,PROJECT DELAYED DUE TO BUDGETARY CONSTRAINTS,,CA HUDSON RIVE DRAINAGE CHAMBER,cpd11-20cw.pdf
CAT-431,CATSKILL AQUEDUCT RECONST.-KENSICO TO HILVIEW,826,DEPT ENVIRONMENTAL PROTECTION,WATER QUALITY PRESERVATION,000,CITYWIDE,WM-0030,59032,28509,0,0,70000,0,0,55000,153509,28509,0,0,70000,0,0,55000,153509,57018,0,0,140000,0,0,110000,307018,PROJECT DELAYED DUE TO BUDGETARY CONSTRAINTS,,CATSKILL AQUEDUCT RECONST.-KENSICO TO HILVIEW,cpd11-20cw.pdf
CAT-452,WOH Catskill Acqueduct Chambers Rehab & Restoration,826,DEPT ENVIRONMENTAL PROTECTION,WATER QUALITY PRESERVATION,000,CITYWIDE,WM-0030,9600,0,0,3184,0,1990,19900,0,25074,0,0,3184,0,1990,19900,0,25074,0,0,6368,0,3980,39800,0,50148,,,WOH CATSKILL ACQUEDUCT CHAMBERS REHABILITATION & RESTORATION,cpd11-20cw.pdf
CAT-454,RECONSTRUCTION GRAND GORGE WWTP,826,DEPT ENVIRONMENTAL PROTECTION,MISCELLANEOUS IMPROVEMENTS UPSTATE,,CITYWIDE,WM-0030,1700,0,0,0,0,1700,0,0,1700,0,0,0,0,1700,0,0,1700,0,0,0,0,3400,0,0,3400,PROJECT DELAYED DUE TO CHANGES IN SCOPE/DESIGN,,RECONSTRUCTION GRAND GORDE WWTP,cpd11-20cw.pdf
CAT-455,RECONSTRUCTION TANNERSVILLE WWTP,826,DEPT ENVIRONMENTAL PROTECTION,MISCELLANEOUS IMPROVEMENTS UPSTATE,,CITYWIDE,WM-0030,1700,0,0,0,0,1700,0,0,1700,0,0,0,0,1700,0,0,1700,0,0,0,0,3400,0,0,3400,,,PINE HILL MUNICIPAL WATER LINE EXTENSION,cpd11-20cw.pdf
CAT-475,GILBOA HLO,826,DEPT ENVIRONMENTAL PROTECTION,WATER QUALITY PRESERVATION,000,CITYWIDE,WM-0030,14500,0,0,2358,3800,0,0,11000,17158,0,0,2358,3800,0,0,11000,17158,0,0,4716,7600,0,0,22000,34316,,,GILBOA HLO,cpd11-20cw.pdf
CAT-477,Catskill Acqueduct Pressure Tunnels,826,DEPT ENVIRONMENTAL PROTECTION,WATER QUALITY PRESERVATION,000,CITYWIDE,WM-0030,217389,6819,0,12600,8800,0,8000,140000,176219,6819,0,12600,8800,0,8000,140000,176219,13638,0,25200,17600,0,16000,280000,352438,,,TUNNEL WORK,cpd11-20cw.pdf
CAT-508,DR-30 Culvert Repair & Embankment Stabilization,826,DEPT ENVIRONMENTAL PROTECTION,WATER QUALITY PRESERVATION,000,CITYWIDE,WM-0030,5020,0,0,620,400,7000,0,0,8020,0,0,620,400,7000,0,0,8020,0,0,1240,800,14000,0,0,16040,,,DR-30 CULVERT REPAIR & EMBANKMENT STABILIZATION,cpd11-20cw.pdf
CAT-511,Grand Gorge and Tannersville WWTP Collection System Repairs,826,DEPT ENVIRONMENTAL PROTECTION,WATER QUALITY PRESERVATION,000,CITYWIDE,WM-0030,10000,0,0,1400,800,7800,0,0,10000,0,0,1400,800,7800,0,0,10000,0,0,2800,1600,15600,0,0,20000,,,GRAND GORGE AND TANNERSVILLE WWTP COLLECTION SYSTEM REPAIRS,cpd11-20cw.pdf
CAT-OPTIM,To Increase the Capacity of Upper Catskill Aqueduct,826,DEPT ENVIRONMENTAL PROTECTION,WATER FOR THE FUTURE,000,CITYWIDE,W-0005,139000,234083,16267,0,0,0,0,0,250350,234083,16267,0,0,0,0,0,250350,468166,32534,0,0,0,0,0,500700,PROJECT DELAYED DUE TO BUDGETARY CONSTRAINTS,THE PROJECT INVOLVES IMPROVEMENTS TO INCREASE THE CAPACITY OF UPPER CATSKILL,THE PROJECT INVOLVES IMPROVEMENTS TO INCREASE THE CAPACITY OF UPPER CATSKILL,cpd11-20cw.pdf
CRO-208B,NEW CROTON DAM RECONSTRUCTION,826,DEPT ENVIRONMENTAL PROTECTION,WATER QUALITY PRESERVATION,000,CITYWIDE,WM-0030,17000,12384,500,0,15000,0,120000,0,147884,12384,500,0,15000,0,120000,0,147884,24768,1000,0,30000,0,240000,0,295768,PROJECT DELAYED DUE TO BUDGETARY CONSTRAINTS,,NEW CROTON DAM RECONSTRUCTION,cpd11-20cw.pdf
CRO-357,"INSTALLATION OF A TELEMETRY SYSTEM, EAST-OF-HUDSON DISTRICT",826,DEPT ENVIRONMENTAL PROTECTION,WATER QUALITY PRESERVATION,000,CITYWIDE,WM-0030,3800,10783,751,0,0,0,0,0,11534,10783,751,0,0,0,0,0,11534,21566,1502,0,0,0,0,0,23068,,"WESTCHESTER COUNTY, NY",INSTALLATION OF A TELEMTRY SYSTEM TO MONITOR THE WATER SUPPLY SYSTEM IN THE,cpd11-20cw.pdf
CRO-366,"REPLACE DOORS, EAST-OF-HUDSON DISTRICT",826,DEPT ENVIRONMENTAL PROTECTION,WATER QUALITY PRESERVATION,000,CITYWIDE,WM-0030,1275,4606,129,0,0,0,0,0,4735,4606,129,0,0,0,0,0,4735,9212,258,0,0,0,0,0,9470,PROJECT DELAYED DUE TO CHANGES IN SCOPE/DESIGN,VARIOUS LOCATIONS THROUGHOUT THE EAST-OF-HUDSON WATER SUPPLY DISTRICT,REMOVAL AND REPLACEMENT OF HEAVY STEEL DOORS AT VARIOUS WATER SUPPLY STRUCTURES IN,cpd11-20cw.pdf
CRO-410,NEW CROTON LAKE GATE HOUSE HVAC REHABILITATION,826,DEPT ENVIRONMENTAL PROTECTION,WATER QUALITY PRESERVATION,000,CITYWIDE,WM-0030,850,0,0,2000,0,0,0,0,2000,0,0,2000,0,0,0,0,2000,0,0,4000,0,0,0,0,4000,PROJECT DELAYED DUE TO BUDGETARY CONSTRAINTS,,CROTON LAKE GATE HOUSE HVAC,cpd11-20cw.pdf
CRO-452,WWTP - CYCLICAL EQUIPMENT REPLACEMENT,826,DEPT ENVIRONMENTAL PROTECTION,WATER QUALITY PRESERVATION,000,CITYWIDE,WM-0030,4500,2264,926,1100,750,750,750,0,6540,2264,926,1100,750,750,750,0,6540,4528,1852,2200,1500,1500,1500,0,13080,PROJECT DELAYED DUE TO BUDGETARY CONSTRAINTS,,MAHOPAC WWTP - EQUIPMENT REPLACEMENT & FACILITY REHAB.,cpd11-20cw.pdf
CRO-497,Aqueduct Erosion Restoration at EOH,826,DEPT ENVIRONMENTAL PROTECTION,WATER QUALITY PRESERVATION,000,CITYWIDE,WM-0030,2400,1252,53,0,0,0,0,0,1305,1252,53,0,0,0,0,0,1305,2504,106,0,0,0,0,0,2610,PROJECT DELAYED DUE TO CHANGES IN SCOPE/DESIGN,,AQUEDUCT EROSION RESTORATION AT EOH,cpd11-20cw.pdf
CRO-502,Road Improvement due to Kensico Dam Road Closure,826,DEPT ENVIRONMENTAL PROTECTION,WATER QUALITY PRESERVATION,000,CITYWIDE,WM-0030,2400,5584,141,0,0,0,0,0,5725,5584,141,0,0,0,0,0,5725,11168,282,0,0,0,0,0,11450,PROJECT DELAYED DUE TO BUDGETARY CONSTRAINTS,,ROAD IMPROVEMENT DUE TO KENSICO DAM ROAD CLOSURE,cpd11-20cw.pdf
CRO-509,Arcady Road Reconstruction,826,DEPT ENVIRONMENTAL PROTECTION,WATER QUALITY PRESERVATION,000,CITYWIDE,WM-0030,2000,0,0,2000,0,0,6000,0,8000,0,0,2000,0,0,6000,0,8000,0,0,4000,0,0,12000,0,16000,,,"ARCADY ROAD IS LOCATED IN WESTCHESTER COUNTY, NY ADJACENT TO THE CROTON RESERVOIR.",cpd11-20cw.pdf
CRO-530,"Removal and reconstruction of DEP bridges, upstate watershed",826,DEPT ENVIRONMENTAL PROTECTION,WATER QUALITY PRESERVATION,000,CITYWIDE,WM-0030,19000,2647,221,0,0,16500,0,0,19368,2647,221,0,0,16500,0,0,19368,5294,442,0,0,33000,0,0,38736,PROJECT DELAYED DUE TO BUDGETARY CONSTRAINTS,,REPLACEMENT OF THE BAPTIST CHURCH ROAD BRIDGE,cpd11-20cw.pdf
CRO-534,WEST BRANCH AUXILIARY DAM-CREEP REMEDIATION,826,DEPT ENVIRONMENTAL PROTECTION,WATER QUALITY PRESERVATION,000,CITYWIDE,WM-0030,4000,0,0,8600,0,0,0,0,8600,0,0,8600,0,0,0,0,8600,0,0,17200,0,0,0,0,17200,PROJECT DELAYED DUE TO CHANGES IN SCOPE/DESIGN,,WEST BRANCH AUXILIARY DAM-CREEP REMEDIATION,cpd11-20cw.pdf
CRO-536,EOH Dam Facing,826,DEPT ENVIRONMENTAL PROTECTION,WATER QUALITY PRESERVATION,000,CITYWIDE,WM-0030,21000,4196,0,3000,35000,0,0,0,42196,4196,0,3000,35000,0,0,0,42196,8392,0,6000,70000,0,0,0,84392,PROJECT DELAYED DUE TO BUDGETARY CONSTRAINTS,,CATSKILL AQUEDUCT PRESSURE CAPS-MODNA SIPHON,cpd11-20cw.pdf
CRO-546,Amawalk Dam Ogee Spillway Replacement,826,DEPT ENVIRONMENTAL PROTECTION,WATER QUALITY PRESERVATION,000,CITYWIDE,WM-0030,3000,0,0,0,2130,0,0,0,2130,0,0,0,2130,0,0,0,2130,0,0,0,4260,0,0,0,4260,,,PERMANENT REPLACEMENT OF BOTH SPILLWAY APPROACH WALLS AT AMAWALK DAM,cpd11-20cw.pdf
CRO-551,Conversion of Kensico Lab to EOH Operations HQ,826,DEPT ENVIRONMENTAL PROTECTION,WATER QUALITY PRESERVATION,000,CITYWIDE,WM-0030,5000,0,0,6300,0,0,0,0,6300,0,0,6300,0,0,0,0,6300,0,0,12600,0,0,0,0,12600,,,CONVERSION OF KENSICO LAB TO EOH OPERATIONS HQ,cpd11-20cw.pdf
CRO-552,Shaft 18 Traveling Screens & Other Work,826,DEPT ENVIRONMENTAL PROTECTION,WATER QUALITY PRESERVATION,000,CITYWIDE,WM-0030,5000,0,0,0,5000,0,0,0,5000,0,0,0,5000,0,0,0,5000,0,0,0,10000,0,0,0,10000,,,PURCHASE AND INSTALLATION OF TRAVELING SCREENS AT SHAFT 18,cpd11-20cw.pdf
CRO-553,KENSICO SPILLWAY CRACK RECONSTRUCTION,826,DEPT ENVIRONMENTAL PROTECTION,WATER QUALITY PRESERVATION,000,CITYWIDE,WM-0030,4000,0,0,0,4000,0,0,16000,20000,0,0,0,4000,0,0,16000,20000,0,0,0,8000,0,0,32000,40000,,,KENSICO SPILLWAY CRACK RECONSTRUCTION,cpd11-20cw.pdf
CRO-557,Kensico Waterfowl Facility Construction & Paving,826,DEPT ENVIRONMENTAL PROTECTION,WATER QUALITY PRESERVATION,000,CITYWIDE,WM-0030,8100,0,0,8100,0,0,0,0,8100,0,0,8100,0,0,0,0,8100,0,0,16200,0,0,0,0,16200,,,KENSICO WATERFOWL FACILITY CONSTRUCTION & PAVING,cpd11-20cw.pdf
CRO-558,Aqueduct Restoration at Lake Street - EOH,826,DEPT ENVIRONMENTAL PROTECTION,WATER QUALITY PRESERVATION,000,CITYWIDE,WM-0030,3500,0,0,0,0,2500,0,0,2500,0,0,0,0,2500,0,0,2500,0,0,0,0,5000,0,0,5000,,,AQUEDUCT RESTORATION AT LAKE STREET - EOH,cpd11-20cw.pdf
CRO-570,HILLVIEW MAINTENANCE SHOP,826,DEPT ENVIRONMENTAL PROTECTION,WATER QUALITY PRESERVATION,000,CITYWIDE,WM-0030,5000,0,0,5250,0,0,0,0,5250,0,0,5250,0,0,0,0,5250,0,0,10500,0,0,0,0,10500,PROJECT DELAYED DUE TO BUDGETARY CONSTRAINTS,,HILLVIEW MAINTENANCE SHOP,cpd11-20cw.pdf
CRO-589,EASTVIEW MAINTENANCE SHOP,826,DEPT ENVIRONMENTAL PROTECTION,WATER QUALITY PRESERVATION,000,CITYWIDE,WM-0030,5000,0,0,0,0,0,0,7000,7000,0,0,0,0,0,0,7000,7000,0,0,0,0,0,0,14000,14000,,,EASTVIEW MAINTENANCE SHOP,cpd11-20cw.pdf
CRO-594,UV FOUNDATION DRAIN MH PHASE 2,826,DEPT ENVIRONMENTAL PROTECTION,WATER QUALITY PRESERVATION,000,CITYWIDE,WM-0030,1300,0,0,1300,0,0,0,0,1300,0,0,1300,0,0,0,0,1300,0,0,2600,0,0,0,0,2600,,,UV FOUNDATION DRAIN MH PHASE 2,cpd11-20cw.pdf
CRO-607,Shaft 17 Elevator Replacement,826,DEPT ENVIRONMENTAL PROTECTION,WATER QUALITY PRESERVATION,000,CITYWIDE,WM-0030,300,0,300,0,0,0,0,0,300,0,300,0,0,0,0,0,300,0,600,0,0,0,0,0,600,,,SHAFT 17 ELEVATOR REPLACEMENT,cpd11-20cw.pdf
CRO-609,Cyclic Equipment Replacement for WTO,826,DEPT ENVIRONMENTAL PROTECTION,WATER QUALITY PRESERVATION,000,CITYWIDE,WM-0030,3000,0,1000,2000,0,0,0,0,3000,0,1000,2000,0,0,0,0,3000,0,2000,4000,0,0,0,0,6000,,,CYCLIC EQUIPMENT REPLACEMENT FOR WTO,cpd11-20cw.pdf
CRO-610,Paving of Roadway at Hillview Complex,826,DEPT ENVIRONMENTAL PROTECTION,WATER QUALITY PRESERVATION,000,CITYWIDE,WM-0030,600,0,0,600,0,0,0,0,600,0,0,600,0,0,0,0,600,0,0,1200,0,0,0,0,1200,,,PAVING OF ROADWAY AT HILLVIEW COMPLEX,cpd11-20cw.pdf
CRO-611,BWS Emergency Services Contract,826,DEPT ENVIRONMENTAL PROTECTION,WATER QUALITY PRESERVATION,000,CITYWIDE,WM-0030,9000,0,0,0,3000,0,6000,0,9000,0,0,0,3000,0,6000,0,9000,0,0,0,6000,0,12000,0,18000,,,BWS EMERGENCY SERVICES CONTRACT,cpd11-20cw.pdf
CSO-LTCP2,CITY-WIDE LONG TERM CONTROL PLAN FOR CSO ABATEMENT,826,DEPT ENVIRONMENTAL PROTECTION,WATER QUALITY MANDATES,000,CITYWIDE,WP-0169,38607,35199,393,0,0,0,0,0,35592,35199,393,0,0,0,0,0,35592,70398,786,0,0,0,0,0,71184,,,FACILITY PLANNING FOR THE DEVELOPMENT OF THE CITYWIDE CSO LONG TERM CONTROL PLAN,cpd11-20cw.pdf
CSO-UPGRD,UPGRADES AT CSO FACILITIES,826,DEPT ENVIRONMENTAL PROTECTION,WATER QUALITY MANDATES,000,CITYWIDE,WP-0169,20000,0,0,0,0,0,0,20000,20000,0,0,0,0,0,0,20000,20000,0,0,0,0,0,0,40000,40000,,,UPGRADES AT CSO FACILITIES,cpd11-20cw.pdf
CT12VENT,"CITY TUNNELS1 & 2, REPLACE VENTURI LINES @ SHAFTS",826,DEPT ENVIRONMENTAL PROTECTION,"CITY TUNNEL NO. 1, RECONSTRUCTION",000,CITYWIDE,W-0015,22000,0,0,965,0,0,0,0,965,0,0,965,0,0,0,0,965,0,0,1930,0,0,0,0,1930,,,"CITY TUNNELS1 & 2, REPLACE VENTURI LINES @ SHAFTS",cpd11-20cw.pdf
CT315B,"CITY TUNNEL 3, REPAIR LEAK@ SHAFT 15B",826,DEPT ENVIRONMENTAL PROTECTION,WATER QUALITY PRESERVATION,,CITYWIDE,W-0013,4000,0,160,0,0,0,0,0,160,0,160,0,0,0,0,0,160,0,320,0,0,0,0,0,320,PROJECT DELAYED DUE TO CHANGES IN SCOPE/DESIGN,,"CITY TUNNEL 3, REPAIR LEAK@ SHAFT 15B",cpd11-20cw.pdf
CT3CORR,Repairs & Remediate Corrosion Issues - CT 3,826,DEPT ENVIRONMENTAL PROTECTION,CORROSION PROTECTION SYSTEM,,CITYWIDE,W-0013,67000,10751,0,2000,0,19000,2500,0,34251,10751,0,2000,0,19000,2500,0,34251,21502,0,4000,0,38000,5000,0,68502,PROJECT DELAYED DUE TO BUDGETARY CONSTRAINTS,,"CITY TUNNEL 3, CORRECT STAGE 1 CORROSION ISSUES",cpd11-20cw.pdf
DEL-194,Merriman Dam Spillway,826,DEPT ENVIRONMENTAL PROTECTION,DAM SAFETY PROGRAM,000,CITYWIDE,WM-0030,25250,2028,572,3000,20000,0,0,0,25600,2028,572,3000,20000,0,0,0,25600,4056,1144,6000,40000,0,0,0,51200,PROJECT DELAYED DUE TO BUDGETARY CONSTRAINTS,UPSTATE,MERRIMAN DAM & RONDOUT RESERVOIR INTAKE & EFFLUENT CHAMBER,cpd11-20cw.pdf
DEL-231,CANNONSVILLE EMERGENCY GATE TOWER,826,DEPT ENVIRONMENTAL PROTECTION,WATER QUALITY PRESERVATION,000,CITYWIDE,WM-0030,1150,0,100,0,0,0,0,0,100,0,100,0,0,0,0,0,100,0,200,0,0,0,0,0,200,PROJECT DELAYED DUE TO CHANGES IN SCOPE/DESIGN,"CANNONSVILLE RESERVOIR, DELAWARE COUNTY, NY",RPLACEMENT OF EMERGENCY GATE TOWER HOIST,cpd11-20cw.pdf
DEL-359V,Shaft 4 Gate Valve Replacements,826,DEPT ENVIRONMENTAL PROTECTION,WATER QUALITY PRESERVATION,,CITYWIDE,WM-0030,6000,0,0,2500,0,9500,0,0,12000,0,0,2500,0,9500,0,0,12000,0,0,5000,0,19000,0,0,24000,,,SHAFT 4 GATE VALVE REPLACEMENTS,cpd11-20cw.pdf
DEL-395,DELAWARE CHAMBERS HVAC IMPROVEMENT,826,DEPT ENVIRONMENTAL PROTECTION,WATER QUALITY PRESERVATION,000,CITYWIDE,WM-0030,500,0,0,500,0,0,0,0,500,0,0,500,0,0,0,0,500,0,0,1000,0,0,0,0,1000,PROJECT DELAYED DUE TO CHANGES IN SCOPE/DESIGN,,DELAWARE CHAMBERS HVAC IMPROVEMENT,cpd11-20cw.pdf
DEL-397,Riser Valve Control Mechanism at DA Chambers,826,DEPT ENVIRONMENTAL PROTECTION,WATER QUALITY PRESERVATION,000,CITYWIDE,WM-0030,10000,500,0,0,7600,0,0,0,8100,500,0,0,7600,0,0,0,8100,1000,0,0,15200,0,0,0,16200,,,DA/CA FASTENERS REPLACMENT & RISER VALVE OPERATORS,cpd11-20cw.pdf
DEL-400,Town fo Wawarsing Public Water Project,826,DEPT ENVIRONMENTAL PROTECTION,WATER QUALITY PRESERVATION,000,CITYWIDE,WM-0030,17000,7000,13000,0,0,0,0,0,20000,7000,13000,0,0,0,0,0,20000,14000,26000,0,0,0,0,0,40000,,,INTER GOV'T AGREEMENT-DEP CONTRIBUTE FINANCIAL ASSISTANCE TO THE TOWNOF WAWARSING TO,cpd11-20cw.pdf
DEL-415,EAST DELAWARE RELEASE CHAMBER VALVE REPLACEMENTS,826,DEPT ENVIRONMENTAL PROTECTION,MISCELLANEOUS IMPROVEMENTS UPSTATE,,CITYWIDE,WM-0030,5990,0,11493,0,0,0,0,0,11493,0,11493,0,0,0,0,0,11493,0,22986,0,0,0,0,0,22986,PROJECT DELAYED DUE TO BUDGETARY CONSTRAINTS,,REPLACEMENT OF RELEASE CHAMER VALVE AT EAST DELAWARE.,cpd11-20cw.pdf
DEL-424,Replacement/Rehabilitation of Honk Falls Dam,826,DEPT ENVIRONMENTAL PROTECTION,DAM SAFETY PROGRAM,000,CITYWIDE,WM-0030,8221,3985,4780,9500,0,0,0,0,18265,3985,4780,9500,0,0,0,0,18265,7970,9560,19000,0,0,0,0,36530,,,REPLACEMENT/REHABILITATION OF HONK FALLS DAM,cpd11-20cw.pdf
DEL-428,EDTO VALVE,826,DEPT ENVIRONMENTAL PROTECTION,WATER QUALITY PRESERVATION,000,CITYWIDE,WM-0030,800,0,800,0,0,0,0,0,800,0,800,0,0,0,0,0,800,0,1600,0,0,0,0,0,1600,,,EDTO VALVE,cpd11-20cw.pdf
DEL-434,DAM STABILITY IMPROVEMENTS,826,DEPT ENVIRONMENTAL PROTECTION,WATER QUALITY PRESERVATION,000,CITYWIDE,WM-0030,19500,0,0,2500,0,0,0,25000,27500,0,0,2500,0,0,0,25000,27500,0,0,5000,0,0,0,50000,55000,,,DAM STABILITY IMPROVEMENTS,cpd11-20cw.pdf
DEL-439,Sludge Drying Greenhouse Recon. at Margaretville WWTP,826,DEPT ENVIRONMENTAL PROTECTION,WATER QUALITY PRESERVATION,000,CITYWIDE,WM-0030,1990,0,2436,0,0,0,0,0,2436,0,2436,0,0,0,0,0,2436,0,4872,0,0,0,0,0,4872,,,THIS PROJECT IS TO REPLACE GREENHOUSE SUPERSTRUCTURE OVER 6 SLUDGE DRYING BEDS AT THE,cpd11-20cw.pdf
DEL-450,Downsville Water Connection,826,DEPT ENVIRONMENTAL PROTECTION,WATER QUALITY PRESERVATION,000,CITYWIDE,WM-0030,365,0,0,0,0,365,0,0,365,0,0,0,0,365,0,0,365,0,0,0,0,730,0,0,730,,,DOWNSVILLE WATER CONNECTION,cpd11-20cw.pdf
DEL-SHFT4,Dependability- Connection from Del Aqueduct to Cat Aqueduct,826,DEPT ENVIRONMENTAL PROTECTION,WATER FOR THE FUTURE,000,CITYWIDE,W-0005,57000,31014,246,0,0,0,0,0,31260,31014,246,0,0,0,0,0,31260,62028,492,0,0,0,0,0,62520,PROJECT DELAYED DUE TO BUDGETARY CONSTRAINTS,TO CONSTRUCT A CONNCECTION FROM SHAFT 4 OF THE DELAWARE AQUEDUCT TO THE CATSKILL,TO CONSTRUCT A CONNCECTION FROM SHAFT 4 OF THE DELAWARE AQUEDUCT TO THE CATSKILL,cpd11-20cw.pdf
DEP-CO,Allocation for change orders,826,DEPT ENVIRONMENTAL PROTECTION,WATER QUALITY PRESERVATION,000,CITYWIDE,WM-0030,0,0,2873,0,0,0,0,0,2873,0,2873,0,0,0,0,0,2873,0,5746,0,0,0,0,0,5746,,,ALLOCATION FOR UNIDENTIFIED CHANGE ORDERS,cpd11-20cw.pdf
DEP-DRA,DELAWARE-RONDOUT AQUEDUCT (PARALLEL TUNNEL TO RWBT),826,DEPT ENVIRONMENTAL PROTECTION,WATER FOR THE FUTURE,000,CITYWIDE,W-0005,2221696,1055453,28201,0,0,0,0,0,1083654,1055453,28201,0,0,0,0,0,1083654,2110906,56402,0,0,0,0,0,2167308,,UPSTATE,DELAWARE-RONDOUT AQUEDUCT (PARALLEL TUNNEL TO RWBT).,cpd11-20cw.pdf
DOERETRO,WATER EFFICIENCY UPGRADES AT DOE SCHOOLS,826,DEPT ENVIRONMENTAL PROTECTION,WATER FOR THE FUTURE,000,CITYWIDE,EP-0009,11593,0,5000,6593,0,0,0,0,11593,0,5000,6593,0,0,0,0,11593,0,10000,13186,0,0,0,0,23186,,,"REPLACEMENT OF DOE SCHOOLS TOILETS AND URINALS WITH HIGH EFFICIENCY MODELS, CITYWIDE",cpd11-20cw.pdf
DSMNH,Deep Sewer Manholes,826,DEPT ENVIRONMENTAL PROTECTION,REPLACEMENT OR AUGMENTATION OF EXISTING SYSTEMS,000,CITYWIDE,SE-0001,3000,0,2000,0,0,10000,0,13000,25000,0,2000,0,0,10000,0,13000,25000,0,4000,0,0,20000,0,26000,50000,PROJECT DELAYED DUE TO BUDGETARY CONSTRAINTS,,DESIGN COSTS FOR DEEP SEWER MANHOLES,cpd11-20cw.pdf
EC-GUN22,"Emergency Guniting of Sewers, Citywide",826,DEPT ENVIRONMENTAL PROTECTION,REPLACEMENT OF CHRONICALLY FAILING COMPONENTS,000,CITYWIDE,SE-0758,8911,0,0,8100,0,0,0,0,8100,0,0,8100,0,0,0,0,8100,0,0,16200,0,0,0,0,16200,,,"EMERGENCY GUNITING OF SEWERS, CITYWIDE",cpd11-20cw.pdf
EC-LC22A,Emergency Sewer Lining,826,DEPT ENVIRONMENTAL PROTECTION,REPLACEMENT OF CHRONICALLY FAILING COMPONENTS,000,CITYWIDE,SE-0002K SE-0002M SE-0002Q SE-0002R SE-0002X,4458,0,0,4050,0,0,0,0,4050,0,0,4050,0,0,0,0,4050,0,0,8100,0,0,0,0,8100,,,EMERGENCY SEWER LINING,cpd11-20cw.pdf
EC-WMC22,"Emergency Reconstruction of Water Mains, Citywide",826,DEPT ENVIRONMENTAL PROTECTION,AUGMENTATION OF WATER SUPPLY SYSTEMS,,CITYWIDE,EP-0007 WM-0001 WM-0006,13586,0,0,12350,0,0,0,0,12350,0,0,12350,0,0,0,0,12350,0,0,24700,0,0,0,0,24700,,,"EMERGENCY RECONSTRUCTION OF WATER MAINS, CITYWIDE",cpd11-20cw.pdf
EE-RRC,TRC - RESIDUAL CHLORINE REDUCTION PROGRAM,826,DEPT ENVIRONMENTAL PROTECTION,CONSENT DECREE UPGRADING AND CONSTRUCTION,000,CITYWIDE,WP-0282,76848,84343,9936,0,0,0,15000,63895,173174,84343,9936,0,0,0,15000,63895,173174,168686,19872,0,0,0,30000,127790,346348,PROJECT DELAYED DUE TO BUDGETARY CONSTRAINTS,RESIDUAL CHLORINE REDUCTION PROGRAM,RESIDUAL CHLORINE REDUCTION PROGRAM,cpd11-20cw.pdf
FADFLOOD,FAD - FLOOD HAZARD MITIGATION,826,DEPT ENVIRONMENTAL PROTECTION,FILTRATION AVOIDANCE DETERMINATION,000,CITYWIDE,WM-0030,15000,12000,0,11000,0,0,0,0,23000,12000,0,11000,0,0,0,0,23000,24000,0,22000,0,0,0,0,46000,,,FAD - FLOOD HAZARD MITIGATION,cpd11-20cw.pdf
FMC-LEAD,LEAD PAINT ABATEMENT & REMOVAL,826,DEPT ENVIRONMENTAL PROTECTION,FACILITY PURCHASES AND RECONSTRUCTION,000,CITYWIDE,EP-0006,1986,1795,7192,0,0,2000,1500,0,12487,1795,7192,0,0,2000,1500,0,12487,3590,14384,0,0,4000,3000,0,24974,PROJECT DELAYED DUE TO CHANGES IN SCOPE/DESIGN,,LEAD PAINT ABATEMENT & REMOVAL,cpd11-20cw.pdf
GI-CONS-1,GI - GREEN INFRASTRUCTURE ONSITE CONSTRUCTION CONTRACTS,826,DEPT ENVIRONMENTAL PROTECTION,GREEN INFRASTRUCTURE PROGRAM,000,CITYWIDE,WP-0169,17000,0,0,0,0,17000,0,0,17000,0,0,0,0,17000,0,0,17000,0,0,0,0,34000,0,0,34000,,,"CONSTRUCT GREEN INFRASTRUCTURE RETROFITS ON PUBLIC PARKS, HOUSING DEVELOPMENTS OR",cpd11-20cw.pdf
GI-CONS-2,GI - GREEN INFRASTRUCTURE ONSITE CONSTRUCTION CONTRACTS,826,DEPT ENVIRONMENTAL PROTECTION,GREEN INFRASTRUCTURE PROGRAM,000,CITYWIDE,WP-0169,14600,0,0,0,0,14600,0,0,14600,0,0,0,0,14600,0,0,14600,0,0,0,0,29200,0,0,29200,,,"CONSTRUCT GREEN INFRASTRUCTURE RETROFITS ON PUBLIC PARKS, HOUSING DEVELOPMENTS OR",cpd11-20cw.pdf
GI-DDC,GI - DDC PROJECTS-GREEN INFRASTRUCTURE AND PUBLIC BUILDINGS,826,DEPT ENVIRONMENTAL PROTECTION,GREEN INFRASTRUCTURE PROGRAM,000,CITYWIDE,WP-0169,44202,0,1740,0,0,0,0,0,1740,0,1740,0,0,0,0,0,1740,0,3480,0,0,0,0,0,3480,PROJECT DELAYED DUE TO BUDGETARY CONSTRAINTS,,DDC PROJECTS - GREEN INFRASTRUCTURE,cpd11-20cw.pdf
GI-GRANT,GI - GREEN INFRASTRUCTURE GRANT PROGRAM,826,DEPT ENVIRONMENTAL PROTECTION,GREEN INFRASTRUCTURE PROGRAM,000,CITYWIDE,WP-0169,30000,10232,4934,2726,0,0,0,0,17892,10232,4934,2726,0,0,0,0,17892,20464,9868,5452,0,0,0,0,35784,PROJECT DELAYED DUE TO CHANGES IN SCOPE/DESIGN,,GREEN INFRASTRUCTURE GRANT PROGRAM,cpd11-20cw.pdf
GI-HPD,GI - FUNDING FOR HPD GREEN INFRASTRUCTURE PROJECTS,826,DEPT ENVIRONMENTAL PROTECTION,GREEN INFRASTRUCTURE PROGRAM,000,CITYWIDE,WP-0169,750,0,0,0,1000,0,500,0,1500,0,0,0,1000,0,500,0,1500,0,0,0,2000,0,1000,0,3000,PROJECT DELAYED DUE TO CHANGES IN SCOPE/DESIGN,,GI - FUNDING FOR HPD GREEN INFRASTRUCTURE PROJECTS,cpd11-20cw.pdf
HVR-500,Hillview Police Precinct,826,DEPT ENVIRONMENTAL PROTECTION,WATER QUALITY PRESERVATION,,CITYWIDE,WM-0030,9000,0,0,10100,14000,0,0,0,24100,0,0,10100,14000,0,0,0,24100,0,0,20200,28000,0,0,0,48200,,,"THIS PROJECT WILL CONSTRUCT A NEW BUILDING FOR THE DEP POLICE AT THE HILLVIEW RESERVOIR,",cpd11-20cw.pdf
JFK-12,WATER METER INSTALLATION AT JFK AIRPORT,826,DEPT ENVIRONMENTAL PROTECTION,CONSERVATION FOR WATER METER REPLACEMENTS,000,CITYWIDE,EP-0010,9811,8049,2053,0,0,0,0,0,10102,8049,2053,0,0,0,0,0,10102,16098,4106,0,0,0,0,0,20204,,,,cpd11-20cw.pdf
JOC-12-L,"JOB ORDER CONTRACTING WORK IN REGIONS NORTH, SOUTH, & EAST",826,DEPT ENVIRONMENTAL PROTECTION,PLANT UPGRADING AND RECONSTRUCTION,000,CITYWIDE,WP-0112,119798,65483,63,0,0,0,0,0,65546,65483,63,0,0,0,0,0,65546,130966,126,0,0,0,0,0,131092,,VARIOUS LOCATIONS - CITY-WIDE,"JOB ORDER CONTRACTING FOR PLUMBING WORK IN REGION SOUTH (NEWTOWN CREEK, NORTH RIVER,",cpd11-20cw.pdf
JOC-15BWS,Facilities Improvement Program,826,DEPT ENVIRONMENTAL PROTECTION,WATER QUALITY PRESERVATION,000,CITYWIDE,WM-0030 WM-0011,44160,28980,26446,0,9302,0,0,0,64728,28980,26446,0,9302,0,0,0,64728,57960,52892,0,18604,0,0,0,129456,PROJECT DELAYED DUE TO CHANGES IN SCOPE/DESIGN,,PROCUREMENT CONTRACT FOR JOB ORDER CONTRACTING-UPSTATE,cpd11-20cw.pdf
JOC-17-L,"JOB ORDER CONTRACTING WORK IN REGIONS NORTH, SOUTH & EAST",826,DEPT ENVIRONMENTAL PROTECTION,PLANT UPGRADING AND RECONSTRUCTION,000,CITYWIDE,WP-0112,121700,113113,16371,0,0,0,0,0,129484,113113,16371,0,0,0,0,0,129484,226226,32742,0,0,0,0,0,258968,,VARIOUS WPCPS IN VARIOUS REGIONS AND LOCATIONS CITY-WIDE,JOB ORDER CONTRACTING FOR SMALL TO MEDIUM SIZED PROJECTS IN GENERAL CONSTRUCTION/,cpd11-20cw.pdf
JOC-18-L,"JOB ORDER CONTRACTING WORK IN REGIONS NORTH, SOUTH & EAST",826,DEPT ENVIRONMENTAL PROTECTION,PLANT UPGRADING AND RECONSTRUCTION,000,CITYWIDE,WP-0112,54800,57037,4804,0,0,0,0,0,61841,57037,4804,0,0,0,0,0,61841,114074,9608,0,0,0,0,0,123682,,VARIOUS LOCATIONS CITY-WIDE,JOB ORDER CONTRACTING FOR GENERAL CONSTRUCTION/PLUMBING/HVAC / ELECTRICAL/SCADA AND,cpd11-20cw.pdf
JOC-20-L,"JOB ORDER CONTRACTING WORK IN REGIONS NORTH, SOUTH & EAST",826,DEPT ENVIRONMENTAL PROTECTION,PLANT UPGRADING AND RECONSTRUCTION,000,CITYWIDE,WP-0112,34594,0,28800,0,0,0,0,35000,63800,0,28800,0,0,0,0,35000,63800,0,57600,0,0,0,0,70000,127600,,,JOB ORDER CONTRACTING FOR SMALL TO MEDIUM SIZED PROJECTS IN GENERAL CONSTRUCTION/,cpd11-20cw.pdf
JOC-21-L,"JOB ORDER CONTRACTING WORK IN REGIONS NORTH, SOUTH & EAST",826,DEPT ENVIRONMENTAL PROTECTION,PLANT UPGRADING AND RECONSTRUCTION,000,CITYWIDE,WP-0112,43200,0,47040,0,0,0,0,0,47040,0,47040,0,0,0,0,0,47040,0,94080,0,0,0,0,0,94080,,,JOB ORDER CONTRACTING FOR SMALL TO MEDIUM SIZED PROJECTS IN GENERAL CONSTRUCTION/,cpd11-20cw.pdf
JOC-22-L,"JOB ORDER CONTRACTING WORK IN REGIONS NORTH, SOUTH & EAST",826,DEPT ENVIRONMENTAL PROTECTION,PLANT UPGRADING AND RECONSTRUCTION,000,CITYWIDE,WP-0112,45280,0,0,0,50880,0,0,0,50880,0,0,0,50880,0,0,0,50880,0,0,0,101760,0,0,0,101760,,,JOB ORDER CONTRACTING FOR SMALL TO MEDIUM SIZED PROJECTS IN GENERAL CONSTRUCTION/,cpd11-20cw.pdf
JOC-26-L,"JOB ORDER CONTRACTING WORK IN REGIONS NORTH, SOUTH & EAST",826,DEPT ENVIRONMENTAL PROTECTION,PLANT UPGRADING AND RECONSTRUCTION,000,CITYWIDE,WP-0112,115000,0,0,0,0,0,0,24000,24000,0,0,0,0,0,0,24000,24000,0,0,0,0,0,0,48000,48000,,,JOB ORDER CONTRACTING FOR SMALL TO MEDIUM SIZED PROJECTS IN GENERAL CONSTRUCTION/,cpd11-20cw.pdf
JOC-27-L,"JOB ORDER CONTRACTING WORK IN REGIONS NORTH, SOUTH & EAST",826,DEPT ENVIRONMENTAL PROTECTION,PLANT UPGRADING AND RECONSTRUCTION,000,CITYWIDE,WP-0112,65000,0,0,0,0,0,0,47040,47040,0,0,0,0,0,0,47040,47040,0,0,0,0,0,0,94080,94080,,,JOB ORDER CONTRACTING FOR SMALL TO MEDIUM SIZED PROJECTS IN GENERAL CONSTRUCTION/,cpd11-20cw.pdf
JOC-28-L,"JOB ORDER CONTRACTING WORK IN REGIONS NORTH, SOUTH & EAST",826,DEPT ENVIRONMENTAL PROTECTION,PLANT UPGRADING AND RECONSTRUCTION,000,CITYWIDE,WP-0112,20160,0,0,0,0,0,0,20180,20180,0,0,0,0,0,0,20180,20180,0,0,0,0,0,0,40360,40360,,,"JOB ORDER CONTRACTING WORK IN REGIONS NORTH, SOUTH & EAST",cpd11-20cw.pdf
JOC-29-L,"JOB ORDER CONTRACTING WORK IN REGIONS NORTH, SOUTH & EAST",826,DEPT ENVIRONMENTAL PROTECTION,PLANT UPGRADING AND RECONSTRUCTION,000,CITYWIDE,WP-0112,68160,0,0,0,0,0,0,43200,43200,0,0,0,0,0,0,43200,43200,0,0,0,0,0,0,86400,86400,,,"JOB ORDER CONTRACTING WORK IN REGIONS NORTH, SOUTH & EAST",cpd11-20cw.pdf
JOC-BWS,BWS JOC Contracts (E-O-H & W-O-H),826,DEPT ENVIRONMENTAL PROTECTION,WATER QUALITY PRESERVATION,000,CITYWIDE,WM-0030,64000,0,0,65,6365,0,0,48500,54930,0,0,65,6365,0,0,48500,54930,0,0,130,12730,0,0,97000,109860,PROJECT DELAYED DUE TO CHANGES IN SCOPE/DESIGN,,BWS JOC CONTRACTS (E-O-H & W-O-H),cpd11-20cw.pdf
JOC-BWSO,BWSO Facilities Improvement Program,826,DEPT ENVIRONMENTAL PROTECTION,PLANT UPGRADING AND RECONSTRUCTION,000,CITYWIDE,WM-0105,51348,21780,3030,0,0,1851,0,12900,39561,21780,3030,0,0,1851,0,12900,39561,43560,6060,0,0,3702,0,25800,79122,,,PROCUREMENT CONTRACT FOR JOB ORDER CONTRACTING - CITYWIDE FOR THE BUREAU OF WATER &,cpd11-20cw.pdf
JOC-FMC3,FMC Facilities Improvement Program,826,DEPT ENVIRONMENTAL PROTECTION,FACILITY PURCHASES AND RECONSTRUCTION,,CITYWIDE,EP-0006,5720,2400,2000,1400,0,0,0,0,5800,2400,2000,1400,0,0,0,0,5800,4800,4000,2800,0,0,0,0,11600,,,FMC FACILITIES IMPROVEMENT PROGRAM,cpd11-20cw.pdf
JOC-FMC4,Job Order Contract 2 - CIitywide,826,DEPT ENVIRONMENTAL PROTECTION,FACILITY PURCHASES AND RECONSTRUCTION,,CITYWIDE,EP-0006,4760,2400,0,0,2360,0,0,0,4760,2400,0,0,2360,0,0,0,4760,4800,0,0,4720,0,0,0,9520,PROJECT DELAYED DUE TO BUDGETARY CONSTRAINTS,,JOB ORDER CONTRACT 2 - CITYWIDE,cpd11-20cw.pdf
JOC-FMC6,FMC Facilities Improvement Program,826,DEPT ENVIRONMENTAL PROTECTION,FACILITY PURCHASES AND RECONSTRUCTION,,CITYWIDE,EP-0006,3600,0,0,2400,1200,0,0,0,3600,0,0,2400,1200,0,0,0,3600,0,0,4800,2400,0,0,0,7200,,,FMC FACILITIES IMPROVEMENT PROGRAM,cpd11-20cw.pdf
JOC-FMC7,Job Order Contract 2 - Citywide,826,DEPT ENVIRONMENTAL PROTECTION,FACILITY PURCHASES AND RECONSTRUCTION,,CITYWIDE,EP-0006,3600,0,0,2400,1200,0,0,0,3600,0,0,2400,1200,0,0,0,3600,0,0,4800,2400,0,0,0,7200,,,JOB ORDER CONTRACT 2 - CITYWIDE,cpd11-20cw.pdf
JOC-FMC8,FMC Facilities Improvement Program,826,DEPT ENVIRONMENTAL PROTECTION,FACILITY PURCHASES AND RECONSTRUCTION,,CITYWIDE,EP-0006,3600,0,0,0,0,2400,0,1200,3600,0,0,0,0,2400,0,1200,3600,0,0,0,0,4800,0,2400,7200,,,FMC FACILITIES IMPROVEMENT PROGRAM,cpd11-20cw.pdf
JOC-FMC9,Job Order Contract 2 - Citywide,826,DEPT ENVIRONMENTAL PROTECTION,FACILITY PURCHASES AND RECONSTRUCTION,,CITYWIDE,EP-0006,3600,0,0,0,0,3600,0,0,3600,0,0,0,0,3600,0,0,3600,0,0,0,0,7200,0,0,7200,,,JOB ORDER CONTRACT 2 - CITYWIDE,cpd11-20cw.pdf
JOC-WSO20,BWSO Facilities Improvement Program Citywide,826,DEPT ENVIRONMENTAL PROTECTION,PLANT UPGRADING AND RECONSTRUCTION,000,CITYWIDE,WM-0105,0,0,10560,0,0,0,0,0,10560,0,10560,0,0,0,0,0,10560,0,21120,0,0,0,0,0,21120,,,PROCUREMENT CONTRACT FOR JOB CONTRACTSING - CITYWIDE FOR THE BUREAU OF WATER &,cpd11-20cw.pdf
JPSCOMPEH,JEROME PS ELECTRIC & HYDRAULIC SVC REPLAMNT,826,DEPT ENVIRONMENTAL PROTECTION,WATER QUALITY PRESERVATION,,CITYWIDE,WM-0105,5000,0,0,0,0,0,0,6000,6000,0,0,0,0,0,0,6000,6000,0,0,0,0,0,0,12000,12000,PROJECT DELAYED DUE TO CHANGES IN SCOPE/DESIGN,,JEROME PS ELECTRIC & HYDRAULIC SVC REPLAMNT,cpd11-20cw.pdf
KENS-EAST,KENSICO-EASTVIEW CONNECTION TUNNEL,826,DEPT ENVIRONMENTAL PROTECTION,KENSICO-CITY TUNNEL,000,CITYWIDE,W-0014,563000,104260,15375,0,0,62313,574620,620576,1377144,104260,15375,0,0,62313,574620,620576,1377144,208520,30750,0,0,124626,1149240,1241152,2754288,,,KENSICO-EASTVIEW CONNECTION TUNNEL,cpd11-20cw.pdf
LFK-RELO,Lefrak Relocation,826,DEPT ENVIRONMENTAL PROTECTION,FACILITY PURCHASES AND RECONSTRUCTION,,CITYWIDE,EP-0006,10500,0,0,0,0,0,0,10500,10500,0,0,0,0,0,0,10500,10500,0,0,0,0,0,0,21000,21000,PROJECT DELAYED DUE TO BUDGETARY CONSTRAINTS,,"LEFRAK RELOCATION INCLUDING OIT COST, LABS, PARKING AND ETC.",cpd11-20cw.pdf
MONIT-13,FAD 13-17 Monitoring,826,DEPT ENVIRONMENTAL PROTECTION,FILTRATION AVOIDANCE DETERMINATION,000,CITYWIDE,WM-0030,215,78,158,137,103,187,250,299,1212,78,158,137,103,187,250,299,1212,156,316,274,206,374,500,598,2424,,,FAD 13-17 MONITORING,cpd11-20cw.pdf
MS4-STORM,MS4 CITYWIDE STORMWATER MANAGEMENT PROGRAM,826,DEPT ENVIRONMENTAL PROTECTION,WATER QUALITY MANDATES,000,CITYWIDE,SE-0005,29378,9378,9750,0,0,0,0,0,19128,9378,9750,0,0,0,0,0,19128,18756,19500,0,0,0,0,0,38256,,,MS4 CITYWIDE STORMWATER MANAGEMENT PROGRAM,cpd11-20cw.pdf
NYSDOTBRG,"NYS DOT Bridges El Grant, Jesup, Nelson, Depot, Boston Road",826,DEPT ENVIRONMENTAL PROTECTION,WATER QUALITY PRESERVATION,000,CITYWIDE,WM-0006,5000,1003,0,3997,0,0,0,0,5000,1003,0,3997,0,0,0,0,5000,2006,0,7994,0,0,0,0,10000,,,"NYS DOT EL GRANT, JESUP AND NELSON AVENUE (PIN X806.56), DEPOT PLACE (PIN X720.39), AND",cpd11-20cw.pdf
PJ-PLNT,"RECONSTRUCTION OF PORT JERVIS WPCP, DEL",826,DEPT ENVIRONMENTAL PROTECTION,WATER QUALITY PRESERVATION,000,CITYWIDE,WM-0030,44140,6839,10266,35000,0,0,0,0,52105,6839,10266,35000,0,0,0,0,52105,13678,20532,70000,0,0,0,0,104210,PROJECT DELAYED DUE TO BUDGETARY CONSTRAINTS,UPSTATE,RECONSTRUCTION OF THE PORT JERVIS WATER POLLUTION CONTROL PLANT,cpd11-20cw.pdf
PS179,REHAB 179 ST PS/CONST MULTIPLE PS IN TOWER AREA,826,DEPT ENVIRONMENTAL PROTECTION,WATER QUALITY PRESERVATION,,CITYWIDE,WM-0105,12000,0,0,0,0,0,10000,0,10000,0,0,0,0,0,10000,0,10000,0,0,0,0,0,20000,0,20000,,,REHAB 179 ST PS/CONST MULTIPLE PS IN TOWER AREA,cpd11-20cw.pdf
PW-TOC3,CONSULTANT DESIGN SVCS FOR ALL BWWT JOC & CAPITAL PROJECTS,826,DEPT ENVIRONMENTAL PROTECTION,PLANT UPGRADING AND RECONSTRUCTION,000,CITYWIDE,WP-0112,30000,0,0,0,0,0,0,34306,34306,0,0,0,0,0,0,34306,34306,0,0,0,0,0,0,68612,68612,,VARIOUS BWWT LOCATIONS CITY-WIDE,CONSULTANT DESIGN SERVICES FOR ALL BWWT JOC AND CAPITAL PROJECTS CITY-WIDE,cpd11-20cw.pdf
RESAMSAF,DESIGN & CM FOR DAM SAFETY CONSTRUCTION,826,DEPT ENVIRONMENTAL PROTECTION,WATER QUALITY PRESERVATION,000,CITYWIDE,WM-0105,29000,9691,122,4000,0,40000,0,0,53813,9691,122,4000,0,40000,0,0,53813,19382,244,8000,0,80000,0,0,107626,PROJECT DELAYED DUE TO BUDGETARY CONSTRAINTS,,DESIGN & CM FOR DAM SAFETY CONSTRUCTION,cpd11-20cw.pdf
RIDGEPIPE,RIDGEWOOD RESERVOIR PIPE ABANDONMENT,826,DEPT ENVIRONMENTAL PROTECTION,WATER QUALITY PRESERVATION,,CITYWIDE,WM-0105,2000,0,0,2500,0,0,0,0,2500,0,0,2500,0,0,0,0,2500,0,0,5000,0,0,0,0,5000,,,RIDGEWOOD RESERVOIR PIPE ABANDONMENT - FILLING IN OF ABANDONED UNDERGROUND,cpd11-20cw.pdf
RLCY-WWT,FLOODWATER RESILIENCY AT BWT FACILITES,826,DEPT ENVIRONMENTAL PROTECTION,PLANT UPGRADING AND RECONSTRUCTION,000,CITYWIDE,WP-0112,181000,263702,18334,0,0,0,0,0,282036,263702,18334,0,0,0,0,0,282036,527404,36668,0,0,0,0,0,564072,,,DESIGN AND CONSTRUCTION REQUIREMENTS CONTRACTS WHICH WILL FOCUS ON IMPLEMENTING THE,cpd11-20cw.pdf
ROWGI-A,GI - CITYWIDE CONSTRUCTION OF ROW GREEN INFRASTRUCTURE,826,DEPT ENVIRONMENTAL PROTECTION,GREEN INFRASTRUCTURE PROGRAM,000,CITYWIDE,WP-0169,40000,0,0,0,0,0,0,30000,30000,0,0,0,0,0,0,30000,30000,0,0,0,0,0,0,60000,60000,PROJECT DELAYED DUE TO BUDGETARY CONSTRAINTS,,GI - CITYWIDE CM SERVICES FOR RIGHT OF WAY GREEN INFRASTRUCTURE PROJECTS,cpd11-20cw.pdf
SANDHILLV,HILLVIEW RESERVOIR SECURITY FENCE IMPROVEMENTS,826,DEPT ENVIRONMENTAL PROTECTION,MANAGEMENT INFORMATION SYSTEMS,000,CITYWIDE,EP-0006,574,25,100,0,0,0,0,0,125,25,100,0,0,0,0,0,125,50,200,0,0,0,0,0,250,,"HILLVIEW RESERVIOR AT YONKERS, NEW YORK",IMPROVEMENTS TO THE HILLVIEW RESERVOIR SECURITY FENCE AND INTRUSION ALERT SYSTEM AS A,cpd11-20cw.pdf
SANDPUMP,RECONS OF VARIOUS PUMPING STATIONS DUE TO HURRICANE SANDY,826,DEPT ENVIRONMENTAL PROTECTION,PLANT UPGRADING AND RECONSTRUCTION,000,CITYWIDE,WP-0269,12969,1485,220,0,0,300,0,407,2412,1485,220,0,0,300,0,407,2412,2970,440,0,0,600,0,814,4824,PROJECT DELAYED DUE TO BUDGETARY CONSTRAINTS,,RECONSTRUCTION OF VARIOUS PUMPING STATIONS CITYWIDE DUE TO HURRICANE SANDY,cpd11-20cw.pdf
SANDWM,RECONS OF WATER MAINS CITYWIDE DUE TO HURRICANE SANDY,826,DEPT ENVIRONMENTAL PROTECTION,TRUNK AND DISTRIBUTION MAIN REPLACEMENT,000,CITYWIDE,WM-0001,3300,0,0,0,0,0,0,300,300,0,0,0,0,0,0,300,300,0,0,0,0,0,0,600,600,,,RECONS OF WATER MAINS CITYWIDE DUE TO HURRICANE SANDY,cpd11-20cw.pdf
SANDWPCPS,RECONS OF WPCPS AND PUMPING STATIONS DUE TO HURRICANE SANDY,826,DEPT ENVIRONMENTAL PROTECTION,PLANT UPGRADING AND RECONSTRUCTION,000,CITYWIDE,WP-0112,111579,2530,1893,17039,0,0,0,0,21462,2530,1893,17039,0,0,0,0,21462,5060,3786,34078,0,0,0,0,42924,,,RECONSTRUCTION OF CITYWIDE WATER POLLUTION CONTROL PLANTS AND PUMPINGSTATIONS DUE,cpd11-20cw.pdf
SFM-1,RECONS OF SLUDGE FORCEMAIN FROM JAMAICA TO 26TH WARD WPCP,826,DEPT ENVIRONMENTAL PROTECTION,PLANT UPGRADING AND RECONSTRUCTION,000,CITYWIDE,WP-0112,100000,0,0,0,0,0,0,100000,100000,0,0,0,0,0,0,100000,100000,0,0,0,0,0,0,200000,200000,,,RECONS OF SLUDGE FORCEMAIN FROM JAMAICA TO 26TH WARD WPCP,cpd11-20cw.pdf
STMEOH-18,FAD 18-22 STORMWATER MGMT. (EOH),826,DEPT ENVIRONMENTAL PROTECTION,FILTRATION AVOIDANCE DETERMINATION,000,CITYWIDE,WM-0030,22500,22000,0,0,0,15000,500,0,37500,22000,0,0,0,15000,500,0,37500,44000,0,0,0,30000,1000,0,75000,PROJECT DELAYED DUE TO BUDGETARY CONSTRAINTS,,FAD 18-22 STORMWATER MGMT. (EOH),cpd11-20cw.pdf
STMWOH-08,FAD 08-12 - Stormwater Management-WOH,826,DEPT ENVIRONMENTAL PROTECTION,WATER QUALITY PRESERVATION,000,CITYWIDE,WM-0030,5050,2972,1678,0,0,0,0,0,4650,2972,1678,0,0,0,0,0,4650,5944,3356,0,0,0,0,0,9300,PROJECT DELAYED DUE TO BUDGETARY CONSTRAINTS,,FAD 08-12 - STORMWATER MANAGEMENT-WOH,cpd11-20cw.pdf
STMWOH-13,FAD 13-17 Stormwater Mgmt. (WOH),826,DEPT ENVIRONMENTAL PROTECTION,FILTRATION AVOIDANCE DETERMINATION,000,CITYWIDE,WM-0030,6875,1451,4550,0,0,0,0,0,6001,1451,4550,0,0,0,0,0,6001,2902,9100,0,0,0,0,0,12002,PROJECT DELAYED DUE TO BUDGETARY CONSTRAINTS,,FAD 13-17 STORMWATER MGMT. (WOH),cpd11-20cw.pdf
STMWOH-18,FAD 18-22 STORMWATER MGMT. (WOH),826,DEPT ENVIRONMENTAL PROTECTION,FILTRATION AVOIDANCE DETERMINATION,000,CITYWIDE,WM-0030,14721,4721,0,10000,0,0,0,0,14721,4721,0,10000,0,0,0,0,14721,9442,0,20000,0,0,0,0,29442,PROJECT DELAYED DUE TO BUDGETARY CONSTRAINTS,,FAD 18-22 STORMWATER MGMT. (WOH),cpd11-20cw.pdf
STPUPG-18,FAD 18-22 WWTP UPGRADE PROGRAM,826,DEPT ENVIRONMENTAL PROTECTION,FILTRATION AVOIDANCE DETERMINATION,000,CITYWIDE,WM-0030,26200,26200,20000,0,0,0,0,0,46200,26200,20000,0,0,0,0,0,46200,52400,40000,0,0,0,0,0,92400,PROJECT DELAYED DUE TO BUDGETARY CONSTRAINTS,,FAD 18-22 WWTP UPGRADE PROGRAM,cpd11-20cw.pdf
STREAM-18,FAD 18-22 STREAM MANAGEMENT,826,DEPT ENVIRONMENTAL PROTECTION,FILTRATION AVOIDANCE DETERMINATION,000,CITYWIDE,WM-0030,52167,29053,11042,2124,0,4000,1139,2000,49358,29053,11042,2124,0,4000,1139,2000,49358,58106,22084,4248,0,8000,2278,4000,98716,PROJECT DELAYED DUE TO BUDGETARY CONSTRAINTS,,FAD 18-22 STREAM MANAGEMENT,cpd11-20cw.pdf
TOSC1,TASK ORDER SERVICES,826,DEPT ENVIRONMENTAL PROTECTION,AUGMENTATION OF WATER SUPPLY SYSTEMS,000,CITYWIDE,SE-0432,19884,4004,1980,5020,0,2880,1000,5000,19884,4004,1980,5020,0,2880,1000,5000,19884,8008,3960,10040,0,5760,2000,10000,39768,PROJECT DELAYED DUE TO BUDGETARY CONSTRAINTS,,TASK ORDER SERVICES CONTRACT FOR VARIOUS WATER AND SEWER PROJECTS,cpd11-20cw.pdf
UTIUTIL,UTILITY RELOCATION FOR SE AND WM PROJECTS,826,DEPT ENVIRONMENTAL PROTECTION,UTILITY RELOCATION FOR SE AND WM PROJECTS,000,CITYWIDE,EP-0007,502357,325613,0,0,0,29927,121314,0,476854,325613,0,0,0,29927,121314,0,476854,651226,0,0,0,59854,242628,0,953708,,,,cpd11-20cw.pdf
WEC-LGE16,"LARGE WATER METER PURCHASES, REPLACEMENTS AND INSTALLATIONS",826,DEPT ENVIRONMENTAL PROTECTION,CONSERVATION FOR WATER METER REPLACEMENTS,000,CITYWIDE,EP-0010,44983,22606,10016,0,0,1565,2490,7453,44130,22606,10016,0,0,1565,2490,7453,44130,45212,20032,0,0,3130,4980,14906,88260,PROJECT DELAYED DUE TO BUDGETARY CONSTRAINTS,,PURCHASES AND INSTALLATION OF METERS AND RELATED AUTOMATIC METER READING (AMR) SYSTEM,cpd11-20cw.pdf
WFF-CUNY,Water Efficiency Upgrades at CUNY Colleges,826,DEPT ENVIRONMENTAL PROTECTION,WATER FOR THE FUTURE,000,CITYWIDE,EP-0009,900,0,900,0,0,0,0,0,900,0,900,0,0,0,0,0,900,0,1800,0,0,0,0,0,1800,,,"UNDER THIS PROJECT, WATER EFFICIENCY UPGRADES (TOILET, URINAL, AND BATHROOM FAUCET",cpd11-20cw.pdf
WFF-HHC,HHC Fixture Replacement in City-owned Hospitals,826,DEPT ENVIRONMENTAL PROTECTION,WATER FOR THE FUTURE,,CITYWIDE,EP-0009,6000,0,0,6000,0,0,0,0,6000,0,0,6000,0,0,0,0,6000,0,0,12000,0,0,0,0,12000,,,WATER DEMAND MANAGEMENT PROGRAM - MUNICIPAL WATER EFFICIENCY PROGRAM (MWEP),cpd11-20cw.pdf
WFF-IGAS,WFF-INTER-GOV'T AGREEMENT,826,DEPT ENVIRONMENTAL PROTECTION,WATER FOR THE FUTURE,000,CITYWIDE,WM-0030,23000,15347,15917,283,0,0,0,0,31547,15347,15917,283,0,0,0,0,31547,30694,31834,566,0,0,0,0,63094,,,TWO INTER-GOV'T AGREEMENTS TIED TO THE BYPASS TUNNEL PROJECT-WFF. THEAGREEMENTS ARE,cpd11-20cw.pdf
WFF-WWTP,WATER EFICIENCY UPGRADES AT DEP WASTEWATER TREATMENT PLANTS,826,DEPT ENVIRONMENTAL PROTECTION,WATER FOR THE FUTURE,000,CITYWIDE,EP-0009,6000,0,0,5100,0,0,0,0,5100,0,0,5100,0,0,0,0,5100,0,0,10200,0,0,0,0,10200,,,CAPITAL WATER EFICIENCY UPGRADES AT DEP'S WASTEWATER TREATMENT PLANTS,cpd11-20cw.pdf
WFINSP-SP,CITYWIDE WATERFRONT INSPECTIONS AT VARIOUS WPCPS,826,DEPT ENVIRONMENTAL PROTECTION,PLANT UPGRADING AND RECONSTRUCTION,000,CITYWIDE,WP-0112,22200,0,0,0,200,0,0,0,200,0,0,0,200,0,0,0,200,0,0,0,400,0,0,0,400,PROJECT DELAYED DUE TO BUDGETARY CONSTRAINTS,,CITYWIDE WATERFRONT INSPECTIONS AT VARIOUS WPCPS,cpd11-20cw.pdf
WQMON-ENT,Above ground monitoring stations,826,DEPT ENVIRONMENTAL PROTECTION,WATER QUALITY PRESERVATION,000,CITYWIDE,WM-0105,3000,2349,0,0,1500,0,0,0,3849,2349,0,0,1500,0,0,0,3849,4698,0,0,3000,0,0,0,7698,PROJECT DELAYED DUE TO CHANGES IN SCOPE/DESIGN,,ABOVE GROUND MONITORING STATIONS TO REPLACE THREE UNDERGROUND MONITORING VAULTS,cpd11-20cw.pdf
WWMGT-18,FAD 18-22 COMMUNITY WASTEWATER MGMT.,826,DEPT ENVIRONMENTAL PROTECTION,FILTRATION AVOIDANCE DETERMINATION,000,CITYWIDE,WM-0030,30000,24000,0,0,16180,0,0,0,40180,24000,0,0,16180,0,0,0,40180,48000,0,0,32360,0,0,0,80360,PROJECT DELAYED DUE TO BUDGETARY CONSTRAINTS,,FAD 18-22 COMMUNITY WASTEWATER MGMT.,cpd11-20cw.pdf
S136-366C,COMPOSTING,827,DEPARTMENT OF SANITATION,SOLID WASTE MANAGEMENT,000,CITYWIDE,S-0136 S-0129,5801,20799,2070,0,1955,0,0,0,24824,20799,2070,0,1955,0,0,0,24824,41598,4140,0,3910,0,0,0,49648,PROJECT DELAYED PENDING APPROVAL OF NECESSARY PERMITS,,"REHABILITATION, MITIGATION, AND DEVELOPMENT OF COMPOSTING FACILITIES CITYWIDE.",cpd11-20cw.pdf
S136-366D,Construct/Reconstruct composting sites Citywide,827,DEPARTMENT OF SANITATION,SOLID WASTE MANAGEMENT,000,CITYWIDE,S-D136 S-K136,15195,13853,205,0,0,0,0,0,14058,13853,205,0,0,0,0,0,14058,27706,410,0,0,0,0,0,28116,,,CONSTRUCT/RECONSTRUCT COMPOSTING SITES CITYWIDE,cpd11-20cw.pdf
S136-383T,REPLACEMENT OF HVAC ROOF TOP UNITS CITYWIDE,827,DEPARTMENT OF SANITATION,GARAGES AND FACILITIES,,CITYWIDE,S-0136,2102,2501,136,0,0,0,0,0,2637,2501,136,0,0,0,0,0,2637,5002,272,0,0,0,0,0,5274,,,REPLACE OVERAGE ROOF TOP UNITS,cpd11-20cw.pdf
S136-439,"DSNY FACILITY REHAB, CITYWIDE",827,DEPARTMENT OF SANITATION,GARAGES AND FACILITIES,000,CITYWIDE,S-0136,32800,0,0,0,17291,21265,25000,100000,163556,0,0,0,17291,21265,25000,100000,163556,0,0,0,34582,42530,50000,200000,327112,,,REHABILITATION PROJECTS CITYWIDE,cpd11-20cw.pdf
S136-440,"Sidewalks at DSNY Facilities, Citywide",827,DEPARTMENT OF SANITATION,GARAGES AND FACILITIES,,CITYWIDE,S-0136,374,75,0,0,472,0,0,0,547,75,0,0,472,0,0,0,547,150,0,0,944,0,0,0,1094,,,SIDEWALK REPLACEMENT AT SANITATION FACILITIES,cpd11-20cw.pdf
S216-235,PIER WORK -- CITYWIDE,827,DEPARTMENT OF SANITATION,WASTE DISPOSAL,000,CITYWIDE,S-0216,103093,13819,0,0,3749,5480,3948,17172,44168,13819,0,0,3749,5480,3948,17172,44168,27638,0,0,7498,10960,7896,34344,88336,PROJECT DELAYED DUE TO UNFORESEEN SITE/FIELD CONDITION,CITY WIDE,"THESE FUNDS ARE REQUIRED FOR UPGRADING AND REPLACEMENT OF HEATING PLANT SYSTEMS,",cpd11-20cw.pdf
SANDMTSAP,MTS HAZARD MITIGATION ALTERNATE PROJECT- SANDY RELATED WORK,827,DEPARTMENT OF SANITATION,SOLID WASTE MANAGEMENT,000,CITYWIDE,S-0216,1124,0,0,0,68,0,0,0,68,0,0,0,68,0,0,0,68,0,0,0,136,0,0,0,136,,,HAZARD MITIGATION REHABILITATION WORK AT MARINE TRANSFER STATIONS,cpd11-20cw.pdf
ACEDOT503,"DOT Replacement of Streetlight Fixtures to LED,Manh,BX,SI",841,DEPARTMENT OF TRANSPORTATION,"BUILDING CONSTRUCTION, RECONSTRUCTION OR RETROFIT",000,CITYWIDE,TF-0503,22475,18038,0,0,0,427,0,0,18465,18038,0,0,0,427,0,0,18465,36076,0,0,0,854,0,0,36930,PROJECT DELAYED DUE TO BUDGETARY CONSTRAINTS,,"REPLACEMENT OF EXISTING HPS STREET LIGHT FIXTURES WITH ENERGY EFFICIENT, LONG LIFE LED",cpd11-20cw.pdf
BIKE2030,BIKE NETWORK DEVELOPMENT 2030,841,DEPARTMENT OF TRANSPORTATION,TRAFFIC WORK IN CONJUNCTION WITH HIGHWAY RECONSTRUCTION,000,CITYWIDE,TF-0001,12340,0,0,0,0,0,0,1240,1240,0,0,0,0,0,0,1240,1240,0,0,0,0,0,0,2480,2480,PROJECT DELAYED DUE TO BUDGETARY CONSTRAINTS,,BIKE NETWORK DEVELOPMENT 2030,cpd11-20cw.pdf
BR10YR15,Waterway Bridges Ten Year Plan,841,DEPARTMENT OF TRANSPORTATION,USEFUL LIFE EXTENSION,000,CITYWIDE,BR-0270,175000,0,0,15000,50000,50000,50000,205247,370247,0,0,15000,50000,50000,50000,205247,370247,0,0,30000,100000,100000,100000,410494,740494,,WATERWAY BRIDGES TEN YEAR PLAN,WATERWAY BRIDGES TEN YEAR PLAN,cpd11-20cw.pdf
BRC156F,MANHATTAN BRIDGE #15,841,DEPARTMENT OF TRANSPORTATION,EAST RIVER BRIDGES,000,CITYWIDE,BR-0156,98600,40715,2370,0,928,0,0,0,44013,40715,2370,0,928,0,0,0,44013,81430,4740,0,1856,0,0,0,88026,PROJECT DELAYED DUE TO BUDGETARY CONSTRAINTS,,REHAB OF MANHATTAN BRIDGE,cpd11-20cw.pdf
BRC231F,QUEENSBORO BRIDGE #10 OVER EAST RIVER,841,DEPARTMENT OF TRANSPORTATION,EAST RIVER BRIDGES,000,CITYWIDE,BR-0231,153800,330942,10266,7731,0,0,0,0,348939,330942,10266,7731,0,0,0,0,348939,661884,20532,15462,0,0,0,0,697878,PROJECT DELAYED DUE TO BUDGETARY CONSTRAINTS,,REHAB OF QUEENSBORO BRIDGE,cpd11-20cw.pdf
BRC253D,WILLIAMSBURG BRIDGE MISC REPAIRS AND PAINTING FY20,841,DEPARTMENT OF TRANSPORTATION,EAST RIVER BRIDGES,000,CITYWIDE,BR-0253,414300,8590,8273,55763,0,0,0,0,72626,8590,8273,55763,0,0,0,0,72626,17180,16546,111526,0,0,0,0,145252,PROJECT DELAYED DUE TO BUDGETARY CONSTRAINTS,WILLIAMSBURG BRIDGE MISC REPAIRS AND PAINTING FY20,WILLIAMSBURG BRIDGE MISC REPAIRS AND PAINTING FY20,cpd11-20cw.pdf
BRC270D,BROOKLYN BRIDGE REHABILITATION OF APPOACH ARCHES FY19,841,DEPARTMENT OF TRANSPORTATION,EAST RIVER BRIDGES,000,CITYWIDE,BR-0270,300000,207833,9107,0,0,0,0,0,216940,207833,9107,0,0,0,0,0,216940,415666,18214,0,0,0,0,0,433880,PROJECT DELAYED DUE TO BUDGETARY CONSTRAINTS,BROOKLYN BRIDGE REHABILITATION OF APPOACH ARCHES FY19,BROOKLYN BRIDGE REHABILITATION OF APPOACH ARCHES FY19,cpd11-20cw.pdf
BRCHAZMIG,HAZARD MITIGATION (EAST RIVER BRIDGES - CITYWIDE),841,DEPARTMENT OF TRANSPORTATION,EAST RIVER BRIDGES,000,CITYWIDE,BR-0156 BR-0253 BR-0231 BR-0270,107081,583695,0,0,0,0,140877,0,724572,583695,0,0,0,0,140877,0,724572,1167390,0,0,0,0,281754,0,1449144,PROJECT DELAYED DUE TO BUDGETARY CONSTRAINTS,HAZARD MITIGATION (EAST RIVER BRIDGES - CITYWIDE),HAZARD MITIGATION (EAST RIVER BRIDGES - CITYWIDE),cpd11-20cw.pdf
BRKA24039,GRAND STREET/ NEWTON CREEK BIN,841,DEPARTMENT OF TRANSPORTATION,USEFUL LIFE EXTENSION,000,CITYWIDE,HB-1012 HB-0215,138500,6613,300,556,0,6000,126884,0,140353,6613,300,556,0,6000,126884,0,140353,13226,600,1112,0,12000,253768,0,280706,PROJECT DELAYED DUE TO BUDGETARY CONSTRAINTS,GRAND STREET/ NEWTON CREEK BIN,GRAND STREET/ NEWTON CREEK BIN,cpd11-20cw.pdf
BRX287BS,Macombs Dam Bridge- Bus Stop,841,DEPARTMENT OF TRANSPORTATION,USEFUL LIFE EXTENSION,000,CITYWIDE,BR-0287,3216,349,125,0,0,2196,0,0,2670,349,125,0,0,2196,0,0,2670,698,250,0,0,4392,0,0,5340,PROJECT DELAYED DUE TO BUDGETARY CONSTRAINTS,MACOMBS DAM BRIDGE- BUS STOP,MACOMBS DAM BRIDGE- BUS STOP,cpd11-20cw.pdf
BRX287S,MACOMBS DAM BRIDGE - REHAB OF FENDER SYSTEM & 155TH VIA,841,DEPARTMENT OF TRANSPORTATION,USEFUL LIFE EXTENSION,000,CITYWIDE,BR-0287,45920,33237,250,2472,0,0,0,0,35959,33237,250,2472,0,0,0,0,35959,66474,500,4944,0,0,0,0,71918,PROJECT DELAYED DUE TO BUDGETARY CONSTRAINTS,MACOMBS DAM BRIDGE - SEISMIC RETROFIT,MACOMBS DAM BRIDGE - SEISMIC RETROFIT,cpd11-20cw.pdf
BUS2030,BUS INITIATIVES,841,DEPARTMENT OF TRANSPORTATION,TRAFFIC WORK IN CONJUNCTION WITH HIGHWAY RECONSTRUCTION,000,CITYWIDE,HW-1684 TF-0001,55290,0,0,0,0,0,0,58008,58008,0,0,0,0,0,0,58008,58008,0,0,0,0,0,0,116016,116016,PROJECT DELAYED DUE TO BUDGETARY CONSTRAINTS,,BUS INITIATIVES,cpd11-20cw.pdf
C5447,MISCELLANEOUS UPGRADES TO FERRYBOATS,841,DEPARTMENT OF TRANSPORTATION,RECONSTRUCTION OF FERRY BOATS,000,CITYWIDE,FA-0313,7252,450,0,857,515,481,114,7373,9790,450,0,857,515,481,114,7373,9790,900,0,1714,1030,962,228,14746,19580,PROJECT DELAYED DUE TO BUDGETARY CONSTRAINTS,NA,,cpd11-20cw.pdf
C5586,REPLACEMENT OF COSGROVE FERRY BOAT,841,DEPARTMENT OF TRANSPORTATION,RECONSTRUCTION OF FERRY BOATS,000,CITYWIDE,FA-0313,5275,400,3130,0,0,0,0,2960,6490,400,3130,0,0,0,0,2960,6490,800,6260,0,0,0,0,5920,12980,PROJECT DELAYED DUE TO BUDGETARY CONSTRAINTS,,DESIGN AND CONS OF COSGROVE F/BOAT,cpd11-20cw.pdf
C5589AUS,DRYDOCK AUSTEN CLASS FERRY BOATS,841,DEPARTMENT OF TRANSPORTATION,RECONSTRUCTION OF FERRY BOATS,000,CITYWIDE,FA-0313,3500,3830,1365,1405,0,131,0,0,6731,3830,1365,1405,0,131,0,0,6731,7660,2730,2810,0,262,0,0,13462,PROJECT DELAYED DUE TO BUDGETARY CONSTRAINTS,,DRYDOCK AUSTEN FBOATS,cpd11-20cw.pdf
C5BARBERI,RECON & DRYDOCKING OF BARBERI CLASS FERRY BOATS,841,DEPARTMENT OF TRANSPORTATION,RECONSTRUCTION OF FERRY BOATS,000,CITYWIDE,FA-0313,11000,9828,2032,0,2530,0,0,0,14390,9828,2032,0,2530,0,0,0,14390,19656,4064,0,5060,0,0,0,28780,PROJECT DELAYED DUE TO BUDGETARY CONSTRAINTS,,DRYDOCK AND RECON OF FERRY VESSELS,cpd11-20cw.pdf
CONG2030,CONGESTED CORRIDORS/ GROWTH AREAS,841,DEPARTMENT OF TRANSPORTATION,TRAFFIC WORK IN CONJUNCTION WITH HIGHWAY RECONSTRUCTION,000,CITYWIDE,TF-0777,124790,943,0,0,0,0,0,11504,12447,943,0,0,0,0,0,11504,12447,1886,0,0,0,0,0,23008,24894,PROJECT DELAYED DUE TO BUDGETARY CONSTRAINTS,,CONGESTED CORRIDORS/ GROWTH AREAS,cpd11-20cw.pdf
DECKSCRPL,Deck Scows Replacement,841,DEPARTMENT OF TRANSPORTATION,FERRY MAINTENANCE FACILITY CONSTRUCTION,000,CITYWIDE,FA-0313,3300,311,0,0,0,0,0,19,330,311,0,0,0,0,0,19,330,622,0,0,0,0,0,38,660,PROJECT DELAYED DUE TO BUDGETARY CONSTRAINTS,,SCOWS REPLACEMENT,cpd11-20cw.pdf
FACLUMP,LUMP SUM FOR FACILITIES,841,DEPARTMENT OF TRANSPORTATION,BRIDGE FACILITIES,000,CITYWIDE,HW-0003 HB-1014,66253,0,0,27288,3889,4272,5883,26074,67406,0,0,27288,3889,4272,5883,26074,67406,0,0,54576,7778,8544,11766,52148,134812,PROJECT DELAYED DUE TO BUDGETARY CONSTRAINTS,CITYWIDE,,cpd11-20cw.pdf
FARRSLIP,Arrestors for all slips,841,DEPARTMENT OF TRANSPORTATION,RECONSTRUCTION OF FERRY TERMINAL FACILITIES,000,CITYWIDE,FA-0021,45137,947,0,0,0,0,15630,34190,50767,947,0,0,0,0,15630,34190,50767,1894,0,0,0,0,31260,68380,101534,PROJECT DELAYED DUE TO BUDGETARY CONSTRAINTS,,INSTALLATION OF ARRESTORS AT SLIPS,cpd11-20cw.pdf
FATERMTBC,STG & WHT Ferry Terminals Transfer Bridge Control Update,841,DEPARTMENT OF TRANSPORTATION,RECONSTRUCTION OF FERRY TERMINAL FACILITIES,000,CITYWIDE,FA-0021,1600,0,200,0,0,1400,0,0,1600,0,200,0,0,1400,0,0,1600,0,400,0,0,2800,0,0,3200,,,ELECTRICAL UPGRADE AT TERMINALS TRANSFER BRIDGE,cpd11-20cw.pdf
FAVEHBARP,Vehicle Barrier Replacement Upgrade,841,DEPARTMENT OF TRANSPORTATION,RECONSTRUCTION OF FERRY TERMINAL FACILITIES,000,CITYWIDE,FA-0021,1000,0,0,0,0,200,800,0,1000,0,0,0,0,200,800,0,1000,0,0,0,0,400,1600,0,2000,,,BARRIER REPLACEMENT,cpd11-20cw.pdf
GEAN-2013,STREET LIGHTING ANNUAL CONSTRUCTION-FY14,841,DEPARTMENT OF TRANSPORTATION,INSTALLATION OF LAMPPOSTS AND LUMINAIRES,000,CITYWIDE,TF-0503,4000,4021,0,0,0,0,0,0,4021,4021,0,0,0,0,0,0,4021,8042,0,0,0,0,0,0,8042,PROJECT DELAYED DUE TO BUDGETARY CONSTRAINTS,,ST LIGHT ANNUAL CONSTRUCTION CONTRACT,cpd11-20cw.pdf
GEAN2017,STREET LIGHTING ANNUAL CONSTRUCTION -FY17,841,DEPARTMENT OF TRANSPORTATION,INSTALLATION OF LAMPPOSTS AND LUMINAIRES,000,CITYWIDE,TF-0503,7515,3565,0,0,0,0,0,0,3565,3565,0,0,0,0,0,0,3565,7130,0,0,0,0,0,0,7130,PROJECT DELAYED DUE TO BUDGETARY CONSTRAINTS,,INSTALLATION OF STREET LIGHT POLES,cpd11-20cw.pdf
GEAN2019,STREET LIGHTING ANNUAL CONSTRUCTION 2019,841,DEPARTMENT OF TRANSPORTATION,INSTALLATION OF LAMPPOSTS AND LUMINAIRES,000,CITYWIDE,TF-0503,8915,75,15,0,0,0,0,0,90,75,15,0,0,0,0,0,90,150,30,0,0,0,0,0,180,PROJECT DELAYED DUE TO BUDGETARY CONSTRAINTS,,"THIS CONTRACT IS FOR INSTALLING AND REMOVING EQUIPMENT FURNISHED BY THE CITY, OR BY THE",cpd11-20cw.pdf
GEHD-2013,HIGHWAY & PARK DISTRIBUTION FY14,841,DEPARTMENT OF TRANSPORTATION,REPLACEMENT OF ELECTRICAL DISTRIBUTION SYSTEMS,000,CITYWIDE,TF-0503,3000,1921,0,0,0,0,0,0,1921,1921,0,0,0,0,0,0,1921,3842,0,0,0,0,0,0,3842,PROJECT DELAYED DUE TO BUDGETARY CONSTRAINTS,,REPLACEMENT AND NEW DISTRIBUTION SYSTEM ON HIGHWAY AND IN PARKS,cpd11-20cw.pdf
GEHD2017,HIGHWAYS & PARKS DISTRIBUTION -FY17,841,DEPARTMENT OF TRANSPORTATION,REPLACEMENT OF ELECTRICAL DISTRIBUTION SYSTEMS,000,CITYWIDE,TF-0503,5000,1420,0,0,0,0,0,0,1420,1420,0,0,0,0,0,0,1420,2840,0,0,0,0,0,0,2840,PROJECT DELAYED DUE TO BUDGETARY CONSTRAINTS,,HIGHWAYS/PARKS DISTRIBUTION CITYWIDE,cpd11-20cw.pdf
HB1014GP,Build-Out Cost for Greenpoint Yard New Trailers,841,DEPARTMENT OF TRANSPORTATION,BRIDGE FACILITIES,000,CITYWIDE,HW-0003,847,0,847,0,0,0,0,0,847,0,847,0,0,0,0,0,847,0,1694,0,0,0,0,0,1694,PROJECT DELAYED DUE TO BUDGETARY CONSTRAINTS,BUILD-OUT COST FOR GREENPOINT YARD NEW TRAILERS,BUILD-OUT COST FOR GREENPOINT YARD NEW TRAILERS,cpd11-20cw.pdf
HB1070ST,PROTECTIVE COATING OF VARIOUS BRIDGES IN STATEN ISLAND,841,DEPARTMENT OF TRANSPORTATION,Bridge Painting,000,CITYWIDE,HB-1070,13650,10698,0,0,0,3255,0,0,13953,10698,0,0,0,3255,0,0,13953,21396,0,0,0,6510,0,0,27906,,,PROTECTIVE COATING OF VARIOUS BRIDGES IN QUEENS & STATEN ISLAND,cpd11-20cw.pdf
HB-BIDSAD,ADVERTISEMENT FOR CAPITAL BRIDGE PROJECTS,841,DEPARTMENT OF TRANSPORTATION,BRIDGE LIFE EXTENSION AND MISCELLANEOUS WORK,000,CITYWIDE,HB-0215,1425,679,0,0,0,102,0,0,781,679,0,0,0,102,0,0,781,1358,0,0,0,204,0,0,1562,PROJECT DELAYED DUE TO BUDGETARY CONSTRAINTS,CITYWIDE,ADVERTISEMENT FOR CAPITAL PROJECTS,cpd11-20cw.pdf
HBC1070,BRIDGE PROTECTIVE COATING,841,DEPARTMENT OF TRANSPORTATION,Bridge Painting,000,CITYWIDE,HB-1070,206749,0,0,10000,10000,65831,32000,128919,246750,0,0,10000,10000,65831,32000,128919,246750,0,0,20000,20000,131662,64000,257838,493500,PROJECT DELAYED DUE TO BUDGETARY CONSTRAINTS,PAINTING FOR VARIOUS BRIDGES CITYWIDE,"PAINTING AND PROTECTIVE TREATMENT FOR VARIOUS BRIDGES, FUNDING IS ALL",cpd11-20cw.pdf
HBC10YR20,BRIDGE 10 YEAR PLAN FY 2020,841,DEPARTMENT OF TRANSPORTATION,BRIDGE LIFE EXTENSION AND MISCELLANEOUS WORK,000,CITYWIDE,HB-0215 HB-1189,136773,0,0,12110,55652,116958,141660,1123600,1449980,0,0,12110,55652,116958,141660,1123600,1449980,0,0,24220,111304,233916,283320,2247200,2899960,PROJECT DELAYED DUE TO BUDGETARY CONSTRAINTS,BRIDGE 10 YEAR PLAN FY 2020,BRIDGE 10 YEAR PLAN FY 2020,cpd11-20cw.pdf
HBCD0011A,IN-PROCESS FAB INSPECTION STRUCTURAL STEEL IN NE USA,841,DEPARTMENT OF TRANSPORTATION,BRIDGE LIFE EXTENSION AND MISCELLANEOUS WORK,000,CITYWIDE,HB-1012,12383,0,12383,0,0,0,0,0,12383,0,12383,0,0,0,0,0,12383,0,24766,0,0,0,0,0,24766,,IN-PROCESS FAB INSPECTION STRUCTURAL STEEL IN NE USA,IN-PROCESS FAB INSPECTION STRUCTURAL STEEL IN NE USA,cpd11-20cw.pdf
HBCD0011B,IN-PROCESS FAB INSPECTION OF STRUCTURAL STEEL IN US/CAN,841,DEPARTMENT OF TRANSPORTATION,BRIDGE LIFE EXTENSION AND MISCELLANEOUS WORK,000,CITYWIDE,HB-1012,6756,0,6756,0,0,0,0,0,6756,0,6756,0,0,0,0,0,6756,0,13512,0,0,0,0,0,13512,,IN-PROCESS FAB INSPECTION OF STRUCTURAL STEEL IN US/CAN,IN-PROCESS FAB INSPECTION OF STRUCTURAL STEEL IN US/CAN,cpd11-20cw.pdf
HBCD0011C,IN-PROCESS FAB INSPECTION OF PP CONCRETE IN NE USA,841,DEPARTMENT OF TRANSPORTATION,BRIDGE LIFE EXTENSION AND MISCELLANEOUS WORK,000,CITYWIDE,HB-1012,3165,0,3796,0,0,0,0,0,3796,0,3796,0,0,0,0,0,3796,0,7592,0,0,0,0,0,7592,,IN-PROCESS FAB INSPECTION OF PP CONCRETE IN NE USA,IN-PROCESS FAB INSPECTION OF PP CONCRETE IN NE USA,cpd11-20cw.pdf
HBCD0012,TESTING AND SAMPLING OF MATERIAL (CITYWIDE),841,DEPARTMENT OF TRANSPORTATION,BRIDGE LIFE EXTENSION AND MISCELLANEOUS WORK,000,CITYWIDE,HB-1012,10876,0,5000,0,0,0,0,0,5000,0,5000,0,0,0,0,0,5000,0,10000,0,0,0,0,0,10000,,TESTING AND SAMPLING OF MATERIAL (CITYWIDE),TESTING AND SAMPLING OF MATERIAL (CITYWIDE),cpd11-20cw.pdf
HBCD006P,Citywide Inspection/Monitoring of Bridge Paint Removal&Appli,841,DEPARTMENT OF TRANSPORTATION,BRIDGE LIFE EXTENSION AND MISCELLANEOUS WORK,000,CITYWIDE,HB-1070,3465,0,2730,0,0,0,0,0,2730,0,2730,0,0,0,0,0,2730,0,5460,0,0,0,0,0,5460,,"QUALITY ASSURANCE CONTRACT (PAINT, CHEMICAL TEST, FAILURE)","QUALITY ASSURANCE CONTRACT (PAINT, CHEMICAL TEST, FAILURE)",cpd11-20cw.pdf
HBCD007P,Citywide Inspection/Monitoring of Bridge Paint Removal & App,841,DEPARTMENT OF TRANSPORTATION,BRIDGE LIFE EXTENSION AND MISCELLANEOUS WORK,000,CITYWIDE,HB-1070,2711,0,0,0,2711,0,0,0,2711,0,0,0,2711,0,0,0,2711,0,0,0,5422,0,0,0,5422,,CITYWIDE INSPECTION/MONITORING OF BRIDGE PAINT REMOVAL & APP,CITYWIDE INSPECTION/MONITORING OF BRIDGE PAINT REMOVAL & APP,cpd11-20cw.pdf
HBCD008P,Citywide Inspection/Monitoring of Bridge Paint Removal & App,841,DEPARTMENT OF TRANSPORTATION,BRIDGE LIFE EXTENSION AND MISCELLANEOUS WORK,000,CITYWIDE,HB-1070,3050,0,0,0,0,0,0,3050,3050,0,0,0,0,0,0,3050,3050,0,0,0,0,0,0,6100,6100,PROJECT DELAYED DUE TO BUDGETARY CONSTRAINTS,CITYWIDE INSPECTION/MONITORING OF BRIDGE PAINT REMOVAL AND APPLICATION,CITYWIDE INSPECTION/MONITORING OF BRIDGE PAINT REMOVAL & APP,cpd11-20cw.pdf
HBCD013,Inspection Services at Concrete & Asphalt Plants,841,DEPARTMENT OF TRANSPORTATION,BRIDGE LIFE EXTENSION AND MISCELLANEOUS WORK,000,CITYWIDE,HB-1012,5200,0,0,0,3400,0,0,0,3400,0,0,0,3400,0,0,0,3400,0,0,0,6800,0,0,0,6800,PROJECT DELAYED DUE TO BUDGETARY CONSTRAINTS,INSPECTION SERVICES AT CONCRETE & ASPHALT PLANTS,INSPECTION SERVICES AT CONCRETE & ASPHALT PLANTS,cpd11-20cw.pdf
HBCD013A,IN-PROCESS FAB INSPECTION OF STRUCTURAL STEEL IN NE US,841,DEPARTMENT OF TRANSPORTATION,BRIDGE LIFE EXTENSION AND MISCELLANEOUS WORK,000,CITYWIDE,HB-1012,12386,0,0,0,0,12386,0,0,12386,0,0,0,0,12386,0,0,12386,0,0,0,0,24772,0,0,24772,,IN-PROCESS FAB INSPECTION OF STRUCTURAL STEEL IN NE US,IN-PROCESS FAB INSPECTION OF STRUCTURAL STEEL IN NE US,cpd11-20cw.pdf
HBCD013B,IN-PROCESS FAB INSPECTION OF STRUCTURAL STEEL IN US,841,DEPARTMENT OF TRANSPORTATION,BRIDGE LIFE EXTENSION AND MISCELLANEOUS WORK,000,CITYWIDE,HB-1012,6756,0,0,0,0,6756,0,0,6756,0,0,0,0,6756,0,0,6756,0,0,0,0,13512,0,0,13512,,IN-PROCESS FAB INSPECTION OF STRUCTURAL STEEL IN US,IN-PROCESS FAB INSPECTION OF STRUCTURAL STEEL IN US,cpd11-20cw.pdf
HBCD013C,IN-PROCESS FAB INSPECTION OF PP CONCRETE IN USA/CAN,841,DEPARTMENT OF TRANSPORTATION,BRIDGE LIFE EXTENSION AND MISCELLANEOUS WORK,000,CITYWIDE,HB-1012,3165,0,0,0,0,3165,0,0,3165,0,0,0,0,3165,0,0,3165,0,0,0,0,6330,0,0,6330,,IN-PROCESS FAB INSPECTION OF PP CONCRETE IN USA/CAN,IN-PROCESS FAB INSPECTION OF PP CONCRETE IN USA/CAN,cpd11-20cw.pdf
HBCD014,Testing and Sampling of Material (Citywide),841,DEPARTMENT OF TRANSPORTATION,BRIDGE LIFE EXTENSION AND MISCELLANEOUS WORK,000,CITYWIDE,HB-1012,11301,0,0,0,0,11301,0,0,11301,0,0,0,0,11301,0,0,11301,0,0,0,0,22602,0,0,22602,,TESTING AND SAMPLING OF MATERIAL (CITYWIDE),TESTING AND SAMPLING OF MATERIAL (CITYWIDE),cpd11-20cw.pdf
HBCD015,INSPECTION SERVICES AT CONCRETE & ASPHALT PLANTS,841,DEPARTMENT OF TRANSPORTATION,BRIDGE LIFE EXTENSION AND MISCELLANEOUS WORK,000,CITYWIDE,HB-1012,5400,0,0,0,0,0,0,5400,5400,0,0,0,0,0,0,5400,5400,0,0,0,0,0,0,10800,10800,PROJECT DELAYED DUE TO BUDGETARY CONSTRAINTS,TESTING AND SAMPLING OF MATERIAL (CITYWIDE),TESTING AND SAMPLING OF MATERIAL (CITYWIDE),cpd11-20cw.pdf
HBCD015A,IN-PROCESS FAB INSPECTION OF STRUCTURAL STEEL IN NE USA,841,DEPARTMENT OF TRANSPORTATION,BRIDGE LIFE EXTENSION AND MISCELLANEOUS WORK,000,CITYWIDE,HB-1012,12383,0,0,0,0,0,0,12767,12767,0,0,0,0,0,0,12767,12767,0,0,0,0,0,0,25534,25534,,IN-PROCESS FAB INSPECTION OF STRUCTURAL STEEL IN NE USA,IN-PROCESS FAB INSPECTION OF STRUCTURAL STEEL IN NE USA,cpd11-20cw.pdf
HBCD015B,IN-PROCESS FAB INSPECTION OF STRUCTURAL STEEL IN US/CAN,841,DEPARTMENT OF TRANSPORTATION,BRIDGE LIFE EXTENSION AND MISCELLANEOUS WORK,000,CITYWIDE,HB-1012,6756,0,0,0,0,0,0,6965,6965,0,0,0,0,0,0,6965,6965,0,0,0,0,0,0,13930,13930,,IN-PROCESS FAB INSPECTION OF STRUCTURAL STEEL IN US/CAN,IN-PROCESS FAB INSPECTION OF STRUCTURAL STEEL IN US/CAN,cpd11-20cw.pdf
HBCD015C,IN-PROCESS FAB INSPECTION OF PP CONCRETE IN USA/CAN,841,DEPARTMENT OF TRANSPORTATION,BRIDGE LIFE EXTENSION AND MISCELLANEOUS WORK,000,CITYWIDE,HB-1012,3165,0,0,0,0,0,0,3263,3263,0,0,0,0,0,0,3263,3263,0,0,0,0,0,0,6526,6526,PROJECT DELAYED DUE TO BUDGETARY CONSTRAINTS,IN-PROCESS FAB INSPECTION OF PP CONCRETE IN USA/CAN,IN-PROCESS FAB INSPECTION OF PP CONCRETE IN USA/CAN,cpd11-20cw.pdf
HBCD016,TESTING AND SAMPLING OF MATERIAL (CITYWIDE),841,DEPARTMENT OF TRANSPORTATION,BRIDGE LIFE EXTENSION AND MISCELLANEOUS WORK,000,CITYWIDE,HB-1012,12802,0,0,0,0,0,0,12802,12802,0,0,0,0,0,0,12802,12802,0,0,0,0,0,0,25604,25604,PROJECT DELAYED DUE TO BUDGETARY CONSTRAINTS,TESTING AND SAMPLING OF MATERIAL (CITYWIDE),TESTING AND SAMPLING OF MATERIAL (CITYWIDE),cpd11-20cw.pdf
HBCR02B,COMPONENT REHABILITATION 02B CONSTRUCTION,841,DEPARTMENT OF TRANSPORTATION,BRIDGE LIFE EXTENSION AND MISCELLANEOUS WORK,000,CITYWIDE,HB-0215,10595,35176,1911,430,0,0,0,0,37517,35176,1911,430,0,0,0,0,37517,70352,3822,860,0,0,0,0,75034,PROJECT DELAYED DUE TO BUDGETARY CONSTRAINTS,COMP REHAB 02B CONS,COMP REHAB 02B CONS,cpd11-20cw.pdf
HBCR03A,COMPONENT REHABILITATION 03A CONSTRUCTION,841,DEPARTMENT OF TRANSPORTATION,BRIDGE LIFE EXTENSION AND MISCELLANEOUS WORK,000,CITYWIDE,HB-0215,11070,36415,850,1318,0,0,0,0,38583,36415,850,1318,0,0,0,0,38583,72830,1700,2636,0,0,0,0,77166,PROJECT DELAYED DUE TO BUDGETARY CONSTRAINTS,COMP REHAB CONS,COMP REHAB CONS,cpd11-20cw.pdf
HBCR03B,COMPONENT REHABILITATION 03B CONSTRUCTION,841,DEPARTMENT OF TRANSPORTATION,BRIDGE LIFE EXTENSION AND MISCELLANEOUS WORK,000,CITYWIDE,HB-0215,12120,3498,4284,29654,0,0,0,0,37436,3498,4284,29654,0,0,0,0,37436,6996,8568,59308,0,0,0,0,74872,PROJECT DELAYED DUE TO BUDGETARY CONSTRAINTS,COMP REHAB 03B CONST,COMP REHAB 03B CONST,cpd11-20cw.pdf
HBCR16,COMPONENT REHAB OF BRIDGES CITYWIDE (8 BRIDGES),841,DEPARTMENT OF TRANSPORTATION,BRIDGE LIFE EXTENSION AND MISCELLANEOUS WORK,000,CITYWIDE,HB-0215,10724,3124,21772,0,0,0,0,0,24896,3124,21772,0,0,0,0,0,24896,6248,43544,0,0,0,0,0,49792,,COMPONENT REHAB OF BRIDGES CITYWIDE (8 BRIDGES),COMPONENT REHAB OF BRIDGES CITYWIDE (8 BRIDGES),cpd11-20cw.pdf
HBCR21A,COMPONENT REHAB OF BRIDGES 21A,841,DEPARTMENT OF TRANSPORTATION,BRIDGE LIFE EXTENSION AND MISCELLANEOUS WORK,000,CITYWIDE,HB-0215,21550,2939,0,19238,0,0,0,0,22177,2939,0,19238,0,0,0,0,22177,5878,0,38476,0,0,0,0,44354,PROJECT DELAYED DUE TO BUDGETARY CONSTRAINTS,CONVERSION DATA- DESCRIPTION REQUIRED,COMPONENT REHAB OF BRIDGES 21A,cpd11-20cw.pdf
HBCR21B,COMPONENT REHAB OF BRIDGES 21B,841,DEPARTMENT OF TRANSPORTATION,BRIDGE LIFE EXTENSION AND MISCELLANEOUS WORK,000,CITYWIDE,HB-0215,19234,2172,0,21139,0,0,0,0,23311,2172,0,21139,0,0,0,0,23311,4344,0,42278,0,0,0,0,46622,PROJECT DELAYED DUE TO BUDGETARY CONSTRAINTS,COMPONENT REHAB OF BRIDGES 21B,COMPONENT REHAB OF BRIDGES 21B,cpd11-20cw.pdf
HBCR22A,COMPONENT REHAB OF BRIDGES 22A,841,DEPARTMENT OF TRANSPORTATION,BRIDGE LIFE EXTENSION AND MISCELLANEOUS WORK,000,CITYWIDE,HB-0215,21695,2370,0,0,0,21091,0,0,23461,2370,0,0,0,21091,0,0,23461,4740,0,0,0,42182,0,0,46922,PROJECT DELAYED DUE TO BUDGETARY CONSTRAINTS,COMPONENT REHAB,COMPONENT REHAB OF BRIDGES,cpd11-20cw.pdf
HBCR22B,COMPONENT REHAB OF BRIDGES 22B,841,DEPARTMENT OF TRANSPORTATION,BRIDGE LIFE EXTENSION AND MISCELLANEOUS WORK,000,CITYWIDE,HB-0215,19530,2315,0,0,0,19048,0,0,21363,2315,0,0,0,19048,0,0,21363,4630,0,0,0,38096,0,0,42726,PROJECT DELAYED DUE TO BUDGETARY CONSTRAINTS,COMPONENT REHAB OF BRIDGES 22B,COMPONENT REHAB OF BRIDGES 22B,cpd11-20cw.pdf
HBCR23A,COMPONENT REHAB OF BRIDGES 23A,841,DEPARTMENT OF TRANSPORTATION,FINANCING COSTS,000,CITYWIDE,HB-0215,22345,112,2133,0,0,22639,0,0,24884,112,2133,0,0,22639,0,0,24884,224,4266,0,0,45278,0,0,49768,,,COMPONENT REHAB OF BRIDGES 23A,cpd11-20cw.pdf
HBCR23B,COMPONENT REHAB OF BRIDGES 23B,841,DEPARTMENT OF TRANSPORTATION,BRIDGE LIFE EXTENSION AND MISCELLANEOUS WORK,000,CITYWIDE,HB-0215,22345,0,1910,0,0,20435,0,0,22345,0,1910,0,0,20435,0,0,22345,0,3820,0,0,40870,0,0,44690,PROJECT DELAYED DUE TO BUDGETARY CONSTRAINTS,,COMPONENT REHAB OF BRIDGES 23B,cpd11-20cw.pdf
HBCR24A,COMPONENT REHAB OF BRIDGES 24A,841,DEPARTMENT OF TRANSPORTATION,BRIDGE LIFE EXTENSION AND MISCELLANEOUS WORK,000,CITYWIDE,HB-0215,23020,0,0,1970,0,0,21050,0,23020,0,0,1970,0,0,21050,0,23020,0,0,3940,0,0,42100,0,46040,PROJECT DELAYED DUE TO BUDGETARY CONSTRAINTS,COMPONENT REHAB OF BRIDGES 24A,COMPONENT REHAB OF BRIDGES 24A,cpd11-20cw.pdf
HBCR24B,COMPONENT REHAB OF BRIDGES 24B,841,DEPARTMENT OF TRANSPORTATION,BRIDGE LIFE EXTENSION AND MISCELLANEOUS WORK,000,CITYWIDE,HB-0215,20725,0,0,1970,0,0,18755,0,20725,0,0,1970,0,0,18755,0,20725,0,0,3940,0,0,37510,0,41450,PROJECT DELAYED DUE TO BUDGETARY CONSTRAINTS,COMPONENT REHAB OF BRIDGES 24B,COMPONENT REHAB OF BRIDGES 24B,cpd11-20cw.pdf
HBKBQE,Rehabilitation of BQE (I-278) from Sands St. to Atlantic Ave,841,DEPARTMENT OF TRANSPORTATION,FAIR BRIDGES,000,CITYWIDE,HB-0278 P-0508 HB-1012,1901292,199578,10000,109499,173422,398221,71303,937078,1899101,199578,10000,109499,173422,398221,71303,937078,1899101,399156,20000,218998,346844,796442,142606,1874156,3798202,,21 BINS,21 BINS,cpd11-20cw.pdf
HBR10COMP,TEN YR COMP,841,DEPARTMENT OF TRANSPORTATION,BRIDGE LIFE EXTENSION AND MISCELLANEOUS WORK,000,CITYWIDE,HB-0215,43020,0,0,450,0,95228,50000,200000,345678,0,0,450,0,95228,50000,200000,345678,0,0,900,0,190456,100000,400000,691356,PROJECT DELAYED DUE TO BUDGETARY CONSTRAINTS,,,cpd11-20cw.pdf
HBREP6919,Emergency Contract for 181st (Washington Bridge) over Harlem,841,DEPARTMENT OF TRANSPORTATION,FAIR BRIDGES,000,CITYWIDE,HB-0215,25918,0,25368,0,0,0,0,0,25368,0,25368,0,0,0,0,0,25368,0,50736,0,0,0,0,0,50736,PROJECT DELAYED DUE TO BUDGETARY CONSTRAINTS,EMERGENCY CONTRACT FOR 181ST (WASHINGTON BRIDGE) OVER HARLEM RIVER,EMERGENCY CONTRACT FOR 181ST (WASHINGTON BRIDGE) OVER HARLEM RIVER,cpd11-20cw.pdf
HBX1670,EAST 169TH STREET OVER METRO NORTH RR BIN,841,DEPARTMENT OF TRANSPORTATION,BRIDGE LIFE EXTENSION AND MISCELLANEOUS WORK,000,CITYWIDE,HB-1070 HB-0167 TF-0002 TF-0502,7265,3825,4407,5091,0,0,0,0,13323,3825,4407,5091,0,0,0,0,13323,7650,8814,10182,0,0,0,0,26646,,,EAST 169TH STREET OVER METRO NORTH RR ÝBIN,cpd11-20cw.pdf
HW200IFA1,In-House Pedestrian Ramp Rehabilitation - Crews,841,DEPARTMENT OF TRANSPORTATION,PEDESTRIAN RAMP CONSTRUCTION,000,CITYWIDE,HW-0200,19402,41472,16500,24365,28351,39969,39969,190591,381217,41472,16500,24365,28351,39969,39969,190591,381217,82944,33000,48730,56702,79938,79938,381182,762434,PROJECT DELAYED DUE TO BUDGETARY CONSTRAINTS,IN-HOUSE PEDESTRIAN RAMP REHABILITATION - CREWS,IN-HOUSE PEDESTRIAN RAMP REHABILITATION - CREWS,cpd11-20cw.pdf
HW200IFA2,In-House Pedestrian Ramp Rehabilitation - OTPS,841,DEPARTMENT OF TRANSPORTATION,PEDESTRIAN RAMP CONSTRUCTION,000,CITYWIDE,HW-0200,24888,20335,9472,14310,16651,6535,6535,28672,102510,20335,9472,14310,16651,6535,6535,28672,102510,40670,18944,28620,33302,13070,13070,57344,205020,PROJECT DELAYED DUE TO BUDGETARY CONSTRAINTS,IN-HOUSE PEDESTRIAN RAMP REHABILITATION - OTPS,IN-HOUSE PEDESTRIAN RAMP REHABILITATION - OTPS,cpd11-20cw.pdf
HW2CR06,CITYWIDE MILLING,841,DEPARTMENT OF TRANSPORTATION,PRIMARY STREET RESURFACING,099,CITYWIDE,HW-0002M,125195,0,0,10670,9837,8394,8671,37712,75284,0,0,10670,9837,8394,8671,37712,75284,0,0,21340,19674,16788,17342,75424,150568,PROJECT DELAYED DUE TO BUDGETARY CONSTRAINTS,N/A,,cpd11-20cw.pdf
HW34907,IN-HOUSE RESURFACING - CREWS&OTHER NON-ASPHALT OTPS,841,DEPARTMENT OF TRANSPORTATION,PRIMARY STREET RESURFACING,099,CITYWIDE,HW-0349,891282,1318166,149818,82314,83921,86627,89420,388900,2199166,1318166,149818,82314,83921,86627,89420,388900,2199166,2636332,299636,164628,167842,173254,178840,777800,4398332,PROJECT DELAYED DUE TO BUDGETARY CONSTRAINTS,,,cpd11-20cw.pdf
HWC349M03,MANHOLE RINGS,841,DEPARTMENT OF TRANSPORTATION,PRIMARY STREET RESURFACING,000,CITYWIDE,HW-0349,8370,647,0,2124,500,517,534,2322,6644,647,0,2124,500,517,534,2322,6644,1294,0,4248,1000,1034,1068,4644,13288,PROJECT DELAYED DUE TO BUDGETARY CONSTRAINTS,,,cpd11-20cw.pdf
HWCFTRLR,Citywide Trailer Rehabilitation,841,DEPARTMENT OF TRANSPORTATION,FACILITY RECONSTRUCTION,000,CITYWIDE,HB-1014 HW-0003,3169,2332,2462,0,0,0,0,0,4794,2332,2462,0,0,0,0,0,4794,4664,4924,0,0,0,0,0,9588,PROJECT DELAYED DUE TO BUDGETARY CONSTRAINTS,,CITYWIDE TRAILER REHABILITATION,cpd11-20cw.pdf
HWC-HDBP,High-Density Bike Parking,841,DEPARTMENT OF TRANSPORTATION,PRIMARY STREET RECONSTRUCTION,000,CITYWIDE,HW-0001,2800,0,0,0,0,0,0,2800,2800,0,0,0,0,0,0,2800,2800,0,0,0,0,0,0,5600,5600,PROJECT DELAYED DUE TO BUDGETARY CONSTRAINTS,HIGH-DENSITY BIKE PARKING,HIGH-DENSITY BIKE PARKING,cpd11-20cw.pdf
HWCPDLOC2,Perimeter Security Measures 2,841,DEPARTMENT OF TRANSPORTATION,PRIMARY STREET RECONSTRUCTION,000,CITYWIDE,HW-0001,70000,0,0,0,0,0,0,65342,65342,0,0,0,0,0,0,65342,65342,0,0,0,0,0,0,130684,130684,PROJECT DELAYED DUE TO BUDGETARY CONSTRAINTS,PERIMETER SECURITY MEASURES 2,PERIMETER SECURITY MEASURES 2,cpd11-20cw.pdf
HWCWREC,CITYWIDE RECONSTRUCTION OF STREETS,841,DEPARTMENT OF TRANSPORTATION,PRIMARY STREET RECONSTRUCTION,099,CITYWIDE,HW-0001 HW-0001Q,546260,0,9000,0,0,1707,30773,6203,47683,0,9000,0,0,1707,30773,6203,47683,0,18000,0,0,3414,61546,12406,95366,PROJECT DELAYED DUE TO BUDGETARY CONSTRAINTS,NA,,cpd11-20cw.pdf
HWCW-SOGR,Citywide Streets - 30-Year State of Good Repair,841,DEPARTMENT OF TRANSPORTATION,PRIMARY STREET RECONSTRUCTION,,CITYWIDE,HW-0001 HW-1684,49250,0,0,0,0,0,0,9739,9739,0,0,0,0,0,0,9739,9739,0,0,0,0,0,0,19478,19478,PROJECT DELAYED DUE TO BUDGETARY CONSTRAINTS,CITYWIDE,FY13 JAN PLAN SUPPLEMENTAL REQUEST - CITYWIDE RECONSTRUCTION OF PRIMARY STREETS TO A,cpd11-20cw.pdf
HWCW-VZSR,Vision Zero Street Reconstuction,841,DEPARTMENT OF TRANSPORTATION,PRIMARY STREET RECONSTRUCTION,000,CITYWIDE,HW-0001,272324,0,0,0,0,0,0,1655,1655,0,0,0,0,0,0,1655,1655,0,0,0,0,0,0,3310,3310,PROJECT DELAYED DUE TO BUDGETARY CONSTRAINTS,,VISION ZERO STREET RECONSTUCTION,cpd11-20cw.pdf
HWMMPEDSW,MULTI-MODAL #2 - 2000 PED RAMPS AND SIDEWALK,841,DEPARTMENT OF TRANSPORTATION,SIDEWALK RECONSTRUCTION,000,CITYWIDE,HW-0200,260,0,0,0,0,0,0,0,0,0,0,0,0,0,0,0,0,0,0,0,0,0,0,0,0,PROJECT DELAYED DUE TO BUDGETARY CONSTRAINTS,MULTI-MODAL #2 - 2000 PED RAMPS AND SIDEWALK,MULTI-MODAL #2 - 2000 PED RAMPS AND SIDEWALK,cpd11-20cw.pdf
HWP19MKLM,COMPLEX PED RAMPS (LANDMARK) - MANHATTAN AND BROOKLYN,841,DEPARTMENT OF TRANSPORTATION,PEDESTRIAN RAMP CONSTRUCTION,000,CITYWIDE,HW-0200,5901,0,0,0,0,5901,0,0,5901,0,0,0,0,5901,0,0,5901,0,0,0,0,11802,0,0,11802,PROJECT DELAYED DUE TO BUDGETARY CONSTRAINTS,COMPLEX PED RAMPS (LANDMARK) - MANHATTAN AND BROOKLYN,COMPLEX PED RAMPS (LANDMARK) - MANHATTAN AND BROOKLYN,cpd11-20cw.pdf
HWP19MXLM,COMPLEX PED RAMPS (LANDMARK) - MANHATTAN AND BRONX,841,DEPARTMENT OF TRANSPORTATION,PEDESTRIAN RAMP CONSTRUCTION,000,CITYWIDE,HW-0200,3139,0,0,0,0,3139,0,0,3139,0,0,0,0,3139,0,0,3139,0,0,0,0,6278,0,0,6278,PROJECT DELAYED DUE TO BUDGETARY CONSTRAINTS,COMPLEX PED RAMPS (LANDMARK) - MANHATTAN AND BRONX,CITYWIDE COMPLEX PED RAMPS (LANDMARK) - MANHATTAN AND BRONX,cpd11-20cw.pdf
HWPDRAPS,Pedestrian Ramps - Required APS add on,841,DEPARTMENT OF TRANSPORTATION,PEDESTRIAN RAMP CONSTRUCTION,000,CITYWIDE,TF-0001,79680,0,0,7080,0,18990,11910,0,37980,0,0,7080,0,18990,11910,0,37980,0,0,14160,0,37980,23820,0,75960,PROJECT DELAYED DUE TO BUDGETARY CONSTRAINTS,PEDESTRIAN RAMPS - REQUIRED APS ADD ON,PEDESTRIAN RAMPS - REQUIRED APS ADD ON,cpd11-20cw.pdf
HWPDRFORC,Pedestrian Ramps - Force Account,841,DEPARTMENT OF TRANSPORTATION,PEDESTRIAN RAMP CONSTRUCTION,000,CITYWIDE,HW-0200,3196,0,0,0,684,0,0,0,684,0,0,0,684,0,0,0,684,0,0,0,1368,0,0,0,1368,PROJECT DELAYED DUE TO BUDGETARY CONSTRAINTS,PEDESTRIAN RAMPS - FORCE ACCOUNT,PEDESTRIAN RAMPS - FORCE ACCOUNT,cpd11-20cw.pdf
HWPDRTREE,Pedestrian Ramps - Tree Replacement,841,DEPARTMENT OF TRANSPORTATION,PEDESTRIAN RAMP CONSTRUCTION,000,CITYWIDE,HW-0200,3199,0,0,0,0,1566,0,0,1566,0,0,0,0,1566,0,0,1566,0,0,0,0,3132,0,0,3132,PROJECT DELAYED DUE TO BUDGETARY CONSTRAINTS,PEDESTRIAN RAMPS - TREE REPLACEMENT,PEDESTRIAN RAMPS - TREE REPLACEMENT,cpd11-20cw.pdf
HWPELIMLM,REPACKAGED COMPLEX PED RAMP INSTALL LANDMARK,841,DEPARTMENT OF TRANSPORTATION,PEDESTRIAN RAMP CONSTRUCTION,,CITYWIDE,HW-0200,3635,0,455,0,0,3180,0,0,3635,0,455,0,0,3180,0,0,3635,0,910,0,0,6360,0,0,7270,PROJECT DELAYED DUE TO BUDGETARY CONSTRAINTS,COMPLEX PED RAMP INSTALLS,REPACKED CORNERS,cpd11-20cw.pdf
HWPELIMMX,Repacked Complex Ped Ramps Installs - Manhattan & Bronx,841,DEPARTMENT OF TRANSPORTATION,PEDESTRIAN RAMP CONSTRUCTION,000,CITYWIDE,HW-0200,5268,0,0,0,0,5268,0,0,5268,0,0,0,0,5268,0,0,5268,0,0,0,0,10536,0,0,10536,PROJECT DELAYED DUE TO BUDGETARY CONSTRAINTS,,REPACKED CORNERS,cpd11-20cw.pdf
HWPELIMQR,"Repacked Complex Ped Ramp Installs - Queens, Mnhn, & SI",841,DEPARTMENT OF TRANSPORTATION,PEDESTRIAN RAMP CONSTRUCTION,,CITYWIDE,HW-0200,4853,0,0,0,0,4853,0,0,4853,0,0,0,0,4853,0,0,4853,0,0,0,0,9706,0,0,9706,PROJECT DELAYED DUE TO BUDGETARY CONSTRAINTS,"COMPLEX PED RAMP INSTALLS - QUEENS, MANHATTAN, & BRONX",REPACKED CORNERS,cpd11-20cw.pdf
HWPELIMTA,Repacked Complex Ped Ramps (TA),841,DEPARTMENT OF TRANSPORTATION,PEDESTRIAN RAMP CONSTRUCTION,000,CITYWIDE,HW-0200,6612,0,0,0,0,6612,0,0,6612,0,0,0,0,6612,0,0,6612,0,0,0,0,13224,0,0,13224,PROJECT DELAYED DUE TO BUDGETARY CONSTRAINTS,COMPLEX PED RAMP INSTALLS (TA),REPACKED CORNERS,cpd11-20cw.pdf
HWPL20006,PRIOR NOTICE SIDEWALK(SIM),841,DEPARTMENT OF TRANSPORTATION,SIDEWALK RECONSTRUCTION,000,CITYWIDE,P-1331 HW-0200 P-1018,180000,0,-9157,24806,0,65777,32938,160119,274483,0,-9157,24806,0,65777,32938,160119,274483,0,-18314,49612,0,131554,65876,320238,548966,PROJECT DELAYED DUE TO BUDGETARY CONSTRAINTS,,,cpd11-20cw.pdf
HWPLZ015Q,Ozone Park Plaza,841,DEPARTMENT OF TRANSPORTATION,PRIMARY STREET RECONSTRUCTION,000,CITYWIDE,HW-1684,3000,0,0,0,0,0,8717,0,8717,0,0,0,0,0,8717,0,8717,0,0,0,0,0,17434,0,17434,PROJECT DELAYED DUE TO BUDGETARY CONSTRAINTS,OZONE PARK PLAZA,OZONE PARK PLAZA,cpd11-20cw.pdf
HWPRINSTL,Pedestrian Ramps Installation - Lump Sum,841,DEPARTMENT OF TRANSPORTATION,PEDESTRIAN RAMP CONSTRUCTION,000,CITYWIDE,HW-0200,40000,0,3185,0,0,47551,20000,89266,160002,0,3185,0,0,47551,20000,89266,160002,0,6370,0,0,95102,40000,178532,320004,PROJECT DELAYED DUE TO BUDGETARY CONSTRAINTS,PEDESTRIAN RAMPS INSTALLATION - LUMP SUM,PEDESTRIAN RAMPS INSTALLATION - LUMP SUM,cpd11-20cw.pdf
HWPRREHAB,Pedestrian Ramps Rehabilitation - Lump Sum,841,DEPARTMENT OF TRANSPORTATION,PEDESTRIAN RAMP CONSTRUCTION,000,CITYWIDE,HW-0200,75074,0,-11585,0,0,81503,41297,202974,314189,0,-11585,0,0,81503,41297,202974,314189,0,-23170,0,0,163006,82594,405948,628378,PROJECT DELAYED DUE TO BUDGETARY CONSTRAINTS,PEDESTRIAN RAMPS REHABILITATION,PEDESTRIAN RAMPS REHABILITATION - LUMP SUM,cpd11-20cw.pdf
HWRAP07,RAP HAULING,841,DEPARTMENT OF TRANSPORTATION,PRIMARY STREET RESURFACING,000,CITYWIDE,HW-0349,74651,74134,6424,6552,6684,6905,7132,31001,138832,74134,6424,6552,6684,6905,7132,31001,138832,148268,12848,13104,13368,13810,14264,62002,277664,PROJECT DELAYED DUE TO BUDGETARY CONSTRAINTS,RAP HAULING,RAP HAULING,cpd11-20cw.pdf
HWS2021XM,PRIOR NOTICE SIDEWALK - BRONX & MANHATTAN,841,DEPARTMENT OF TRANSPORTATION,SIDEWALK RECONSTRUCTION,000,CITYWIDE,HW-0200 P-1331,3941,0,2985,0,0,0,0,0,2985,0,2985,0,0,0,0,0,2985,0,5970,0,0,0,0,0,5970,,PRIOR NOTICE SIDEWALK - CITYWIDE - BRONX AND MANHATTAN,PRIOR NOTICE SIDEWALK - CITYWIDE - BRONX AND MANHATTAN,cpd11-20cw.pdf
HWSAFTR,Safe Routes to Transit,841,DEPARTMENT OF TRANSPORTATION,PRIMARY STREET RECONSTRUCTION,000,CITYWIDE,HW-0988,16058,0,0,0,0,0,0,14382,14382,0,0,0,0,0,0,14382,14382,0,0,0,0,0,0,28764,28764,PROJECT DELAYED DUE TO BUDGETARY CONSTRAINTS,,SAFE ROUTES TO TRANSIT,cpd11-20cw.pdf
HWSTEP04,STEP STREET REHABILITATION,841,DEPARTMENT OF TRANSPORTATION,RECONSTRUCTION OF STEP STREETS,000,CITYWIDE,HW-0211,10100,0,0,0,0,0,0,1122,1122,0,0,0,0,0,0,1122,1122,0,0,0,0,0,0,2244,2244,PROJECT DELAYED DUE TO BUDGETARY CONSTRAINTS,CITYWIDE,STEP STREET REHABILITATION CITYWIDE,cpd11-20cw.pdf
HWTSQI,Public Plaza Improvements,841,DEPARTMENT OF TRANSPORTATION,PRIMARY STREET RECONSTRUCTION,000,CITYWIDE,HW-1684,133970,0,0,0,0,0,12300,61717,74017,0,0,0,0,0,12300,61717,74017,0,0,0,0,0,24600,123434,148034,PROJECT DELAYED DUE TO BUDGETARY CONSTRAINTS,,TOWN SQUARE INITIATIVE,cpd11-20cw.pdf
ITSBELTPK,Intelligent Transportation Systems on Belt Parkway X501.62,841,DEPARTMENT OF TRANSPORTATION,SIGNAL INSTALLATION AND COMPUTERIZATION,000,CITYWIDE,TF-0001,4925,619,70,70,0,0,0,226,985,619,70,70,0,0,0,226,985,1238,140,140,0,0,0,452,1970,,,NYCDOT'S TRAFFIC MANAGEMENT CENTER HAS LIMITATIONS TO PROVIDING DAILYTRAFFIC INCIDENT,cpd11-20cw.pdf
MOLRETROF,MOLINARI CLASS UPGRADES-RETRO FIT,841,DEPARTMENT OF TRANSPORTATION,RECONSTRUCTION OF FERRY BOATS,000,CITYWIDE,FA-0313,11030,826,0,10078,0,0,0,226,11130,826,0,10078,0,0,0,226,11130,1652,0,20156,0,0,0,452,22260,PROJECT DELAYED DUE TO BUDGETARY CONSTRAINTS,MOLINARI CLASS UPGRADES-RETRO FIT,MOLINARI CLASS UPGRADES-RETRO FIT,cpd11-20cw.pdf
NYCWINRPL,NYCWIN Replacement,841,DEPARTMENT OF TRANSPORTATION,SIGNAL INSTALLATION AND COMPUTERIZATION,000,CITYWIDE,TF-0001,75000,69988,1023,0,0,0,0,3990,75001,69988,1023,0,0,0,0,3990,75001,139976,2046,0,0,0,0,7980,150002,PROJECT DELAYED DUE TO BUDGETARY CONSTRAINTS,,NYCWIN REPLACEMENT,cpd11-20cw.pdf
PLANTRANS,TRANSIT SIGNAL PRIORITY-2030,841,DEPARTMENT OF TRANSPORTATION,SIGNAL INSTALLATION AND COMPUTERIZATION,000,CITYWIDE,TF-0001,9246,0,0,300,0,0,0,0,300,0,0,300,0,0,0,0,300,0,0,600,0,0,0,0,600,PROJECT DELAYED DUE TO BUDGETARY CONSTRAINTS,TRANSIT SIGNAL PRIORITY-2030,TRANSIT SIGNAL RIORITY-2030,cpd11-20cw.pdf
RTPIFY19,REAL TIME PASSENGER INFO SIGNS - FY19,841,DEPARTMENT OF TRANSPORTATION,SIGNAL INSTALLATION AND COMPUTERIZATION,000,CITYWIDE,TF-D005 TF-K001 TF-0001 TF-X001,7441,1800,4501,5222,0,0,0,0,11523,1800,4501,5222,0,0,0,0,11523,3600,9002,10444,0,0,0,0,23046,PROJECT DELAYED DUE TO BUDGETARY CONSTRAINTS,,FUNDING FOR FURNISH AND INSTALLATION OF REAL TIME PASSENGER INFORMATION SIGNS CITYWIDE,cpd11-20cw.pdf
RTPIFY20,Real Time Passenger Info Signs FY20ADOP,841,DEPARTMENT OF TRANSPORTATION,SIGNAL INSTALLATION AND COMPUTERIZATION,000,CITYWIDE,TF-K001 TF-D005,2760,0,2060,1380,0,0,0,0,3440,0,2060,1380,0,0,0,0,3440,0,4120,2760,0,0,0,0,6880,PROJECT DELAYED DUE TO BUDGETARY CONSTRAINTS,,FURNISH AND INSTALL RTPI AT VARIOUS LOCATIONS,cpd11-20cw.pdf
SAND-349R,Citywide In-House Resurfacing - Hurricane Sandy Recovery,841,DEPARTMENT OF TRANSPORTATION,PRIMARY STREET RESURFACING,000,CITYWIDE,HW-0349,43320,453,0,22,0,0,0,0,475,453,0,22,0,0,0,0,475,906,0,44,0,0,0,0,950,PROJECT DELAYED DUE TO BUDGETARY CONSTRAINTS,CITYWIDE IN-HOUSE RESURFACING - HURRICANE SANDY RECOVERY,IN-HOUSE RESURFACING - HURRICANE SANDY RECOVERY,cpd11-20cw.pdf
SANDCONDU,SANDY CONDUIT ADDITIONAL CITY-WIDE WORK,841,DEPARTMENT OF TRANSPORTATION,REPLACEMENT OF ELECTRICAL DISTRIBUTION SYSTEMS,000,CITYWIDE,HW-0003 TF-0503,29731,30,0,294,0,589,0,0,913,30,0,294,0,589,0,0,913,60,0,588,0,1178,0,0,1826,PROJECT DELAYED DUE TO BUDGETARY CONSTRAINTS,,SANDY CONDUIT ADDITIONAL CITY-WIDE WORK,cpd11-20cw.pdf
SANDHB002,Rehab of Movable Bridges Citywide - Sandy,841,DEPARTMENT OF TRANSPORTATION,BRIDGE LIFE EXTENSION AND MISCELLANEOUS WORK,000,CITYWIDE,HB-0215,35654,25534,0,0,970,0,0,0,26504,25534,0,0,970,0,0,0,26504,51068,0,0,1940,0,0,0,53008,PROJECT DELAYED DUE TO BUDGETARY CONSTRAINTS,,"TO REPAIR VARIOUS MOVABLE BRIDGES DAMAGED DUE TO HURRICANE SANDY, CITYWIDE.",cpd11-20cw.pdf
SANDRF05,Construction of New Ferryboats,841,DEPARTMENT OF TRANSPORTATION,RECONSTRUCTION OF FERRY BOATS,000,CITYWIDE,FA-0313,340000,67698,0,0,0,1000,0,24156,92854,67698,0,0,0,1000,0,24156,92854,135396,0,0,0,2000,0,48312,185708,PROJECT DELAYED DUE TO BUDGETARY CONSTRAINTS,,CONSTRUCTION OF 3 NEW FERRYBOATS,cpd11-20cw.pdf
SANDRF07,SEVERE WEATHER MOORING UPGRADE,841,DEPARTMENT OF TRANSPORTATION,RECONSTRUCTION OF FERRY TERMINAL FACILITIES,000,CITYWIDE,FA-0021,2844,122,0,215,0,0,311,0,648,122,0,215,0,0,311,0,648,244,0,430,0,0,622,0,1296,,SEVERE WEATHER MOORING UPGRADE,SEVERE WEATHER MOORING UPGRADE,cpd11-20cw.pdf
SANDRF10,ROCK-SOCKETED STEEL MOORING PILES,841,DEPARTMENT OF TRANSPORTATION,RECONSTRUCTION OF FERRY TERMINAL FACILITIES,000,CITYWIDE,FA-0021,14751,0,1476,1474,0,0,0,0,2950,0,1476,1474,0,0,0,0,2950,0,2952,2948,0,0,0,0,5900,,ROCK-SOCKETED STEEL MOORING PILES,ROCK-SOCKETED STEEL MOORING PILES,cpd11-20cw.pdf
SANDRF11,Ferry Terminal Floodproofing,841,DEPARTMENT OF TRANSPORTATION,RECONSTRUCTION OF FERRY TERMINAL FACILITIES,000,CITYWIDE,FA-0021,25355,20,198,5248,0,0,0,0,5466,20,198,5248,0,0,0,0,5466,40,396,10496,0,0,0,0,10932,PROJECT DELAYED DUE TO BUDGETARY CONSTRAINTS,,MEASURES TO MITIGATE STORM SURGE IMPACT AT SIF FACILITIES,cpd11-20cw.pdf
SEQUEENS,South East Queens Initiative,841,DEPARTMENT OF TRANSPORTATION,PRIMARY STREET RECONSTRUCTION,000,CITYWIDE,HW-0001Q,100505,0,0,0,0,0,0,47119,47119,0,0,0,0,0,0,47119,47119,0,0,0,0,0,0,94238,94238,PROJECT DELAYED DUE TO BUDGETARY CONSTRAINTS,SOUTH EAST QUEENS INITIATIVE,SOUTH EAST QUEENS INITIATIVE,cpd11-20cw.pdf
SIGNALSF2,"TRAFFIC SIGNAL SAFETY, CITYWIDE",841,DEPARTMENT OF TRANSPORTATION,SIGNAL INSTALLATION AND COMPUTERIZATION,000,CITYWIDE,TF-0001,70000,19403,3560,10478,0,0,0,0,33441,19403,3560,10478,0,0,0,0,33441,38806,7120,20956,0,0,0,0,66882,PROJECT DELAYED DUE TO BUDGETARY CONSTRAINTS,"TRAFFIC SIGNAL SAFETY, CITYWIDE","TRAFFIC SIGNAL SAFETY, CITYWIDE",cpd11-20cw.pdf
SLMNTLUMP,CAPITAL COMPONENT STREETLIGHT MAINTENANCE (TEN YR PLAN),841,DEPARTMENT OF TRANSPORTATION,INSTALLATION OF LAMPPOSTS AND LUMINAIRES,000,CITYWIDE,TF-0503,30500,0,0,0,0,72,0,0,72,0,0,0,0,72,0,0,72,0,0,0,0,144,0,0,144,PROJECT DELAYED DUE TO BUDGETARY CONSTRAINTS,CAPITAL COMPONENT STREET LIGHT MAINTENANCE,CAPITAL COMPONENT STREET LIGHT MAINTENANCE,cpd11-20cw.pdf
STEFFSCMV,NYC Street Efficiency Strategic Commercial Vehicle Monitorin,841,DEPARTMENT OF TRANSPORTATION,SIGNAL INSTALLATION AND COMPUTERIZATION,000,CITYWIDE,TF-0001,2441,0,0,633,634,1174,0,0,2441,0,0,633,634,1174,0,0,2441,0,0,1266,1268,2348,0,0,4882,PROJECT DELAYED DUE TO BUDGETARY CONSTRAINTS,,CVM,cpd11-20cw.pdf
TF012013,NEW SIGNAL INSTALLATION REQUIREMENT CONTRACT FY13,841,DEPARTMENT OF TRANSPORTATION,SIGNAL INSTALLATION AND COMPUTERIZATION,000,CITYWIDE,TF-0001,15500,4475,0,0,0,0,0,0,4475,4475,0,0,0,0,0,0,4475,8950,0,0,0,0,0,0,8950,PROJECT DELAYED DUE TO BUDGETARY CONSTRAINTS,,INSTALLATION OF NEW SIGNALS,cpd11-20cw.pdf
TF012014,NEW SIGNALS INSTALLATION REQUIREMENT,841,DEPARTMENT OF TRANSPORTATION,SIGNAL INSTALLATION AND COMPUTERIZATION,000,CITYWIDE,TF-0001,16600,8075,0,0,0,0,0,0,8075,8075,0,0,0,0,0,0,8075,16150,0,0,0,0,0,0,16150,PROJECT DELAYED DUE TO BUDGETARY CONSTRAINTS,NEW SIGNAL INSTALLATION REQUIREMENT,NEW SIGNAL INSTALLATION REQUIREMENT,cpd11-20cw.pdf
TF012017,NEW SIGNALS INSTALLATION REQUIREMENT FY17,841,DEPARTMENT OF TRANSPORTATION,SIGNAL INSTALLATION AND COMPUTERIZATION,000,CITYWIDE,TF-0001,28932,10772,0,0,0,0,0,689,11461,10772,0,0,0,0,0,689,11461,21544,0,0,0,0,0,1378,22922,PROJECT DELAYED DUE TO BUDGETARY CONSTRAINTS,,FURNISHED AND INSTALL NEW SIGNALS,cpd11-20cw.pdf
TF012019,NEW SIGNALS INSTALLATION REQUIREMENT 2019,841,DEPARTMENT OF TRANSPORTATION,SIGNAL INSTALLATION AND COMPUTERIZATION,000,CITYWIDE,TF-0001,32426,6420,9531,6025,0,0,0,0,21976,6420,9531,6025,0,0,0,0,21976,12840,19062,12050,0,0,0,0,43952,PROJECT DELAYED DUE TO BUDGETARY CONSTRAINTS,,"THIS CONTRACT IS FOR THE FURNISHING, INSTALLATION AND REMOVAL OF ELECTRICAL TRAFFIC",cpd11-20cw.pdf
TF01-9910,LOCAL STREET NETWORK MGMT AND INCIDENT MGMT X500.94,841,DEPARTMENT OF TRANSPORTATION,SIGNAL INSTALLATION AND COMPUTERIZATION,000,CITYWIDE,TF-0001,4346,2339,0,350,0,0,1388,0,4077,2339,0,350,0,0,1388,0,4077,4678,0,700,0,0,2776,0,8154,PROJECT DELAYED DUE TO BUDGETARY CONSTRAINTS,LOCAL STREET NETWORK MGMT AND INCIDENT MGMT,LOCAL STREET NETWORK MGMT AND INCIDENT MGMT,cpd11-20cw.pdf
TF01-9911,Advance Travel Information System Upgrade,841,DEPARTMENT OF TRANSPORTATION,SIGNAL INSTALLATION AND COMPUTERIZATION,000,CITYWIDE,TF-0001,500,0,80,420,0,0,0,0,500,0,80,420,0,0,0,0,500,0,160,840,0,0,0,0,1000,PROJECT DELAYED DUE TO BUDGETARY CONSTRAINTS,,UPGRADE OF EZPASS REVENUE SYSTEM,cpd11-20cw.pdf
TF01APS,Accessible Pedestrian System(AT 75 LOCATIONS PER YEAR),841,DEPARTMENT OF TRANSPORTATION,SIGNAL INSTALLATION AND COMPUTERIZATION,000,CITYWIDE,TF-0001,15200,0,0,0,10098,10098,0,31498,51694,0,0,0,10098,10098,0,31498,51694,0,0,0,20196,20196,0,62996,103388,PROJECT DELAYED DUE TO BUDGETARY CONSTRAINTS,APS (AT 75 LOCATIONS PER YEAR ),APS (AT 75 LOCATIONS PER YEAR ),cpd11-20cw.pdf
TF01RL5,RED LIGHT CAMERAS,841,DEPARTMENT OF TRANSPORTATION,SIGNAL INSTALLATION AND COMPUTERIZATION,000,CITYWIDE,TF-0001,3229,5056,0,0,0,0,193,0,5249,5056,0,0,0,0,193,0,5249,10112,0,0,0,0,386,0,10498,PROJECT DELAYED DUE TO BUDGETARY CONSTRAINTS,RED LIGHT CAMERAS,RED LIGHT CAMERAS,cpd11-20cw.pdf
TF01TPM18,Thermoplastic Markings -FY18,841,DEPARTMENT OF TRANSPORTATION,INSTALLATION OF PAVEMENT MARKINGS,000,CITYWIDE,TF-0001,15649,16882,3000,0,0,0,0,0,19882,16882,3000,0,0,0,0,0,19882,33764,6000,0,0,0,0,0,39764,PROJECT DELAYED DUE TO BUDGETARY CONSTRAINTS,,FURNISHED AND INSTALL THERMOPLASTIC MARKING CITYWIDE,cpd11-20cw.pdf
TF01TPM21,Thermoplastic Marking-FY21,841,DEPARTMENT OF TRANSPORTATION,INSTALLATION OF PAVEMENT MARKINGS,000,CITYWIDE,TF-0001,19000,0,5000,12000,0,2000,0,0,19000,0,5000,12000,0,2000,0,0,19000,0,10000,24000,0,4000,0,0,38000,,,RECONSTRUCTION,cpd11-20cw.pdf
TF01VARMS,"Variable Message Signs Replacement, Citywide",841,DEPARTMENT OF TRANSPORTATION,SIGNAL INSTALLATION AND COMPUTERIZATION,000,CITYWIDE,TF-0001,4586,0,400,300,1943,2017,0,0,4660,0,400,300,1943,2017,0,0,4660,0,800,600,3886,4034,0,0,9320,PROJECT DELAYED DUE TO BUDGETARY CONSTRAINTS,,"VARIABLE MESSAGE SIGNS REPLACEMENT , CITYWIDE",cpd11-20cw.pdf
TF18-LUMP,LUMP SUM FOR PARKING RECONSTRUCTION,841,DEPARTMENT OF TRANSPORTATION,"Parking Meters, Lots, and Garages",000,CITYWIDE,TF-0018,1405,0,0,0,0,0,0,5637,5637,0,0,0,0,0,0,5637,5637,0,0,0,0,0,0,11274,11274,PROJECT DELAYED DUE TO BUDGETARY CONSTRAINTS,CITY-WIDE,LUMP SUM FOR PARKING RECONSTRUCTION,cpd11-20cw.pdf
TFAPEDSY3,Accessible Pedestrian System-Retrofit,841,DEPARTMENT OF TRANSPORTATION,SIGNAL INSTALLATION AND COMPUTERIZATION,000,CITYWIDE,TF-0001,10098,0,9383,9382,0,0,0,0,18765,0,9383,9382,0,0,0,0,18765,0,18766,18764,0,0,0,0,37530,PROJECT DELAYED DUE TO BUDGETARY CONSTRAINTS,,FURNISH AND INSTALL APS,cpd11-20cw.pdf
TFAPSLUMP,"Accessible Pedestrian Signals, TEN YEARS",841,DEPARTMENT OF TRANSPORTATION,SIGNAL INSTALLATION AND COMPUTERIZATION,000,CITYWIDE,TF-0001,48548,0,0,19760,20121,0,0,0,39881,0,0,19760,20121,0,0,0,39881,0,0,39520,40242,0,0,0,79762,PROJECT DELAYED DUE TO BUDGETARY CONSTRAINTS,,"FURNISH AND INSTALL ACCESSIBLE PEDESTRIAN SIGNALS, TEN YEARS",cpd11-20cw.pdf
TFCORRBAS,Replacement of Corroded Street light and Signal Poles,841,DEPARTMENT OF TRANSPORTATION,SIGNAL INSTALLATION AND COMPUTERIZATION,000,CITYWIDE,TF-0001,6116,0,765,3058,2293,0,0,0,6116,0,765,3058,2293,0,0,0,6116,0,1530,6116,4586,0,0,0,12232,,,REPLACEMENT OF CORRODED STREET LIGHT AND SIGNAL POLES,cpd11-20cw.pdf
TFCWSBST,SBS-Citywide Real Time Totem System,841,DEPARTMENT OF TRANSPORTATION,SIGNAL INSTALLATION AND COMPUTERIZATION,000,CITYWIDE,TF-0001,3557,1685,0,1872,0,0,0,0,3557,1685,0,1872,0,0,0,0,3557,3370,0,3744,0,0,0,0,7114,PROJECT DELAYED DUE TO BUDGETARY CONSTRAINTS,,PURCHASE AND INSTALLATION OF TOTEM SIGNS CITYWIDE ON SBS ROUTES,cpd11-20cw.pdf
TFITSAMS,INTELLIGENT TRANSPORTATION SYSTEM(ITS) ON HIGHWAYS,841,DEPARTMENT OF TRANSPORTATION,SIGNAL INSTALLATION AND COMPUTERIZATION,000,CITYWIDE,TF-0001,27758,492,100,100,100,0,0,3124,3916,492,100,100,100,0,0,3124,3916,984,200,200,200,0,0,6248,7832,PROJECT DELAYED DUE TO BUDGETARY CONSTRAINTS,ITS AND AMS INSTALLATION,ITS AND AMS INSTALLATION,cpd11-20cw.pdf
TFLGUDECK,"Lighting at underdeck Structure, citywide",841,DEPARTMENT OF TRANSPORTATION,INSTALLATION OF LAMPPOSTS AND LUMINAIRES,000,CITYWIDE,TF-0503,4000,2414,0,0,0,2201,0,0,4615,2414,0,0,0,2201,0,0,4615,4828,0,0,0,4402,0,0,9230,PROJECT DELAYED DUE TO BUDGETARY CONSTRAINTS,,FURNISH AND INSTALL LIGHT AT UNDERDECK,cpd11-20cw.pdf
TFLGUSBWY,Furnish and Install Lighting under elevated structures,841,DEPARTMENT OF TRANSPORTATION,INSTALLATION OF LAMPPOSTS AND LUMINAIRES,000,CITYWIDE,TF-0503,7735,3384,0,0,0,3642,0,0,7026,3384,0,0,0,3642,0,0,7026,6768,0,0,0,7284,0,0,14052,,,FURNISH AND INSTALL LIGHT UNDER ELEVEATED SUBWAY,cpd11-20cw.pdf
TFMARKLMP,THERMOPLASTIC MARKINGS-TEN YEARS,841,DEPARTMENT OF TRANSPORTATION,INSTALLATION OF PAVEMENT MARKINGS,000,CITYWIDE,TF-0001,30456,0,0,0,9500,10500,19000,31168,70168,0,0,0,9500,10500,19000,31168,70168,0,0,0,19000,21000,38000,62336,140336,PROJECT DELAYED DUE TO BUDGETARY CONSTRAINTS,,INSTALLATION OF THERM MARKINGS ON RESURFACED STREETS,cpd11-20cw.pdf
TFPEDCDW3,Furnish and install Pedestrian Countdown Clocks,841,DEPARTMENT OF TRANSPORTATION,SIGNAL INSTALLATION AND COMPUTERIZATION,000,CITYWIDE,TF-0001,3222,0,194,0,0,0,0,128,322,0,194,0,0,0,0,128,322,0,388,0,0,0,0,256,644,PROJECT DELAYED DUE TO BUDGETARY CONSTRAINTS,,URNISH AND INSTALL PEDESTRIAN COUNTDOWN CLOCKS,cpd11-20cw.pdf
TFPWSIGNL,PROACTIVE WARRANT NEW SIGNALS INSTALLATION,841,DEPARTMENT OF TRANSPORTATION,SIGNAL INSTALLATION AND COMPUTERIZATION,000,CITYWIDE,TF-0001,10500,675,0,0,0,0,0,0,675,675,0,0,0,0,0,0,675,1350,0,0,0,0,0,0,1350,,,NEW SIGNALS INSTALLATION,cpd11-20cw.pdf
TFSPDCAM,Purchase and Install Speed Cameras in School Zones Areas,841,DEPARTMENT OF TRANSPORTATION,SIGNAL INSTALLATION AND COMPUTERIZATION,000,CITYWIDE,TF-0001,2495,58290,82761,46788,0,0,23704,0,211543,58290,82761,46788,0,0,23704,0,211543,116580,165522,93576,0,0,47408,0,423086,PROJECT DELAYED DUE TO BUDGETARY CONSTRAINTS,SPEED CAMERA,SPEED CAMERA,cpd11-20cw.pdf
TFVISIONZ,Traffic Vision Zero projects-St Light Enhancement,841,DEPARTMENT OF TRANSPORTATION,INSTALLATION OF LAMPPOSTS AND LUMINAIRES,000,CITYWIDE,TF-0503,3949,3023,332,0,0,0,0,886,4241,3023,332,0,0,0,0,886,4241,6046,664,0,0,0,0,1772,8482,PROJECT DELAYED DUE TO BUDGETARY CONSTRAINTS,,ST LIGHT AND SPEED CAMERAS FURNISHED AND INSTALLATION,cpd11-20cw.pdf
TRNCHREST,Trench Restoration,841,DEPARTMENT OF TRANSPORTATION,PRIMARY STREET RECONSTRUCTION,000,CITYWIDE,HW-0001 HW-0001K,60000,0,0,0,0,0,0,2846,2846,0,0,0,0,0,0,2846,2846,0,0,0,0,0,0,5692,5692,PROJECT DELAYED DUE TO BUDGETARY CONSTRAINTS,TRENCH RESTORATION,TRENCH RESTORATION,cpd11-20cw.pdf
TYPLILL,STREET LIGHTING <TEN YEAR PLAN),841,DEPARTMENT OF TRANSPORTATION,INSTALLATION OF LAMPPOSTS AND LUMINAIRES,000,CITYWIDE,TF-0503,70000,0,0,0,15,0,15,112,142,0,0,0,15,0,15,112,142,0,0,0,30,0,30,224,284,PROJECT DELAYED DUE TO BUDGETARY CONSTRAINTS,,,cpd11-20cw.pdf
TYPLREP,TRAFFIC PARK & HIGHWAY DISTRIBUTION(TEN YEAR PLAN),841,DEPARTMENT OF TRANSPORTATION,REPLACEMENT OF ELECTRICAL DISTRIBUTION SYSTEMS,000,CITYWIDE,TF-0503 P-0705,55300,0,0,0,600,0,0,0,600,0,0,0,600,0,0,0,600,0,0,0,1200,0,0,0,1200,PROJECT DELAYED DUE TO BUDGETARY CONSTRAINTS,,,cpd11-20cw.pdf
TYPLSGM,TRAFFIC SIGNALS (TEN YEAR PLAN),841,DEPARTMENT OF TRANSPORTATION,SIGNAL INSTALLATION AND COMPUTERIZATION,000,CITYWIDE,TF-0001,172000,0,0,7094,0,7094,7096,22140,43424,0,0,7094,0,7094,7096,22140,43424,0,0,14188,0,14188,14192,44280,86848,PROJECT DELAYED DUE TO BUDGETARY CONSTRAINTS,,,cpd11-20cw.pdf
ACEDPR403,DPR efficient lighting @various facilities 5bor CNYG-2415MA1,846,DEPT OF PARKS AND RECREATION,"BUILDING CONSTRUCTION, RECONSTRUCTION OR RETROFIT",,CITYWIDE,PU-0025,2500,2709,0,0,228,0,0,0,2937,2709,0,0,228,0,0,0,2937,5418,0,0,456,0,0,0,5874,,FY15 $1 CONTRACT FOR DCAS ACE PROGRAM,FY15 $1 CONTRACT FOR DCAS ACE PROGRAM,cpd11-20cw.pdf
ACEDPR404,DPR efficient lighting @ ballfields SI & Q CNYG-2815M,846,DEPT OF PARKS AND RECREATION,MISCELLANEOUS ENERGY EFFICIENCY AND SUSTAINABILITY,,CITYWIDE,P-1018 P-0882,1460,1478,174,0,0,0,0,0,1652,1478,174,0,0,0,0,0,1652,2956,348,0,0,0,0,0,3304,,DACS - ENERGY EFFICIENCY BALLFIELD LIGHTING RETROFIT AT VARIOUS PARKS& RECREATION,DCAS - ENERGY EFFICIENCY BALLFIELD LIGHTING RETROFIT AT VARIOUS PARKS& RECREATION,cpd11-20cw.pdf
ACEDPR405,"DPR efficient lighting @ ballfields MN, BK & BX CNYG-2915",846,DEPT OF PARKS AND RECREATION,MISCELLANEOUS ENERGY EFFICIENCY AND SUSTAINABILITY,,CITYWIDE,P-1018 PU-0025,2386,4968,309,1,0,0,0,0,5278,4968,309,1,0,0,0,0,5278,9936,618,2,0,0,0,0,10556,,DCAS - ENERGY EFFICIENCY BALLFIELD LIGHTING RETROFIT AT VARIOUS PARKS& RECREATION,DCAS - ENERGY EFFICIENCY BALLFIELD LIGHTING RETROFIT AT VARIOUS PARKS& RECREATION,cpd11-20cw.pdf
GXBXBKQ1,"GI Citywide-Bioswales in Parks Bronx, Queens & Brooklyn",846,DEPT OF PARKS AND RECREATION,LAND ACQUISITION AND TREE PLANTING,000,CITYWIDE,WP-0169 P-0822,2272,377,0,548,0,0,0,0,925,377,0,548,0,0,0,0,925,754,0,1096,0,0,0,0,1850,,"GI CITYWIDE-BIOSWALES IN PARKS BRONX, QUEENS & BROOKLYN","GI CITYWIDE-BIOSWALES IN PARKS BRONX, QUEENS & BROOKLYN",cpd11-20cw.pdf
P-3ALRMMN,Manhattan - Fire Alarm,846,DEPT OF PARKS AND RECREATION,"LARGE, MAJOR AND REGIONAL PARK RECONSTRUCTION",000,CITYWIDE,P-1008,1150,1928,0,193,0,0,0,0,2121,1928,0,193,0,0,0,0,2121,3856,0,386,0,0,0,0,4242,PROJECT DELAYED DUE TO UNFORESEEN SITE/FIELD CONDITION,MANHATTAN,MANHATTAN - FIRE ALARM,cpd11-20cw.pdf
P-600ZOO3,Citywide Zoos - roof replacements at various buildings,846,DEPT OF PARKS AND RECREATION,ZOOS,000,CITYWIDE,P-1018,2007,1773,177,0,0,0,0,0,1950,1773,177,0,0,0,0,0,1950,3546,354,0,0,0,0,0,3900,PROJECT DELAYED DUE TO UNFORESEEN SITE/FIELD CONDITION,"REPLACEMENT OF ROOFS AT QUEENS ZOO OPERATIONS BUILDING, PROSPECT PARKZOO BUILDING A,","REPLACEMENT OF ROOFS AT QUEENS ZOO OPERATIONS BUILDING, PROSPECT PARKZOO BUILDING A,",cpd11-20cw.pdf
P-600ZOO4,Citywide Zoos - HVAC replacements,846,DEPT OF PARKS AND RECREATION,ZOOS,000,CITYWIDE,P-0887,790,718,72,0,0,0,0,0,790,718,72,0,0,0,0,0,790,1436,144,0,0,0,0,0,1580,PROJECT DELAYED DUE TO UNFORESEEN SITE/FIELD CONDITION,CENTRAL PARK ZOO AND PROSPECT PARK ZOO,"HVAC REPLACEMENT AT CPZ DANCING CRANE CAFE, CPZ ZOOTIQUE GIFT SHOP, CPZ OUTDOOR BIRD",cpd11-20cw.pdf
P-600ZOO5,Citywide Zoos - HVAC at CPZ snow leopard & QZ concession,846,DEPT OF PARKS AND RECREATION,ZOOS,000,CITYWIDE,P-0887,700,0,700,0,0,0,0,0,700,0,700,0,0,0,0,0,700,0,1400,0,0,0,0,0,1400,,CITYWIDE ZOOS - HVAC AT CPZ SNOW LEOPARD & QZ CONCESSION,CITYWIDE ZOOS - HVAC AT CPZ SNOW LEOPARD & QZ CONCESSION,cpd11-20cw.pdf
P-65BORO,"5 Boro Relocation - 850 East 138th street, Bronx",846,DEPT OF PARKS AND RECREATION,"LARGE, MAJOR AND REGIONAL PARK RECONSTRUCTION",000,CITYWIDE,P-1018,30000,5,0,2329,0,0,0,0,2334,5,0,2329,0,0,0,0,2334,10,0,4658,0,0,0,0,4668,PROJECT DELAYED DUE TO CHANGES IN SCOPE/DESIGN,CW,5 BORO RELOCATION,cpd11-20cw.pdf
P-6ABLDG3,"REQUIREMENTS -BLDGS-ARCH CNYG-1503M, CNYG-1903M-OMBP",846,DEPT OF PARKS AND RECREATION,MAJOR RECREATIONAL FACILITIES AND FACILITY RECONSTRUCTION,000,CITYWIDE,P-1018,2994,2880,39,0,0,0,0,0,2919,2880,39,0,0,0,0,0,2919,5760,78,0,0,0,0,0,5838,,CITYWIDE,BUILDING REQUIREMENTS - GENERAL - CITYWIDE,cpd11-20cw.pdf
P-6BLDG9C,FY10 Building Requirements (CNYG-409M),846,DEPT OF PARKS AND RECREATION,NEIGHBORHOOD PARKS AND PLAYGROUNDS,000,CITYWIDE,P-1018,590,1246,37,0,0,0,0,0,1283,1246,37,0,0,0,0,0,1283,2492,74,0,0,0,0,0,2566,PROJECT DELAYED DUE TO CHANGES IN SCOPE/DESIGN,CW,BUILDING REQUIREMENTS,cpd11-20cw.pdf
P-6BLGC15,FY15 Citywide buildings (gen construction) CNYG-1615MA,846,DEPT OF PARKS AND RECREATION,"LARGE, MAJOR AND REGIONAL PARK RECONSTRUCTION",,CITYWIDE,P-D019 P-1018,1025,815,268,0,0,0,0,0,1083,815,268,0,0,0,0,0,1083,1630,536,0,0,0,0,0,2166,,CITYWIDE,FY15 CITYWIDE BUILDINGS (GEN CONSTRUCTION),cpd11-20cw.pdf
P-6BLRC14,RC OF C/S & FACILITIES @ VARIOUS PKS MAYOR FUNDED CNYG-814MA,846,DEPT OF PARKS AND RECREATION,"LARGE, MAJOR AND REGIONAL PARK RECONSTRUCTION",000,CITYWIDE,P-1018,3050,2919,189,0,0,0,0,0,3108,2919,189,0,0,0,0,0,3108,5838,378,0,0,0,0,0,6216,PROJECT DELAYED DUE TO CHANGES IN SCOPE/DESIGN,CITYWIDE BUILDINGS,RC OF C/S & FACILITIES AT VARIOUS PKS MAYOR FUNDED,cpd11-20cw.pdf
P-6BOIL15,"MOSHOLU PK CS, PROSPECT PK PAINT SHOP, BENSONHURST SR CTR",846,DEPT OF PARKS AND RECREATION,"LARGE, MAJOR AND REGIONAL PARK RECONSTRUCTION",000,CITYWIDE,P-1250,348,63,0,1063,0,0,0,0,1126,63,0,1063,0,0,0,0,1126,126,0,2126,0,0,0,0,2252,,,"MOSHOLU PK CS, PROSPECT PK PAINT SHOP, BENSONHURST SR CTR",cpd11-20cw.pdf
P-6BPOOL3,"POOLS - ELECTRICAL, BK, Q & SI CNYG-403M",846,DEPT OF PARKS AND RECREATION,"LARGE, MAJOR AND REGIONAL PARK RECONSTRUCTION",000,CITYWIDE,P-1008,0,35,74,0,0,0,0,0,109,35,74,0,0,0,0,0,109,70,148,0,0,0,0,0,218,,"POOLS ELECTRICAL BK, Q & SI",THE IN-KIND RECONSTRUCTION OF DETERIORATED ELECTRICAL SYSTEMS FOR VARIOUS PARKS &,cpd11-20cw.pdf
P-6BRIDGE,Citywide Flag Repairs,846,DEPT OF PARKS AND RECREATION,"LARGE, MAJOR AND REGIONAL PARK RECONSTRUCTION",000,CITYWIDE,P-0508,4000,0,181,2000,0,0,0,0,2181,0,181,2000,0,0,0,0,2181,0,362,4000,0,0,0,0,4362,PROJECT DELAYED DUE TO CHANGES IN SCOPE/DESIGN,CW,FLAG REPAIRS,cpd11-20cw.pdf
P-6CBLDG4,REQUIREMENTS - BLDGS - PLMB CNYG-404M,846,DEPT OF PARKS AND RECREATION,VEHICLES AND EQUIPMENT,000,CITYWIDE,P-1018 P-R245,456,274,104,0,0,0,0,0,378,274,104,0,0,0,0,0,378,548,208,0,0,0,0,0,756,,REQUIREMENTS - BLDGS - PLMB,REQUIREMENTS - BLDGS - PLMB,cpd11-20cw.pdf
P-6COMF18,Recon citywide Comfort Stations $1 contract,846,DEPT OF PARKS AND RECREATION,NEIGHBORHOOD PARKS AND PLAYGROUNDS,,CITYWIDE,P-0505,2657,100,0,2657,0,0,0,0,2757,100,0,2657,0,0,0,0,2757,200,0,5314,0,0,0,0,5514,,CITYWIDE,RECON CITYWIDE COMFORT STATIONS $1 CONTRACT,cpd11-20cw.pdf
P-6CPIBN3,CPI PH1- Construction of CW C/S CNYG-3215M,846,DEPT OF PARKS AND RECREATION,NEIGHBORHOOD PARKS AND PLAYGROUNDS,000,CITYWIDE,P-1018 WP-0169,1392,20015,55,854,0,0,0,0,20924,20015,55,854,0,0,0,0,20924,40030,110,1708,0,0,0,0,41848,PROJECT DELAYED DUE TO CHANGES IN SCOPE/DESIGN,CITYWIDE,"THE CONSTRUCTION OF TEN, EYCK PLGD CS, LYONS SQUARE PLGD CS, MELROSE COMMONS CS, SAW",cpd11-20cw.pdf
P-6CPIBN4,CPI PH1- Bx & Mn C/S-Bundle 4 CNYG-3315M,846,DEPT OF PARKS AND RECREATION,"LARGE, MAJOR AND REGIONAL PARK RECONSTRUCTION",,CITYWIDE,P-1018,555,9247,2,579,0,0,0,0,9828,9247,2,579,0,0,0,0,9828,18494,4,1158,0,0,0,0,19656,,CPI- BX & MN COMFORT STATIONS-BUNDLE 4,CPI- BX & MN COMFORT STATIONS-BUNDLE 4,cpd11-20cw.pdf
P-6CPIPH2,Community Parks Initiative (CPI Ph. 2),846,DEPT OF PARKS AND RECREATION,NEIGHBORHOOD PARKS AND PLAYGROUNDS,000,CITYWIDE,P-1018,107106,0,0,0,0,6384,0,0,6384,0,0,0,0,6384,0,0,6384,0,0,0,0,12768,0,0,12768,PROJECT DELAYED DUE TO CHANGES IN SCOPE/DESIGN,$181K OFFSET W/P1CPIOPG FY18 TO FY19..$52K TRSF TO P-1CPIOPG..7/28/17$2434K FY19 TRSF TO,XFERS FY17,cpd11-20cw.pdf
P-6CSBLDG,Reconst of Comfort Stations & Buildings Citywide CNYG-219M,846,DEPT OF PARKS AND RECREATION,NEIGHBORHOOD PARKS AND PLAYGROUNDS,000,CITYWIDE,P-0505,2800,2133,993,0,0,0,0,0,3126,2133,993,0,0,0,0,0,3126,4266,1986,0,0,0,0,0,6252,,,RECONSTRUCTION OF COMFORT STATIONS AND BUILDINGS CITYWIDE,cpd11-20cw.pdf
P-6CW1250,"BOILERS RECONSTRUCTION,CITYWIDE",846,DEPT OF PARKS AND RECREATION,MAJOR RECREATIONAL FACILITIES AND FACILITY RECONSTRUCTION,000,CITYWIDE,P-1250,13931,442,1,0,0,2815,0,43031,46289,442,1,0,0,2815,0,43031,46289,884,2,0,0,5630,0,86062,92578,PROJECT DELAYED DUE TO UNFORESEEN SITE/FIELD CONDITION,TRF FR P-202BWHB ($30K P 1250 FY18 AND $1470 FY19)...3/5/2018 $1052K (P-1250 FY19) XFER FR P-,RC OF BOILERS - CW...FY'15 TRF $1.0M TO P-217PDGT...$1500K FY17 P1250TRSF TO P-101STMH...$735K,cpd11-20cw.pdf
P-6CW5131,NYS Law 5-1.31 Compliance/ Citywide Installation of Backflow,846,DEPT OF PARKS AND RECREATION,NEIGHBORHOOD PARKS AND PLAYGROUNDS,000,CITYWIDE,P-1250,6239,0,554,1560,1562,1563,0,0,5239,0,554,1560,1562,1563,0,0,5239,0,1108,3120,3124,3126,0,0,10478,,,NYS LAW 5-1.31 COMPLIANCE/ CITYWIDE INSTALLATION OF BACKFLOW PREVENTION DEVICES,cpd11-20cw.pdf
P-6CWASBR,Citwide - HazMat Abatement & Borings,846,DEPT OF PARKS AND RECREATION,MAJOR RECREATIONAL FACILITIES AND FACILITY RECONSTRUCTION,000,CITYWIDE,P-1018,8036,798,39,3000,0,2000,1000,1373,8210,798,39,3000,0,2000,1000,1373,8210,1596,78,6000,0,4000,2000,2746,16420,PROJECT DELAYED DUE TO UNFORESEEN SITE/FIELD CONDITION,VARIOUS FACILITIES,XFER $195K (P-1018) TO P-6ROOF15...$800K (P 1018) TO P-218BILD...$200K XFER FR P-6HZMT11...$57K TRF,cpd11-20cw.pdf
P-6CWBLDS,Citywide - Building Requirements Contract,846,DEPT OF PARKS AND RECREATION,MAJOR RECREATIONAL FACILITIES AND FACILITY RECONSTRUCTION,000,CITYWIDE,P-1018 P-0505,12662,0,263,1595,0,2759,1448,6298,12363,0,263,1595,0,2759,1448,6298,12363,0,526,3190,0,5518,2896,12596,24726,,CITIWIDE,CITYWIDE - BUILDING REQUIREMENTS CONTRACT,cpd11-20cw.pdf
P-6CWCGDN,CITYWIDE COMMUNITY GARDENS,846,DEPT OF PARKS AND RECREATION,NEIGHBORHOOD PARKS AND PLAYGROUNDS,000,CITYWIDE,P-1018,0,0,300,3600,0,0,0,0,3900,0,300,3600,0,0,0,0,3900,0,600,7200,0,0,0,0,7800,,CITYWIDE,CITYWIDE COMMUNITY GARDENS,cpd11-20cw.pdf
P-6CWCMVE,Citywide - Comfort Stations Standards Study,846,DEPT OF PARKS AND RECREATION,MAJOR RECREATIONAL FACILITIES AND FACILITY RECONSTRUCTION,000,CITYWIDE,P-1018,225,184,0,41,0,0,0,0,225,184,0,41,0,0,0,0,225,368,0,82,0,0,0,0,450,,,CITYWIDE COMFORT STATIONS STANDARDS STUDY,cpd11-20cw.pdf
P-6CWFALM,NATURE CTRS AND REC CTRS-FIRE ALARMS AND LIFE SAFETY,846,DEPT OF PARKS AND RECREATION,MAJOR RECREATIONAL FACILITIES AND FACILITY RECONSTRUCTION,000,CITYWIDE,P-0506,59017,0,0,0,0,0,8000,0,8000,0,0,0,0,0,8000,0,8000,0,0,0,0,0,16000,0,16000,,NATURE CTRS AND REC CTRS,"NATURE CTRS AND REC CTRS. 10/26/18 $475K P-0506 FY21 TRANSFER TO P-3PDHBRC...3/8/19 $6,256K",cpd11-20cw.pdf
P-6CWGRNT,Hazardous Sidewalk Removal and Replacement,846,DEPT OF PARKS AND RECREATION,NEIGHBORHOOD PARKS AND PLAYGROUNDS,000,CITYWIDE,P-1018,2019,0,0,889,161,0,0,0,1050,0,0,889,161,0,0,0,1050,0,0,1778,322,0,0,0,2100,,GREENTHUMB GARDEN,GREENTHUMB GARDEN,cpd11-20cw.pdf
P-6CWMARI,CITYWIDE - MARINAS,846,DEPT OF PARKS AND RECREATION,"LARGE, MAJOR AND REGIONAL PARK RECONSTRUCTION",000,CITYWIDE,P-1018 P-1245,5000,0,1,0,2698,0,0,0,2699,0,1,0,2698,0,0,0,2699,0,2,0,5396,0,0,0,5398,PROJECT DELAYED DUE TO CHANGES IN SCOPE/DESIGN,CW,RECONSTRUCTION OF MARINAS - CITYWIDE,cpd11-20cw.pdf
P-6CWMINI,MINI-POOLS - CITYWIDE CNYG-1601MA,846,DEPT OF PARKS AND RECREATION,"LARGE, MAJOR AND REGIONAL PARK RECONSTRUCTION",000,CITYWIDE,P-1008,789,369,0,0,0,0,0,0,369,369,0,0,0,0,0,0,369,738,0,0,0,0,0,0,738,,CITYWIDE,RECONSTRUCTION OF MINI-POOLS - CITYWIDE,cpd11-20cw.pdf
P-6CWNP,CPI - NEIGHBORHOOD PARKS,846,DEPT OF PARKS AND RECREATION,NEIGHBORHOOD PARKS AND PLAYGROUNDS,000,CITYWIDE,WP-0169,75750,0,0,499,0,0,0,0,499,0,0,499,0,0,0,0,499,0,0,998,0,0,0,0,998,,"$1187K TO P-4CPIBOW, $1279K TO P-4CPIAST)..10/16/15 $344K P1018 TR IN($133K P-1CPIP52, $40K",FY15 SEPT PLAN $36.3M WP0169..1/6/15 $1500K P1018 TR TO P-4CPICMA...$273K P-1018 TRSF TO,cpd11-20cw.pdf
P-6CWPLE1,"Recon pool electrical systems, Citywide",846,DEPT OF PARKS AND RECREATION,NEIGHBORHOOD PARKS AND PLAYGROUNDS,,CITYWIDE,P-1008,2200,0,0,0,0,2200,0,0,2200,0,0,0,0,2200,0,0,2200,0,0,0,0,4400,0,0,4400,,CITYWIDE,"RECON POOL ELECTRICAL SYSTEMS, CITYWIDE",cpd11-20cw.pdf
P-6CWPOOL,CITYWIDE - POOLS,846,DEPT OF PARKS AND RECREATION,MAJOR RECREATIONAL FACILITIES AND FACILITY RECONSTRUCTION,000,CITYWIDE,P-1008,18199,652,0,280,0,1754,2075,9025,13786,652,0,280,0,1754,2075,9025,13786,1304,0,560,0,3508,4150,18050,27572,PROJECT DELAYED DUE TO UNFORESEEN SITE/FIELD CONDITION,$18K FR P-6POL11B...$49K FR P-6POOL11...FY'19 TRF $376K TO P-215HCPL...FY'19S TRF IN $283K ( P 1008)-,$1.346M XFER TO ACEDPR405... FY17 JAN PLAN PROPOSAL - THE PARKS DEPARTMENT IS REQUESTING,cpd11-20cw.pdf
P-6CWR22C,CityWide - HVAC R22 coolant retrofit,846,DEPT OF PARKS AND RECREATION,VEHICLES AND EQUIPMENT,000,CITYWIDE,P-1250,9777,0,333,0,2821,7352,0,0,10506,0,333,0,2821,7352,0,0,10506,0,666,0,5642,14704,0,0,21012,,,FY20 JAN,cpd11-20cw.pdf
P-6CWR23C,CityWide - HVAC R22 coolant retrofit (other facilities),846,DEPT OF PARKS AND RECREATION,VEHICLES AND EQUIPMENT,000,CITYWIDE,P-1250,15467,30,73,753,0,8951,0,0,9807,30,73,753,0,8951,0,0,9807,60,146,1506,0,17902,0,0,19614,,CITYWIDE,HVAC,cpd11-20cw.pdf
P-6CWRDIO,CITYWIDE - RUPS/ Radio System & Field equipment Revamp,846,DEPT OF PARKS AND RECREATION,VEHICLES AND EQUIPMENT,000,CITYWIDE,P-1018 P-0931,4871,4190,681,0,0,0,0,0,4871,4190,681,0,0,0,0,0,4871,8380,1362,0,0,0,0,0,9742,,,FY20 JAN NN,cpd11-20cw.pdf
P-6CWREWA,Retaining Walls- Citywide-Man.-S.I. & BX,846,DEPT OF PARKS AND RECREATION,MAJOR RECREATIONAL FACILITIES AND FACILITY RECONSTRUCTION,000,CITYWIDE,P-1329,12269,0,1229,1040,0,2000,2000,6000,12269,0,1229,1040,0,2000,2000,6000,12269,0,2458,2080,0,4000,4000,12000,24538,,,RETAINING WALLS- CITYWIDE-MAN.-S.I. & BX,cpd11-20cw.pdf
P-6CWROOF,CITYWIDE - ROOFING SYSTEMS RC,846,DEPT OF PARKS AND RECREATION,MAJOR RECREATIONAL FACILITIES AND FACILITY RECONSTRUCTION,000,CITYWIDE,P-1249,18524,93,0,2526,749,1563,1615,7025,13571,93,0,2526,749,1563,1615,7025,13571,186,0,5052,1498,3126,3230,14050,27142,PROJECT DELAYED DUE TO UNFORESEEN SITE/FIELD CONDITION,ROOFING SYSTEMS CITYWIDE..$323K & $2.177K TO P-1RNQARF..4/26/19 $750KFY22 & $764K FY23 TO,"RECONSTRUCTION OF ROOFING SYSTEMS, CITY-WIDE...$1.665M ADDED FY26 & $1.717M IN FY27...$216K",cpd11-20cw.pdf
P-6CWRWAL,RETAINING WALLS - CITYWIDE,846,DEPT OF PARKS AND RECREATION,VEHICLES AND EQUIPMENT,000,CITYWIDE,P-0245M P-1329,5000,0,0,375,3054,2309,2417,12991,21146,0,0,375,3054,2309,2417,12991,21146,0,0,750,6108,4618,4834,25982,42292,,CITYWIDE,"RETAINING WALLS - CITYWIDE - FY'20J PLAN NN APPROVED $4045 (FY22),$4196(FY23), $4309(FY24),",cpd11-20cw.pdf
P-6CWSSPE,REQUIREMENTS CONTRACTS- CITYWIDE,846,DEPT OF PARKS AND RECREATION,NEIGHBORHOOD PARKS AND PLAYGROUNDS,000,CITYWIDE,P-1018,158690,2284,0,0,0,6151,4797,0,13232,2284,0,0,0,6151,4797,0,13232,4568,0,0,0,12302,9594,0,26464,PROJECT DELAYED DUE TO UNFORESEEN SITE/FIELD CONDITION,,...$6.996M (FY16-18) XFER TO P-1BWPLGR...$9.207M (FY16-18) XFER TO P-2BWPLGR......$7.129M ADDED,cpd11-20cw.pdf
P-6CWSTF,CITYWIDE SYNTHETIC RC,846,DEPT OF PARKS AND RECREATION,"LARGE, MAJOR AND REGIONAL PARK RECONSTRUCTION",000,CITYWIDE,P-0245M,101548,0,0,649,0,0,0,0,649,0,0,649,0,0,0,0,649,0,0,1298,0,0,0,0,1298,,CITYWIDE SYNTHETIC RC...$1310K P0245M FY22 TRSF FR P-306STVA...,"FY'18 TRF $1.450M TO P-210DSTF ($251M (FY'19) & $1.199M (FY'21))...5/18/18 $9327K ($933K FY19, $8394K",cpd11-20cw.pdf
P-6CWWALK,BOARDWALKS - CITYWIDE,846,DEPT OF PARKS AND RECREATION,VEHICLES AND EQUIPMENT,099,CITYWIDE,P-1245,109368,215,847,0,213,894,923,4014,7106,215,847,0,213,894,923,4014,7106,430,1694,0,426,1788,1846,8028,14212,PROJECT DELAYED PENDING APPROVAL OF NECESSARY PERMITS,CITYWIDE,...$552K XFER TO P-107WHLN...$1.753M XFER TO P-311MGFI...$604K TRSFR TO P-3PLG15C...8/29/16 $89K,cpd11-20cw.pdf
P-6DBLDG3,REQUIREMENTS - BLDGS - HVAC CNYG-1002MR,846,DEPT OF PARKS AND RECREATION,MAJOR RECREATIONAL FACILITIES AND FACILITY RECONSTRUCTION,,CITYWIDE,P-D020,554,491,51,0,0,0,0,0,542,491,51,0,0,0,0,0,542,982,102,0,0,0,0,0,1084,,CITYWIDE,REQUIREMENTS - BLDG -- HVAC,cpd11-20cw.pdf
P-6DEERFE,"Citywide - Deer Fencing - SI ,BX",846,DEPT OF PARKS AND RECREATION,"LARGE, MAJOR AND REGIONAL PARK RECONSTRUCTION",000,CITYWIDE,P-0822,356,0,356,0,0,0,0,0,356,0,356,0,0,0,0,0,356,0,712,0,0,0,0,0,712,,BOROUGHS OF STATEN ISLAND AND BRONX,CITYWIDE DEER FENCING,cpd11-20cw.pdf
P-6DTREE7,Trees - FY07 Spring Trees (CNYG-407M),846,DEPT OF PARKS AND RECREATION,LAND ACQUISITION AND TREE PLANTING,000,CITYWIDE,P-D171,633,623,0,69,0,0,0,0,692,623,0,69,0,0,0,0,692,1246,0,138,0,0,0,0,1384,PROJECT DELAYED DUE TO CHANGES IN SCOPE/DESIGN,FY07 SPRING TREES - CITYWIDE,FY07 SPRING TREES (CNYG-407M),cpd11-20cw.pdf
P-6EABTRA,Emerald Ash Borer (EAB) Tree Remove BX & MN,846,DEPT OF PARKS AND RECREATION,LAND ACQUISITION AND TREE PLANTING,000,CITYWIDE,P-0822,345,0,345,0,0,0,0,0,345,0,345,0,0,0,0,0,345,0,690,0,0,0,0,0,690,,CITYWIDE,EMERALD ASH BORER (EAB) TREE REMOVE BX &MHT,cpd11-20cw.pdf
P-6EABTRB,Emerald Ash Borer (EAB) Tree Remove BK &SI-CNYG-2319M,846,DEPT OF PARKS AND RECREATION,LAND ACQUISITION AND TREE PLANTING,000,CITYWIDE,P-0822,894,0,894,0,0,0,0,0,894,0,894,0,0,0,0,0,894,0,1788,0,0,0,0,0,1788,,EMERALD ASH BORER (EAB) TREE REMOVE BK &SI,EMERALD ASH BORER (EAB) TREE REMOVE BK &SI,cpd11-20cw.pdf
P-6EABTRE,Emerald Ash Borer (EAB) Remove and Replace,846,DEPT OF PARKS AND RECREATION,LAND ACQUISITION AND TREE PLANTING,000,CITYWIDE,P-0822,7934,0,1154,0,0,0,0,0,1154,0,1154,0,0,0,0,0,1154,0,2308,0,0,0,0,0,2308,,,EMERALD ASH BORER (EAB) REMOVE AND REPLACE,cpd11-20cw.pdf
P-6ELUT15,FY15 site utility (dig job) electric M104-219M,846,DEPT OF PARKS AND RECREATION,"LARGE, MAJOR AND REGIONAL PARK RECONSTRUCTION",,CITYWIDE,P-0245M P-1106,1336,197,1820,0,0,0,0,0,2017,197,1820,0,0,0,0,0,2017,394,3640,0,0,0,0,0,4034,,CITYWIDE,FY15 SITE UTILITY (DIG JOB) ELECTRIC - $1 CONTRACT,cpd11-20cw.pdf
P-6ENVTST,Citywide environment testing at DPR facilities CNYG-119M,846,DEPT OF PARKS AND RECREATION,NEIGHBORHOOD PARKS AND PLAYGROUNDS,,CITYWIDE,P-1018 P-1249 P-1008,0,0,266,0,0,0,0,0,266,0,266,0,0,0,0,0,266,0,532,0,0,0,0,0,532,,CITYWIDE,CITYWIDE ENVIRONMENT TESTING AT DPR FACILITIES,cpd11-20cw.pdf
P-6FLMMUL,Fire Alarm - Rec Ctr & Nature Ctr Citywide CNYG-1217M,846,DEPT OF PARKS AND RECREATION,MAJOR RECREATIONAL FACILITIES AND FACILITY RECONSTRUCTION,,CITYWIDE,P-0506,8451,770,0,427,0,0,0,0,1197,770,0,427,0,0,0,0,1197,1540,0,854,0,0,0,0,2394,,CITYWIDE,FIRE ALARM - REC CTR & NATURE CTR CITYWIDE....TRANSFER $92K P-0506 FY21 TO,cpd11-20cw.pdf
P-6FNCE01,"GreenThumb Capital Fencing Work, Citywide",846,DEPT OF PARKS AND RECREATION,NEIGHBORHOOD PARKS AND PLAYGROUNDS,,CITYWIDE,P-1018,0,0,444,0,0,0,0,0,444,0,444,0,0,0,0,0,444,0,888,0,0,0,0,0,888,,CITYWIDE,"GREENTHUMB CAPITAL FENCING WORK, CITYWIDE",cpd11-20cw.pdf
P-6GASBSI,CONVERSION OF OIL TO GAS BKLYN & SI CNYG-1914M,846,DEPT OF PARKS AND RECREATION,"LARGE, MAJOR AND REGIONAL PARK RECONSTRUCTION",,CITYWIDE,P-1250,1250,156,0,0,3500,0,0,0,3656,156,0,0,3500,0,0,0,3656,312,0,0,7000,0,0,0,7312,,CONVERSION OF OIL TO GAS BKLYN & SI,CONVERSION OF OIL TO GAS BROOKLYN & STATEN ISLAND,cpd11-20cw.pdf
P-6GASBXQ,CONVERSION OF OIL TO GAS BX & QNS CNYG-1814M,846,DEPT OF PARKS AND RECREATION,"LARGE, MAJOR AND REGIONAL PARK RECONSTRUCTION",,CITYWIDE,P-1250,2100,247,48,0,0,0,0,0,295,247,48,0,0,0,0,0,295,494,96,0,0,0,0,0,590,,CONVERSION OF OIL TO GAS BX & QNS,CONVERSION OF OIL TO GAS IN BRONX & QUEENS,cpd11-20cw.pdf
P-6GASMAN,CONVERSION OF OIL TO GAS MANHATTAN MG-814M,846,DEPT OF PARKS AND RECREATION,"LARGE, MAJOR AND REGIONAL PARK RECONSTRUCTION",,CITYWIDE,P-1250,1750,185,164,161,0,0,0,0,510,185,164,161,0,0,0,0,510,370,328,322,0,0,0,0,1020,,CONVERSION OF OIL TO GAS MANHATTAN,CONVERSION OF OIL TO GAS MANHATTAN,cpd11-20cw.pdf
P-6GDRL15,FY15 Citywide guiderail & fencing CNYG-2015M,846,DEPT OF PARKS AND RECREATION,"LARGE, MAJOR AND REGIONAL PARK RECONSTRUCTION",,CITYWIDE,P-1018,901,204,0,0,0,0,0,0,204,204,0,0,0,0,0,0,204,408,0,0,0,0,0,0,408,,CITYWIDE,FY15 CITYWIDE GUIDERAIL & FENCING,cpd11-20cw.pdf
P-6GRST16,FY16 Greenstreets - CITYWIDE,846,DEPT OF PARKS AND RECREATION,LAND ACQUISITION AND TREE PLANTING,000,CITYWIDE,P-D822 P-0822 P-Q245 P-Q822 ED-Q384 P-D171,595,415,0,2039,202,0,0,0,2656,415,0,2039,202,0,0,0,2656,830,0,4078,404,0,0,0,5312,PROJECT DELAYED DUE TO CHANGES IN SCOPE/DESIGN,FY 16 ADOPT SECT 254. ADD (PD822) $150K(UNION & 9TH ST) AND $35K(66THST)...,FY 16 ADOPT SECT 254. ADD (PD822) $150K(UNION & 9TH ST) AND $35K(66THST)...,cpd11-20cw.pdf
P-6LIGHT1,Construction Of Multisite Path Lighting,846,DEPT OF PARKS AND RECREATION,NEIGHBORHOOD PARKS AND PLAYGROUNDS,000,CITYWIDE,P-1018 P-D021 P-0087,1016,73,363,435,0,0,0,0,871,73,363,435,0,0,0,0,871,146,726,870,0,0,0,0,1742,,,CONSTRUCTION OF MULTISITE PATH LIGHTING-KISSENA CORRIDOR PARK AND CO-OP CITY BIKE PATH,cpd11-20cw.pdf
P-6MSHVAC,Recon HVAC at Greenbelt R/C & Queens Museum CNYG-1318M,846,DEPT OF PARKS AND RECREATION,NEIGHBORHOOD PARKS AND PLAYGROUNDS,,CITYWIDE,P-0505 P-1250 PU-0025,650,227,848,578,0,0,0,0,1653,227,848,578,0,0,0,0,1653,454,1696,1156,0,0,0,0,3306,,GREENBELT R/C & QUEENS MUSEUM,RECON HVAC AT GREENBELT R/C & QUEENS MUSEUM,cpd11-20cw.pdf
P-6NCRC15,FY15 Citywide Nature & Rec Ctr CNYG-1215MA,846,DEPT OF PARKS AND RECREATION,"LARGE, MAJOR AND REGIONAL PARK RECONSTRUCTION",,CITYWIDE,P-D018 P-M245,620,85,0,400,0,0,0,0,485,85,0,400,0,0,0,0,485,170,0,800,0,0,0,0,970,,CITYWIDE,FY15 CITYWIDE NAURE & REC CTR,cpd11-20cw.pdf
P-6NRGF01,NRG - Bronx & Queens Reforestation FY'20 CNYG-3019MA,846,DEPT OF PARKS AND RECREATION,LAND ACQUISITION AND TREE PLANTING,000,CITYWIDE,P-0822,0,0,0,1035,0,0,0,0,1035,0,0,1035,0,0,0,0,1035,0,0,2070,0,0,0,0,2070,,BOROUGHS OF BRONX & QUEENS,BRONX AND QUEENS REFORESTATION,cpd11-20cw.pdf
P-6OLYMPL,Citywide Olympic Pool Mechanical Systems Recon CNYG-2719M,846,DEPT OF PARKS AND RECREATION,MAJOR RECREATIONAL FACILITIES AND FACILITY RECONSTRUCTION,,CITYWIDE,P-1008,2985,214,327,818,0,0,0,0,1359,214,327,818,0,0,0,0,1359,428,654,1636,0,0,0,0,2718,,CITYWIDE,CITYWIDE OLYMPIC POOL MECHANICAL SYSTEMS RECON,cpd11-20cw.pdf
P-6ORCAST,Recon Orchard Beach Nature Center,846,DEPT OF PARKS AND RECREATION,NEIGHBORHOOD PARKS AND PLAYGROUNDS,,CITYWIDE,P-1018 P-0505,2990,213,0,2350,0,0,0,0,2563,213,0,2350,0,0,0,0,2563,426,0,4700,0,0,0,0,5126,,BRONX & QUEENS,RECON ORCHARD BEACH N/C & ASTORIA PARK F/H,cpd11-20cw.pdf
P-6PBBP15,FY15 Recon plumbing system in bldg & pool CW CNYG-1415M,846,DEPT OF PARKS AND RECREATION,"LARGE, MAJOR AND REGIONAL PARK RECONSTRUCTION",,CITYWIDE,P-D019 P-1018,483,570,35,23,0,0,0,0,628,570,35,23,0,0,0,0,628,1140,70,46,0,0,0,0,1256,,CITYWIDE,FY15 RECON PLUMBING SYSTEM IN BLDG & POOL CW,cpd11-20cw.pdf
P-6PBUT15,FY15 site utility (dig job) plumbing CNYG-1815M,846,DEPT OF PARKS AND RECREATION,"LARGE, MAJOR AND REGIONAL PARK RECONSTRUCTION",,CITYWIDE,P-1018 PU-0025,1016,653,191,0,0,0,0,0,844,653,191,0,0,0,0,0,844,1306,382,0,0,0,0,0,1688,,CITYWIDE,FY15 SITE UTILITY (DIG JOB) PLUMBING - $1 CONTRACT,cpd11-20cw.pdf
P-6PDRFMN,Recon roofs at Parks facilities in Manhattan MG-215M,846,DEPT OF PARKS AND RECREATION,MAJOR RECREATIONAL FACILITIES AND FACILITY RECONSTRUCTION,000,CITYWIDE,P-1018,1750,2591,137,0,0,0,0,0,2728,2591,137,0,0,0,0,0,2728,5182,274,0,0,0,0,0,5456,,RECON ROOFS AT PARKS FACILITIES IN MANHATTAN,RECON ROOFS AT PARKS FACILITIES IN MANHATTAN,cpd11-20cw.pdf
P-6PKTREE,Park Trees - Maintain Stem Count,846,DEPT OF PARKS AND RECREATION,LAND ACQUISITION AND TREE PLANTING,099,CITYWIDE,P-0822,13524,260,0,0,7915,0,0,0,8175,260,0,0,7915,0,0,0,8175,520,0,0,15830,0,0,0,16350,,PARK TREES - MAINTAIN STEM COUNT,PARK TREES - MAINTAIN STEM COUNT,cpd11-20cw.pdf
P-6PLAYFA,PLAYFAIR CAPITAL WORK,846,DEPT OF PARKS AND RECREATION,NEIGHBORHOOD PARKS AND PLAYGROUNDS,,CITYWIDE,P-1018,0,60,0,0,3210,0,0,0,3270,60,0,0,3210,0,0,0,3270,120,0,0,6420,0,0,0,6540,,,PLAYFAIR CAPITAL WORK,cpd11-20cw.pdf
P-6PLFLTR,Recon of intermediate pool filter plants citywide CNYG-619M,846,DEPT OF PARKS AND RECREATION,NEIGHBORHOOD PARKS AND PLAYGROUNDS,000,CITYWIDE,P-1008 P-1249 P-1018,3200,291,0,4178,0,0,0,0,4469,291,0,4178,0,0,0,0,4469,582,0,8356,0,0,0,0,8938,,CITYWIDE,RECON OF INTERMEDIATE POOL FILTER PLANTS CITYWIDE,cpd11-20cw.pdf
P-6PLHNGR,Recon of citywide pool piping hangers & supports CNYG-419M,846,DEPT OF PARKS AND RECREATION,NEIGHBORHOOD PARKS AND PLAYGROUNDS,000,CITYWIDE,P-1008 P-1018,0,1584,1,170,0,0,0,0,1755,1584,1,170,0,0,0,0,1755,3168,2,340,0,0,0,0,3510,,CITYWIDE,RECON OF CITYWIDE POOL PIPING HANGERS & SUPPORTS,cpd11-20cw.pdf
P-6PNYCST,PlaNYC 2030 Street Trees,846,DEPT OF PARKS AND RECREATION,LAND ACQUISITION AND TREE PLANTING,,CITYWIDE,P-0822,244790,0,0,2143,0,0,0,0,2143,0,0,2143,0,0,0,0,2143,0,0,4286,0,0,0,0,4286,PROJECT DELAYED DUE TO UNFORESEEN SITE/FIELD CONDITION,$848K TO P-4PNYT31..FY20 TRF $224K TO P-6PNYR36..FY'20 TRF IN $286K (P 0822) FR P-6PNYT24...,(P0822) TO P-4PNYT26...FY 16 TRF $1.285M (P 0822) TO P-6PNYT22... TRF$1.321M (P0822) TO,cpd11-20cw.pdf
P-6PNYDOT,PlaNYC - Street Trees,846,DEPT OF PARKS AND RECREATION,LAND ACQUISITION AND TREE PLANTING,000,CITYWIDE,P-0822,20131,0,0,0,1025,0,0,0,1025,0,0,0,1025,0,0,0,1025,0,0,0,2050,0,0,0,2050,PROJECT DELAYED DUE TO UNFORESEEN SITE/FIELD CONDITION,CW,PLANYC - STREET TREES (DOT CONSTRUCTION PJCTS) - FY20 TRF $43K TO P-6TREPLS...FY20 TRF IN,cpd11-20cw.pdf
P-6PNYG05,PlaNYC - FY09 Spring Greenstreets (CNYG-2109M),846,DEPT OF PARKS AND RECREATION,LAND ACQUISITION AND TREE PLANTING,000,CITYWIDE,P-D171,769,696,0,73,0,0,0,0,769,696,0,73,0,0,0,0,769,1392,0,146,0,0,0,0,1538,,CW,FY09 SPRING GREENSTREETS,cpd11-20cw.pdf
P-6PNYR34,"PlaNYC - Reforestatiob Bk,Que,& SI FY17-25 (CNYG-3816M)",846,DEPT OF PARKS AND RECREATION,LAND ACQUISITION AND TREE PLANTING,000,CITYWIDE,P-0822,500,514,0,0,92,0,0,0,606,514,0,0,92,0,0,0,606,1028,0,0,184,0,0,0,1212,,"PLANYC - REFORESTATION BK,QUE,& SI FY17-25","PLANYC - REFORESTATIOB BK,QUE,& SI FY17-25",cpd11-20cw.pdf
P-6PNYR36,"PlaNYC - FY18 Reforestation Br,Q &SI",846,DEPT OF PARKS AND RECREATION,LAND ACQUISITION AND TREE PLANTING,000,CITYWIDE,P-0822,2005,1724,316,0,0,0,0,0,2040,1724,316,0,0,0,0,0,2040,3448,632,0,0,0,0,0,4080,,CITYWIDE,"PLANYC - FY18 REFORESTATION BR,Q &SI",cpd11-20cw.pdf
P-6PNYR37,PlaNYC - FY18 Reforestation Bx & Mnt,846,DEPT OF PARKS AND RECREATION,LAND ACQUISITION AND TREE PLANTING,000,CITYWIDE,P-0822,1411,1203,37,0,0,0,0,0,1240,1203,37,0,0,0,0,0,1240,2406,74,0,0,0,0,0,2480,,CITYWIDE,PLANYC - FY18 REFORESTATION BX & MNT,cpd11-20cw.pdf
P-6PNYT25,PlaNYC - FY21 Citiwide Tree Guard Installation,846,DEPT OF PARKS AND RECREATION,LAND ACQUISITION AND TREE PLANTING,000,CITYWIDE,P-0822,842,0,842,0,0,0,0,0,842,0,842,0,0,0,0,0,842,0,1684,0,0,0,0,0,1684,,PLANYC - FY121 CITIWIDE TREE GUARD INSTALLATION,PLANYC - FY121 CITIWIDE TREE GUARD INSTALLATION,cpd11-20cw.pdf
P-6POGC15,FY15 Citywide pool structure CNYG-1515M,846,DEPT OF PARKS AND RECREATION,"LARGE, MAJOR AND REGIONAL PARK RECONSTRUCTION",,CITYWIDE,P-1008,901,1058,2,249,0,0,0,0,1309,1058,2,249,0,0,0,0,1309,2116,4,498,0,0,0,0,2618,,CITYWIDE,FY15 CITYWIDE POOL STRUCTURE,cpd11-20cw.pdf
P-6POL11A,FY11 Recnstr of electrical system for pools CNYG-1611M,846,DEPT OF PARKS AND RECREATION,NEIGHBORHOOD PARKS AND PLAYGROUNDS,,CITYWIDE,P-1018,500,1111,0,84,0,0,0,0,1195,1111,0,84,0,0,0,0,1195,2222,0,168,0,0,0,0,2390,,CITYWIDE,RECONSTRUCTION OF DETERIORATED ELECTRICAL SYSTEMS FOR VARIOUS PARKS AND RECREATION,cpd11-20cw.pdf
P-6POOL18,Recon Citywide pools $1 Contract CNYG-918M,846,DEPT OF PARKS AND RECREATION,NEIGHBORHOOD PARKS AND PLAYGROUNDS,,CITYWIDE,P-1008,1529,109,0,300,0,0,0,0,409,109,0,300,0,0,0,0,409,218,0,600,0,0,0,0,818,,CITYWIDE,RECON CITYWIDE POOLS $1 CONTRACT,cpd11-20cw.pdf
P-6PRKLOT,Recon 5Boro & Garage complex prkg lot M104-117M,846,DEPT OF PARKS AND RECREATION,"LARGE, MAJOR AND REGIONAL PARK RECONSTRUCTION",000,CITYWIDE,P-1018,1500,1461,573,0,0,0,0,0,2034,1461,573,0,0,0,0,0,2034,2922,1146,0,0,0,0,0,4068,,RECON 5BORO & GARAGE COMPLEX PRKG LOT,RECON 5BORO & GARAGE COMPLEX PRKG LOT,cpd11-20cw.pdf
P-6PVMNT1,Reconstruct pavement various Parks CNYG-117MA,846,DEPT OF PARKS AND RECREATION,NEIGHBORHOOD PARKS AND PLAYGROUNDS,,CITYWIDE,P-1018,1,1514,540,0,0,0,0,0,2054,1514,540,0,0,0,0,0,2054,3028,1080,0,0,0,0,0,4108,,VARIOUS PARKS AND RECREATION LOCATIONS,DOLLAR CONTRACT WILL RECONSTRUCT PAVEMENT SURFACES AT VARIOUS PARKS AND RECREATION,cpd11-20cw.pdf
P-6PVMNT2,Citywide Pavement Reconstruction 2 CNYG-1618M,846,DEPT OF PARKS AND RECREATION,NEIGHBORHOOD PARKS AND PLAYGROUNDS,,CITYWIDE,P-1018,1,2255,255,0,0,0,0,0,2510,2255,255,0,0,0,0,0,2510,4510,510,0,0,0,0,0,5020,,CITYWIDE,THIS DOLLAR CONTRACT WILL RECONSTRUCT PAVEMENT SURFACES AT VARIOUS PARKS AND,cpd11-20cw.pdf
P-6REC07B,FY07 Recreation & Nature Centers (Elec) - CNYG-1807M,846,DEPT OF PARKS AND RECREATION,MAJOR RECREATIONAL FACILITIES AND FACILITY RECONSTRUCTION,,CITYWIDE,P-1018,916,584,0,0,274,0,0,0,858,584,0,0,274,0,0,0,858,1168,0,0,548,0,0,0,1716,,CW,FY07 RECREATION & NATURE CENTERS (ELEC) - CNYG-1807M,cpd11-20cw.pdf
P-6REC07D,FY07 Recreation & Nature Centers (HVAC) - CNYG-2007MA2,846,DEPT OF PARKS AND RECREATION,MAJOR RECREATIONAL FACILITIES AND FACILITY RECONSTRUCTION,,CITYWIDE,P-Q245,1145,9,0,0,200,0,0,0,209,9,0,0,200,0,0,0,209,18,0,0,400,0,0,0,418,PROJECT DELAYED DUE TO UNFORESEEN SITE/FIELD CONDITION,CW,FY07 RECREATION & NATURE CENTERS (HVAC) - CNYG-2007M,cpd11-20cw.pdf
P-6REC11B,"Queens, Brooklyn & SI HVAC systems CNYG-1910MA1",846,DEPT OF PARKS AND RECREATION,"LARGE, MAJOR AND REGIONAL PARK RECONSTRUCTION",000,CITYWIDE,P-1018,250,870,63,0,0,0,0,0,933,870,63,0,0,0,0,0,933,1740,126,0,0,0,0,0,1866,PROJECT DELAYED DUE TO UNFORESEEN SITE/FIELD CONDITION,"RECREATION AND NATURE CENTERS IN QUEENS, BROOKLYN AND SI","RECONSTRUCTION OF HVAC SYSTEMS IN REC AND NATURE SENTERS IN THE QUEENS, BROOKLYN AND",cpd11-20cw.pdf
P-6REF20A,Reforestation FY20 Br & Que CB8-14,846,DEPT OF PARKS AND RECREATION,LAND ACQUISITION AND TREE PLANTING,000,CITYWIDE,P-0822,1065,30,1065,0,0,0,0,0,1095,30,1065,0,0,0,0,0,1095,60,2130,0,0,0,0,0,2190,,REFORESTATION FY20 BR & QUE CB8-14,REFORESTATION FY20 BR & QUE CB8-14,cpd11-20cw.pdf
P-6REF20B,Reforestation FY20 BX & Que CB 1-7,846,DEPT OF PARKS AND RECREATION,LAND ACQUISITION AND TREE PLANTING,000,CITYWIDE,P-0822,1135,90,1135,0,0,0,0,0,1225,90,1135,0,0,0,0,0,1225,180,2270,0,0,0,0,0,2450,,REFORESTATION FY20 BX & QUE CB 1-7,REFORESTATION FY20 BX & QUE CB 1-7,cpd11-20cw.pdf
P-6REMT35,"Non Sandy Tree Removal Bx, Mht, Qn",846,DEPT OF PARKS AND RECREATION,LAND ACQUISITION AND TREE PLANTING,000,CITYWIDE,P-0822,210,95,114,1,0,0,0,0,210,95,114,1,0,0,0,0,210,190,228,2,0,0,0,0,420,,CITYWIDE,"NON SANDY TREE REMOVAL BX, MHT, QN",cpd11-20cw.pdf
P-6REMT37,"Tree Removal Bx, Mht, Qn FY19",846,DEPT OF PARKS AND RECREATION,LAND ACQUISITION AND TREE PLANTING,000,CITYWIDE,P-0822,1013,277,736,0,0,0,0,0,1013,277,736,0,0,0,0,0,1013,554,1472,0,0,0,0,0,2026,,"NON SANDY TREE REMOVAL BX, MHT, QN FY19","NON SANDY TREE REMOVAL BX, MHT, QN FY19",cpd11-20cw.pdf
P-6REQ1,State of Good Repair - CW,846,DEPT OF PARKS AND RECREATION,NEIGHBORHOOD PARKS AND PLAYGROUNDS,000,CITYWIDE,P-1018,23342,0,0,0,0,842,0,0,842,0,0,0,0,842,0,0,842,0,0,0,0,1684,0,0,1684,,$3597K P1018 FY24 TRSF FR P-6CWSSPE..,STATE OF GOOD REPAIR - CW - FY'20 TRF $250K TO P-1PUTNAM...,cpd11-20cw.pdf
P-6REQU,State of Good Repair - CW,846,DEPT OF PARKS AND RECREATION,NEIGHBORHOOD PARKS AND PLAYGROUNDS,000,CITYWIDE,P-1018,15000,0,0,0,0,4703,11750,24943,41396,0,0,0,0,4703,11750,24943,41396,0,0,0,0,9406,23500,49886,82792,PROJECT DELAYED DUE TO CHANGES IN SCOPE/DESIGN,FY'18 TRF $137K TO P-214LTFN...4/5/18 $673K TO P-4HCOVPG...FY'19 TRF $557K TO P-303SDRB... XFER,"REQUIREMENTS - CITYWIDE.. FY26 $23.274 & FY27 $23,832...FY18 ARP PLAN",cpd11-20cw.pdf
P-6RETW11,FY11-Reconstr & stabilization of retaining walls CNYG-1511M,846,DEPT OF PARKS AND RECREATION,NEIGHBORHOOD PARKS AND PLAYGROUNDS,,CITYWIDE,P-D018,1502,3673,0,571,0,0,0,0,4244,3673,0,571,0,0,0,0,4244,7346,0,1142,0,0,0,0,8488,PROJECT DELAYED DUE TO CHANGES IN SCOPE/DESIGN,CITYWIDE,FY11 RECONSTRUCTION AND STABILIZATION OF RETAINING WALLS,cpd11-20cw.pdf
P-6RETW14,Retaining Wall R/C (CNYG-514M),846,DEPT OF PARKS AND RECREATION,NEIGHBORHOOD PARKS AND PLAYGROUNDS,099,CITYWIDE,P-1329 P-D018,24853,23990,1953,1059,2031,0,0,0,29033,23990,1953,1059,2031,0,0,0,29033,47980,3906,2118,4062,0,0,0,58066,PROJECT DELAYED DUE TO UNFORESEEN SITE/FIELD CONDITION,CITYWIDE,THE RECONSTRUCTION AND STABILIZATION OF RETAINING WALLS - CITYWIDE,cpd11-20cw.pdf
P-6RETW18,Citywide Retaining Wall FY18 CNYG-1818M,846,DEPT OF PARKS AND RECREATION,NEIGHBORHOOD PARKS AND PLAYGROUNDS,099,CITYWIDE,P-1329,8081,891,3000,2308,6000,0,0,0,12199,891,3000,2308,6000,0,0,0,12199,1782,6000,4616,12000,0,0,0,24398,,CITYWIDE,CITYWIDE RETAINING WALL FY18,cpd11-20cw.pdf
P-6RFMN14,FY14 RECON ROOFINGS IN MANHATTAN MG-614M,846,DEPT OF PARKS AND RECREATION,"LARGE, MAJOR AND REGIONAL PARK RECONSTRUCTION",,CITYWIDE,P-1249,1980,1310,170,296,0,0,0,0,1776,1310,170,296,0,0,0,0,1776,2620,340,592,0,0,0,0,3552,,FY14 RECON ROOFINGS IN MANHATTAN,FY14 RECON ROOFINGS IN MANHATTAN,cpd11-20cw.pdf
P-6ROOF14,FY14 Roof Requirements for Bronx & Queens CNYG-1114M,846,DEPT OF PARKS AND RECREATION,"LARGE, MAJOR AND REGIONAL PARK RECONSTRUCTION",,CITYWIDE,P-1249,2590,2234,0,39,0,0,0,0,2273,2234,0,39,0,0,0,0,2273,4468,0,78,0,0,0,0,4546,,CITYWIDE,FY14 ROOF REQUIREMENTS,cpd11-20cw.pdf
P-6ROOF15,FY15 Citywide roofing CNYG-1115M,846,DEPT OF PARKS AND RECREATION,"LARGE, MAJOR AND REGIONAL PARK RECONSTRUCTION",,CITYWIDE,P-1249,1041,1304,246,0,0,0,0,0,1550,1304,246,0,0,0,0,0,1550,2608,492,0,0,0,0,0,3100,,CITYWIDE,FY15 CITYWIDE ROOFING,cpd11-20cw.pdf
P-6ROOF9A,FY09 Roof Requirements QNS & BX (CNYG-3009M),846,DEPT OF PARKS AND RECREATION,MAJOR RECREATIONAL FACILITIES AND FACILITY RECONSTRUCTION,000,CITYWIDE,P-Q245,2403,5509,0,330,0,0,0,0,5839,5509,0,330,0,0,0,0,5839,11018,0,660,0,0,0,0,11678,PROJECT DELAYED DUE TO CHANGES IN SCOPE/DESIGN,QNS & BX,FY09 ROOF REQUIREMENTS QNS & BX,cpd11-20cw.pdf
P-6RPZBKQ,Brooklyn & Queens Multi-Site RPZ Installation,846,DEPT OF PARKS AND RECREATION,NEIGHBORHOOD PARKS AND PLAYGROUNDS,000,CITYWIDE,P-1250,1300,0,0,0,1000,0,0,0,1000,0,0,0,1000,0,0,0,1000,0,0,0,2000,0,0,0,2000,,CITYWIDE,BROOKLYN & QUEENS MULTI-SITE RPZ INSTALLATION,cpd11-20cw.pdf
P-6SANDT1,"FY18 Sandy Related Tree Replacement - Q, X, M",846,DEPT OF PARKS AND RECREATION,LAND ACQUISITION AND TREE PLANTING,000,CITYWIDE,P-0822,0,2280,0,424,0,0,0,0,2704,2280,0,424,0,0,0,0,2704,4560,0,848,0,0,0,0,5408,,,"FY18 SANDY RELATED TREE REPLACEMENT - Q, X, M",cpd11-20cw.pdf
P-6SECBOL,Parks Security Measures Citywide,846,DEPT OF PARKS AND RECREATION,NEIGHBORHOOD PARKS AND PLAYGROUNDS,,CITYWIDE,P-1095,33740,1081,404,0,3385,0,0,0,4870,1081,404,0,3385,0,0,0,4870,2162,808,0,6770,0,0,0,9740,,CITYWIDE,PARKS SECURITY BOLLARDS CITYWIDE,cpd11-20cw.pdf
P-6SPCR15,NRG - Spring Creek Salt Marsh Restoration CNYG-2715M,846,DEPT OF PARKS AND RECREATION,LAND ACQUISITION AND TREE PLANTING,000,CITYWIDE,P-1327,2000,1171,1460,6477,0,0,0,0,9108,1171,1460,6477,0,0,0,0,9108,2342,2920,12954,0,0,0,0,18216,PROJECT DELAYED PENDING NON-CITY GRANT APPROVAL,BORDERS THE BOROUGHS OF BROOKLYN AND QUEENS.,SPRING CREEK SALT MARSH AND COASTAL UPLAND RESTORATION,cpd11-20cw.pdf
P-6STRUC1,Citywide structural stabilization - Multisite CNYG-1617M,846,DEPT OF PARKS AND RECREATION,MAJOR RECREATIONAL FACILITIES AND FACILITY RECONSTRUCTION,,CITYWIDE,P-0505 P-D018,1267,209,1150,0,0,0,0,0,1359,209,1150,0,0,0,0,0,1359,418,2300,0,0,0,0,0,2718,,CITYWIDE,CITYWIDE STRUCTURAL STABILIZATION - MULTISITE - FOR METROPOLITAN POOL& E54TH ST REC CTR...,cpd11-20cw.pdf
P-6STURF1,Reconstruction of Synthetic Turf Fields Citywide MG-718M,846,DEPT OF PARKS AND RECREATION,"LARGE, MAJOR AND REGIONAL PARK RECONSTRUCTION",000,CITYWIDE,P-0510,4771,2084,0,0,2090,0,0,0,4174,2084,0,0,2090,0,0,0,4174,4168,0,0,4180,0,0,0,8348,,CITYWIDE,RECONSTRUCTION OF SYNTHETIC TURF FIELDS CITYWIDE,cpd11-20cw.pdf
P-6TRAI20,FY19 NRG Arden Woods Trail Construction,846,DEPT OF PARKS AND RECREATION,LAND ACQUISITION AND TREE PLANTING,000,CITYWIDE,P-D019 P-R245 P-D021 P-0822,522,35,567,0,0,0,0,0,602,35,567,0,0,0,0,0,602,70,1134,0,0,0,0,0,1204,,"BX,QUE,SI TRAIL R/C, & PLANTING TREES","BX,QUE,SI TRAIL R/C, & PLANTING TREES",cpd11-20cw.pdf
P-6TRBRSI,Park Trees-Trees Replanting Brooklyn & SI,846,DEPT OF PARKS AND RECREATION,LAND ACQUISITION AND TREE PLANTING,000,CITYWIDE,P-0822,2964,143,0,30,2180,0,0,0,2353,143,0,30,2180,0,0,0,2353,286,0,60,4360,0,0,0,4706,,PARK TREES-TREES REPLANTING BROOKLYN & SI,PARK TREES-TREES REPLANTING BROOKLYN & SI,cpd11-20cw.pdf
P-6TRE18A,Street Trees Supervision FY18,846,DEPT OF PARKS AND RECREATION,LAND ACQUISITION AND TREE PLANTING,000,CITYWIDE,P-0822,3813,1227,1173,0,0,0,0,0,2400,1227,1173,0,0,0,0,0,2400,2454,2346,0,0,0,0,0,4800,,STREET TREES SUPERVISION FY18,STREET TREES SUPERVISION FY18,cpd11-20cw.pdf
P-6TRE19A,Street Trees Supervision FY19,846,DEPT OF PARKS AND RECREATION,LAND ACQUISITION AND TREE PLANTING,000,CITYWIDE,P-0822,1142,0,958,0,0,0,0,0,958,0,958,0,0,0,0,0,958,0,1916,0,0,0,0,0,1916,,STREET TREES SUPERVISION FY19,STREET TREES SUPERVISION FY19,cpd11-20cw.pdf
P-6TRE21S,FY21 Street Trees Supervision,846,DEPT OF PARKS AND RECREATION,LAND ACQUISITION AND TREE PLANTING,000,CITYWIDE,P-0822,905,0,1805,0,0,0,0,0,1805,0,1805,0,0,0,0,0,1805,0,3610,0,0,0,0,0,3610,,FY21 STREET TREES SUPERVISION,FY21 STREET TREES SUPERVISION,cpd11-20cw.pdf
P-6TREEP1,Procurement of Street Trees Region 1-CNYG-3916M,846,DEPT OF PARKS AND RECREATION,LAND ACQUISITION AND TREE PLANTING,,CITYWIDE,P-0822,13800,14765,783,0,0,0,0,0,15548,14765,783,0,0,0,0,0,15548,29530,1566,0,0,0,0,0,31096,,CITYWIDE,PROCUREMENT OF STREET TREES REGION 1-CNYG-3916M,cpd11-20cw.pdf
P-6TREEP2,Procurement of Street Trees Region 2-CNYG-4016M,846,DEPT OF PARKS AND RECREATION,LAND ACQUISITION AND TREE PLANTING,,CITYWIDE,P-0822,13800,10180,2876,0,0,0,0,0,13056,10180,2876,0,0,0,0,0,13056,20360,5752,0,0,0,0,0,26112,,CITYWIDE,PROCUREMENT OF STREET TREES REGION 2-CNYG-4016M,cpd11-20cw.pdf
P-6TREES2,RISK MANAGEMENT TREES,846,DEPT OF PARKS AND RECREATION,LAND ACQUISITION AND TREE PLANTING,000,CITYWIDE,P-0822,2000,0,214,0,0,0,0,0,214,0,214,0,0,0,0,0,214,0,428,0,0,0,0,0,428,PROJECT DELAYED DUE TO CHANGES IN SCOPE/DESIGN,CITYWIDE,RISK MANAGEMENT TREES,cpd11-20cw.pdf
P-6TREESB,TREES - CITYWIDE,846,DEPT OF PARKS AND RECREATION,LAND ACQUISITION AND TREE PLANTING,099,CITYWIDE,S-0216 P-0822 SE-0200Q P-D822 P-1018 WP-0169 WM-0006 HB-0215 HB-1193,74316,0,969,2067,2098,0,24179,40000,69313,0,969,2067,2098,0,24179,40000,69313,0,1938,4134,4196,0,48358,80000,138626,,"$1,595K TO P-4TRE20B..$1,800K TO P-3TRE20B..$1,188K TO P-2TRE20E..$769K TO P-2TRE20C $296K TO",$45K FY19 TR FR GXBXGI-01..$MTA CHECK RESTITUTION CANARSIE TUBE MNHT $556K..$4K ED0409)TR,cpd11-20cw.pdf
P-6TREGRD,FY21 CitywideTree Guards,846,DEPT OF PARKS AND RECREATION,LAND ACQUISITION AND TREE PLANTING,,CITYWIDE,P-0822,420,0,149,0,0,0,0,0,149,0,149,0,0,0,0,0,149,0,298,0,0,0,0,0,298,,FY21 CITYWIDETREE GUARDS,FY21 CITYWIDETREE GUARDS,cpd11-20cw.pdf
P-6TREL21,FY21 Street Tree Long Term Supervision,846,DEPT OF PARKS AND RECREATION,LAND ACQUISITION AND TREE PLANTING,000,CITYWIDE,WM-0006 P-0822,1636,0,255,2581,0,0,0,0,2836,0,255,2581,0,0,0,0,2836,0,510,5162,0,0,0,0,5672,,FY21 STREET TREE LONG TERM SUPERVISION,FY21 STREET TREE LONG TERM SUPERVISION,cpd11-20cw.pdf
P-6TREPLN,Forest Replacement Planting,846,DEPT OF PARKS AND RECREATION,LAND ACQUISITION AND TREE PLANTING,099,CITYWIDE,P-0245R WM-0001 WM-0006 ED-0075,293,0,6595,0,293,0,0,0,6888,0,6595,0,293,0,0,0,6888,0,13190,0,586,0,0,0,13776,,CITYWIDE,FOREST REPLACEMENT PLANTING,cpd11-20cw.pdf
P-6TREPLS,Street & Park Tree Replacement Planting,846,DEPT OF PARKS AND RECREATION,LAND ACQUISITION AND TREE PLANTING,099,CITYWIDE,SE-0002Q P-0822 SE-0002M P-0245R WM-0001 SE-0200K SE-0002K WM-0006 SE-0200R,5821,0,4332,2327,4718,0,0,0,11377,0,4332,2327,4718,0,0,0,11377,0,8664,4654,9436,0,0,0,22754,,CITYWIDE,STREET & PARK TREE REPLACEMENT PLANTING,cpd11-20cw.pdf
P-6TRREMD,TREE REMEDIATION- Sandy Damaged Trees,846,DEPT OF PARKS AND RECREATION,LAND ACQUISITION AND TREE PLANTING,,CITYWIDE,P-0822,9580,0,185,0,1821,0,0,0,2006,0,185,0,1821,0,0,0,2006,0,370,0,3642,0,0,0,4012,PROJECT DELAYED DUE TO CHANGES IN SCOPE/DESIGN,CITYWIDE,TREE REMEDIATION,cpd11-20cw.pdf
P-6TRS19A,Citywide- R/C Sidewalks Damaged by Trees Supervision,846,DEPT OF PARKS AND RECREATION,LAND ACQUISITION AND TREE PLANTING,000,CITYWIDE,P-1331,1691,1399,583,0,0,0,0,0,1982,1399,583,0,0,0,0,0,1982,2798,1166,0,0,0,0,0,3964,,CITYWIDE- R/C SIDEWALKS DAMAGED BY TREES SUPERVISION,CITYWIDE- R/C SIDEWALKS DAMAGED BY TREES SUPERVISION,cpd11-20cw.pdf
P-6TRSD19,Bronx & Mnht- R/C Sidewalks Damaged by Trees,846,DEPT OF PARKS AND RECREATION,LAND ACQUISITION AND TREE PLANTING,000,CITYWIDE,P-1331,1259,1065,1139,0,0,0,0,0,2204,1065,1139,0,0,0,0,0,2204,2130,2278,0,0,0,0,0,4408,,BRONX & MNHT-,BRONX & MNHT- R/C SIDEWALKS DAMAGED BY TREES,cpd11-20cw.pdf
P-6TRSDWK,Citywide- R/C Sidewalks Damaged by Trees,846,DEPT OF PARKS AND RECREATION,LAND ACQUISITION AND TREE PLANTING,000,CITYWIDE,P-D822 P-1018,13227,0,0,11500,5000,0,0,0,16500,0,0,11500,5000,0,0,0,16500,0,0,23000,10000,0,0,0,33000,,CITYWIDE- R/C SIDEWALKS DAMAGED BY TREES,CITYWIDE- R/C SIDEWALKS DAMAGED BY TREES,cpd11-20cw.pdf
P-6UTILCW,McKenna Park - Water Line CNYG-1418M,846,DEPT OF PARKS AND RECREATION,NEIGHBORHOOD PARKS AND PLAYGROUNDS,,CITYWIDE,P-D017 P-0245K,150,0,200,0,0,0,0,0,200,0,200,0,0,0,0,0,200,0,400,0,0,0,0,0,400,,CITYWIDE,RECON SITE UTILITY PLUMBING SYSTEMS CITYWIDE - $1,cpd11-20cw.pdf
SANDY4330,NYC4330 Surplus,846,DEPT OF PARKS AND RECREATION,NEIGHBORHOOD PARKS AND PLAYGROUNDS,000,CITYWIDE,P-1018,10416,0,0,0,0,1042,0,0,1042,0,0,0,0,1042,0,0,1042,0,0,0,0,2084,0,0,2084,,,SANDY - NYC4330 SURPLUS,cpd11-20cw.pdf
SANDY4371,NYC4371 Surplus,846,DEPT OF PARKS AND RECREATION,MAJOR RECREATIONAL FACILITIES AND FACILITY RECONSTRUCTION,000,CITYWIDE,P-1018,5088,0,0,0,0,509,0,0,509,0,0,0,0,509,0,0,509,0,0,0,0,1018,0,0,1018,,,SANDY - PW4371 SURPLUS,cpd11-20cw.pdf
SANDY6-06,SANDY - S.I. Beaches Protective Measures North RG-813M,846,DEPT OF PARKS AND RECREATION,NEIGHBORHOOD PARKS AND PLAYGROUNDS,000,CITYWIDE,P-1018,6003,409,40,0,50,0,0,0,499,409,40,0,50,0,0,0,499,818,80,0,100,0,0,0,998,PROJECT DELAYED DUE TO UNFORESEEN SITE/FIELD CONDITION,,SANDY -EMERGENCY BOILER WORK,cpd11-20cw.pdf
SANDY6-16,For Flushing Meadow Conduit,846,DEPT OF PARKS AND RECREATION,MAJOR RECREATIONAL FACILITIES AND FACILITY RECONSTRUCTION,000,CITYWIDE,P-1018,50894,0,0,0,0,3303,0,0,3303,0,0,0,0,3303,0,0,3303,0,0,0,0,6606,0,0,6606,,,SANDY CITYWIDE CONDUIT REPLACEMENT,cpd11-20cw.pdf
SANDY6-17,Sandy-Trees Removal in Bk & SI CNYG-3616M,846,DEPT OF PARKS AND RECREATION,MAJOR RECREATIONAL FACILITIES AND FACILITY RECONSTRUCTION,000,CITYWIDE,P-1018,1100,104,0,6,0,0,0,0,110,104,0,6,0,0,0,0,110,208,0,12,0,0,0,0,220,,BROOKLYN & STATEN ISLAND,SANDY-TREES REMOVAL IN BK & SI,cpd11-20cw.pdf
SANDY6-18,"Sandy-Trees Removal in BX ,Mnht & Que CNYG-3516M",846,DEPT OF PARKS AND RECREATION,MAJOR RECREATIONAL FACILITIES AND FACILITY RECONSTRUCTION,000,CITYWIDE,P-1018,550,50,1,4,0,0,0,0,55,50,1,4,0,0,0,0,55,100,2,8,0,0,0,0,110,,"BRONX, MANHATTAN , QUEENS","SANDY-TREES REMOVAL IN BX ,MNHT & QUE",cpd11-20cw.pdf
SANDY6-21,"Sandy Tree Planting and Replanting - BX, Q, & M",846,DEPT OF PARKS AND RECREATION,MAJOR RECREATIONAL FACILITIES AND FACILITY RECONSTRUCTION,000,CITYWIDE,P-1018,2200,347,4,0,0,0,0,0,351,347,4,0,0,0,0,0,351,694,8,0,0,0,0,0,702,,,"SANDY TREE PLANTING AND REPLANTING - BX, Q, & M",cpd11-20cw.pdf
SANDYCDUT,SANDY-NYC4371 Conduit Funding,846,DEPT OF PARKS AND RECREATION,MAJOR RECREATIONAL FACILITIES AND FACILITY RECONSTRUCTION,000,CITYWIDE,P-1018,17391,0,0,0,0,1530,0,0,1530,0,0,0,0,1530,0,0,1530,0,0,0,0,3060,0,0,3060,,CITYWIDE,SANDY PWNYC4371 CONDUIT FUNDING,cpd11-20cw.pdf
BED-827,Regulator Chamber Roof Replacements,850,DEPT OF DESIGN & CONSTRUCTION,TRUNK AND DISTRIBUTION MAIN REPLACEMENT,,CITYWIDE,WM-0001,563,222,300,0,518,0,0,0,1040,222,300,0,518,0,0,0,1040,444,600,0,1036,0,0,0,2080,PROJECT DELAYED DUE TO UNFORESEEN SITE/FIELD CONDITION,,REGULATOR CHAMBER ROOF REPLACEMENTS,cpd11-20cw.pdf
CT2-INTER,"CITY TUNNEL #2, REPLACE GUARD VALVES @ 16A",850,DEPT OF DESIGN & CONSTRUCTION,WATER QUALITY PRESERVATION,000,CITYWIDE,WM-0105,10012,10141,700,0,300,0,0,0,11141,10141,700,0,300,0,0,0,11141,20282,1400,0,600,0,0,0,22282,PROJECT DELAYED DUE TO UNFORESEEN SITE/FIELD CONDITION,,"CITY TUNNEL #2, REPLACE GUARD VALVES @ 16A 17A, ETC",cpd11-20cw.pdf
F175EMS17,EMS Station 17 - New Facility,850,DEPT OF DESIGN & CONSTRUCTION,NEW FACILITIES AND RENOVATIONS,000,CITYWIDE,F-0175,17001,2376,0,1215,14000,0,0,0,17591,2376,0,1215,14000,0,0,0,17591,4752,0,2430,28000,0,0,0,35182,,,EMS STATION 17 - NEW FACILITY,cpd11-20cw.pdf
GE-353,"DIST. WM EXT/REPL; NEW BLDGS, ETC ADJ. TO T.A. FACILITIES",850,DEPT OF DESIGN & CONSTRUCTION,TRUNK AND DISTRIBUTION MAIN REPLACEMENT,,CITYWIDE,WM-0001,4400,7668,292,0,0,0,0,0,7960,7668,292,0,0,0,0,0,7960,15336,584,0,0,0,0,0,15920,PROJECT DELAYED DUE TO UNFORESEEN SITE/FIELD CONDITION,,"DISTRIBUTION WATER MAIN EXTENSIONS/REPLACEMENTS; NEW BLDGS, HYDRANT &VALVE",cpd11-20cw.pdf
GE-359,Area-wide Contract for Water Mains,850,DEPT OF DESIGN & CONSTRUCTION,TRUNK AND DISTRIBUTION MAIN REPLACEMENT,000,CITYWIDE,HW-0200,12600,18003,532,0,0,0,0,0,18535,18003,532,0,0,0,0,0,18535,36006,1064,0,0,0,0,0,37070,PROJECT DELAYED DUE TO UNFORESEEN SITE/FIELD CONDITION,,AREA-WIDE CONTRACT FOR WATER MAINS,cpd11-20cw.pdf
GE-363,"Energency Reconstruction of Water Mains, Citywide",850,DEPT OF DESIGN & CONSTRUCTION,TRUNK AND DISTRIBUTION MAIN REPLACEMENT,000,CITYWIDE,WM-0001 WM-0006 EP-0007,12543,0,11400,0,0,0,0,0,11400,0,11400,0,0,0,0,0,11400,0,22800,0,0,0,0,0,22800,,,CITYWIDE EMERGENCY CONSTRUCTION OF WATER MAINS,cpd11-20cw.pdf
HR25FACA,FACADE RESTORATION MULTIPLE SITES,850,DEPT OF DESIGN & CONSTRUCTION,SOCIAL SERVICES BUILDINGS,000,CITYWIDE,HR-0025,3260,20428,250,0,0,0,0,0,20678,20428,250,0,0,0,0,0,20678,40856,500,0,0,0,0,0,41356,PROJECT DELAYED DUE TO CHANGES IN SCOPE/DESIGN,OBA ADVISED THAT ONLY ONE ADDRESS COULD BE LISTED AS THIS PROJECT ISCONSIDERED TO BE,FACADE RESTORATION,cpd11-20cw.pdf
HR25FACA4,FACADE RESTORATION MULTIPLE SITES,850,DEPT OF DESIGN & CONSTRUCTION,SOCIAL SERVICES BUILDINGS,000,CITYWIDE,HR-0025,4322,0,0,5009,715,0,0,0,5724,0,0,5009,715,0,0,0,5724,0,0,10018,1430,0,0,0,11448,,"(1.) 1275 WESTCHESTER AVE., BX. OBA ADVISED THAT ONLY ONE ADDRESS COULD BE LISTED AS THIS",FACADE RESTORATION,cpd11-20cw.pdf
HWCPEDLOC,Perimeter Security Measures,850,DEPT OF DESIGN & CONSTRUCTION,PRIMARY STREET RECONSTRUCTION,000,CITYWIDE,HW-0001,26970,16520,1,0,0,11118,0,0,27639,16520,1,0,0,11118,0,0,27639,33040,2,0,0,22236,0,0,55278,PROJECT DELAYED DUE TO UNFORESEEN SITE/FIELD CONDITION,CITYWIDE PEDESTRIAN REFUGE LOCATIONS,CITYWIDE PEDESTRIAN REFUGE LOCATIONS,cpd11-20cw.pdf
HWCSCH3E,SAFE ROUTES TO SCHOOLS-94 SCHOOLS,850,DEPT OF DESIGN & CONSTRUCTION,PRIMARY STREET RECONSTRUCTION,000,CITYWIDE,HW-0988,9123,2057,0,0,0,0,0,0,2057,2057,0,0,0,0,0,0,2057,4114,0,0,0,0,0,0,4114,PROJECT DELAYED DUE TO UNFORESEEN SITE/FIELD CONDITION,SAFE ROUTES TO SCHOOLS-94 SCHOOLS,SAFE ROUTES TO SCHOOLS-94 SCHOOLS,cpd11-20cw.pdf
HWCSCH3F1,SAFE ROUTES TO SCHOOLS-94 SCHOOLS,850,DEPT OF DESIGN & CONSTRUCTION,PRIMARY STREET RECONSTRUCTION,000,CITYWIDE,HW-0988,10137,7188,87,198,0,0,0,0,7473,7188,87,198,0,0,0,0,7473,14376,174,396,0,0,0,0,14946,PROJECT DELAYED DUE TO UNFORESEEN SITE/FIELD CONDITION,SAFE ROUTES TO SCHOOLS-94 SCHOOLS,SAFE ROUTES TO SCHOOLS-94 SCHOOLS,cpd11-20cw.pdf
HWCSCH3G1,SAFE ROUTES TO SCHOOLS-94 SCHOOLS,850,DEPT OF DESIGN & CONSTRUCTION,PRIMARY STREET RECONSTRUCTION,000,CITYWIDE,HW-0988,5890,459,0,0,0,0,0,0,459,459,0,0,0,0,0,0,459,918,0,0,0,0,0,0,918,PROJECT DELAYED DUE TO UNFORESEEN SITE/FIELD CONDITION,SAFE ROUTES TO SCHOOLS-94 SCHOOLS,SAFE ROUTES TO SCHOOLS-94 SCHOOLS,cpd11-20cw.pdf
HWCSCH3G2,SAFE ROUTES TO SCHOOLS-94 SCHOOLS,850,DEPT OF DESIGN & CONSTRUCTION,PRIMARY STREET RECONSTRUCTION,000,CITYWIDE,HW-0988,7026,1534,0,0,0,0,0,0,1534,1534,0,0,0,0,0,0,1534,3068,0,0,0,0,0,0,3068,PROJECT DELAYED DUE TO UNFORESEEN SITE/FIELD CONDITION,SAFE ROUTES TO SCHOOLS-94 SCHOOLS,SAFE ROUTES TO SCHOOLS-94 SCHOOLS,cpd11-20cw.pdf
HWCSCH3H1,SAFE ROUTES TO SCHOOLS-94 SCHOOLS,850,DEPT OF DESIGN & CONSTRUCTION,PRIMARY STREET RECONSTRUCTION,000,CITYWIDE,HW-0988,1718,0,0,0,0,0,0,0,0,0,0,0,0,0,0,0,0,0,0,0,0,0,0,0,0,PROJECT DELAYED DUE TO UNFORESEEN SITE/FIELD CONDITION,SAFE ROUTES TO SCHOOLS-94 SCHOOLS,SAFE ROUTES TO SCHOOLS-94 SCHOOLS,cpd11-20cw.pdf
HWCSCH3H2,SAFE ROUTES TO SCHOOLS-94 SCHOOLS,850,DEPT OF DESIGN & CONSTRUCTION,PRIMARY STREET RECONSTRUCTION,000,CITYWIDE,HW-0988,2909,915,0,0,0,0,0,0,915,915,0,0,0,0,0,0,915,1830,0,0,0,0,0,0,1830,PROJECT DELAYED DUE TO UNFORESEEN SITE/FIELD CONDITION,SAFE ROUTES TO SCHOOLS-94 SCHOOLS,SAFE ROUTES TO SCHOOLS-94 SCHOOLS,cpd11-20cw.pdf
HWCSCH4A,Safe Route to Schools - Phase 4A (MED-635),850,DEPT OF DESIGN & CONSTRUCTION,PRIMARY STREET RECONSTRUCTION,000,CITYWIDE,HW-0988,5344,2361,0,0,0,0,0,0,2361,2361,0,0,0,0,0,0,2361,4722,0,0,0,0,0,0,4722,PROJECT DELAYED DUE TO CHANGES IN SCOPE/DESIGN,SAFE ROUTES TO SCHOOLS PHASE 4 - 31 SCHOOLS,SAFE ROUTES TO SCHOOLS PHASE 4 - 31 SCHOOLS,cpd11-20cw.pdf
HWCSCH4B1,Safe Routes to Schools - Phase 4B1,850,DEPT OF DESIGN & CONSTRUCTION,PRIMARY STREET RECONSTRUCTION,000,CITYWIDE,HW-0988 HW-0944,5542,4657,0,0,0,0,0,0,4657,4657,0,0,0,0,0,0,4657,9314,0,0,0,0,0,0,9314,PROJECT DELAYED DUE TO UNFORESEEN SITE/FIELD CONDITION,SAFE ROUTES TO SCHOOLS - PHASE 4B1,SAFE ROUTES TO SCHOOLS - PHASE 4B1,cpd11-20cw.pdf
HWCSCH4C2,Safe Routes to Schools - Phase 4C2,850,DEPT OF DESIGN & CONSTRUCTION,PRIMARY STREET RECONSTRUCTION,000,CITYWIDE,HW-0988,17600,7558,33,0,0,0,0,0,7591,7558,33,0,0,0,0,0,7591,15116,66,0,0,0,0,0,15182,PROJECT DELAYED DUE TO UNFORESEEN SITE/FIELD CONDITION,SRTS - PHASE 4C2,SRTS - PHASE 4C2,cpd11-20cw.pdf
HWCSCH4D,Safe Routes to Schools - Phase 4D,850,DEPT OF DESIGN & CONSTRUCTION,PRIMARY STREET RECONSTRUCTION,000,CITYWIDE,HW-0988,4200,1069,10728,0,0,0,0,0,11797,1069,10728,0,0,0,0,0,11797,2138,21456,0,0,0,0,0,23594,PROJECT DELAYED DUE TO BUDGETARY CONSTRAINTS,SAFE ROUTES TO SCHOOLS - PHASE 4D,SAFE ROUTES TO SCHOOLS - PHASE 4D,cpd11-20cw.pdf
HWCSCHPKR,Safe Routes to Schools - Brooklyn & Staten Island,850,DEPT OF DESIGN & CONSTRUCTION,PRIMARY STREET RECONSTRUCTION,000,CITYWIDE,HW-0001 HW-D101,14060,1608,0,12483,0,0,0,0,14091,1608,0,12483,0,0,0,0,14091,3216,0,24966,0,0,0,0,28182,PROJECT DELAYED DUE TO CHANGES IN SCOPE/DESIGN,SAFE ROUTES TO SCHOOLS - BROOKLYN & STATEN ISLAND,SAFE ROUTES TO SCHOOLS - BROOKLYN & STATEN ISLAND,cpd11-20cw.pdf
HWCSCHPMN,SAFE ROUTES TO SCHOOLS- MANHATTAN,850,DEPT OF DESIGN & CONSTRUCTION,PRIMARY STREET RECONSTRUCTION,099,CITYWIDE,HW-0988 HW-D102,18702,1603,0,0,13516,0,0,0,15119,1603,0,0,13516,0,0,0,15119,3206,0,0,27032,0,0,0,30238,,SAFE ROUTES TO SCHOOLS- MANHATTAN,SAFE ROUTES TO SCHOOLS- MANHATTAN,cpd11-20cw.pdf
HWP15XMCL,"Simple, Complex & Landmark Ped Ramps - Bronx and Manhattan",850,DEPT OF DESIGN & CONSTRUCTION,PEDESTRIAN RAMP CONSTRUCTION,000,CITYWIDE,HW-0200,5081,7533,1301,0,0,0,0,0,8834,7533,1301,0,0,0,0,0,8834,15066,2602,0,0,0,0,0,17668,PROJECT DELAYED DUE TO UNFORESEEN SITE/FIELD CONDITION,"SIMPLE, COMPLEX & LANDMARK PED RAMPS - BRONX AND MANHATTAN","SIMPLE, COMPLEX & LANDMARK PED RAMPS - BRONX AND MANHATTAN",cpd11-20cw.pdf
HWP19CWLM,CITYWIDE COMPLEX PED RAMPS (LANDMARK) - MANHATTAN AND BRONX,850,DEPT OF DESIGN & CONSTRUCTION,PEDESTRIAN RAMP CONSTRUCTION,000,CITYWIDE,HW-0200,7290,1373,0,6738,0,0,0,0,8111,1373,0,6738,0,0,0,0,8111,2746,0,13476,0,0,0,0,16222,PROJECT DELAYED DUE TO BUDGETARY CONSTRAINTS,,CITYWIDE COMPLEX PED RAMPS (LANDMARK)- MANHATTAN AND BRONX,cpd11-20cw.pdf
HWP19KQTA,CITYWIDE COMPLEX PED RAMPS (TA) - BROOKLYN AND QUEENS,850,DEPT OF DESIGN & CONSTRUCTION,PEDESTRIAN RAMP CONSTRUCTION,000,CITYWIDE,HW-0200,5588,1354,0,5165,0,0,0,0,6519,1354,0,5165,0,0,0,0,6519,2708,0,10330,0,0,0,0,13038,PROJECT DELAYED DUE TO BUDGETARY CONSTRAINTS,,CITYWIDE COMPLEX PED RAMPS (TRANSIT AUTHORITY)- BROOKLYN AND QUEENS,cpd11-20cw.pdf
HWP19QRC,Citywide Complex Pedestrian Ramps - Queens and Staten Island,850,DEPT OF DESIGN & CONSTRUCTION,PEDESTRIAN RAMP CONSTRUCTION,000,CITYWIDE,HW-0200,6687,1100,0,6180,0,0,0,0,7280,1100,0,6180,0,0,0,0,7280,2200,0,12360,0,0,0,0,14560,PROJECT DELAYED DUE TO BUDGETARY CONSTRAINTS,,CITYWIDE COMPLEX PEDESTRIAN RAMPS- QUEENS AND STATEN ISLAND,cpd11-20cw.pdf
HWP2002Q,CITYWIDE PED RAMPS - QUEENS,850,DEPT OF DESIGN & CONSTRUCTION,PEDESTRIAN RAMP CONSTRUCTION,000,CITYWIDE,HW-0200,5849,5092,752,0,0,0,0,0,5844,5092,752,0,0,0,0,0,5844,10184,1504,0,0,0,0,0,11688,PROJECT DELAYED DUE TO BUDGETARY CONSTRAINTS,CITYWIDE PED RAMPS - QUEENS,CITYWIDE PED RAMPS - QUEENS,cpd11-20cw.pdf
HWP2013MX,CITYWIDE PED RAMPS - MANHATTAN AND BRONX,850,DEPT OF DESIGN & CONSTRUCTION,PEDESTRIAN RAMP CONSTRUCTION,000,CITYWIDE,HW-0200,4258,6540,299,0,0,0,0,0,6839,6540,299,0,0,0,0,0,6839,13080,598,0,0,0,0,0,13678,PROJECT DELAYED DUE TO UNFORESEEN SITE/FIELD CONDITION,CITYWIDE PED RAMPS - MANHATTAN AND BRONX,CITYWIDE PED RAMPS - MANHATTAN AND BRONX,cpd11-20cw.pdf
HWP2019S,Citywide Simple Pedestrian Ramps,850,DEPT OF DESIGN & CONSTRUCTION,PEDESTRIAN RAMP CONSTRUCTION,000,CITYWIDE,HW-0200,6466,1851,4743,0,0,0,0,0,6594,1851,4743,0,0,0,0,0,6594,3702,9486,0,0,0,0,0,13188,PROJECT DELAYED DUE TO BUDGETARY CONSTRAINTS,,CITYWIDE SIMPLE PEDESTRIAN RAMPS,cpd11-20cw.pdf
HWP2020LM,Non-Standard Ped Ramp Installs - Citywide Landmark Locations,850,DEPT OF DESIGN & CONSTRUCTION,PEDESTRIAN RAMP CONSTRUCTION,000,CITYWIDE,HW-0200,7586,1036,0,0,7017,0,0,0,8053,1036,0,0,7017,0,0,0,8053,2072,0,0,14034,0,0,0,16106,PROJECT DELAYED DUE TO BUDGETARY CONSTRAINTS,COMPLEX PED RAMP INSTALLS - CITYWIDE LANDMARK LOCATIONS,COMPLEX PED RAMP INSTALLS - CITYWIDE LANDMARK LOCATIONS,cpd11-20cw.pdf
HWP2020TA,"Non-Standard Ped Ramp Installs - Manh, Brnx, Bk, & Queens",850,DEPT OF DESIGN & CONSTRUCTION,PEDESTRIAN RAMP CONSTRUCTION,000,CITYWIDE,HW-0200,6019,1021,134,0,5586,0,0,0,6741,1021,134,0,5586,0,0,0,6741,2042,268,0,11172,0,0,0,13482,PROJECT DELAYED DUE TO BUDGETARY CONSTRAINTS,"COMPLEX PED RAMP INSTALLS - MANH, BRNX, BK, & QUEENS","COMPLEX PED RAMP INSTALLS - MANH, BRNX, BK, & QUEENS",cpd11-20cw.pdf
HWP20KRC,Non-Standard Ped Ramp Installs - Brooklyn & Staten Island,850,DEPT OF DESIGN & CONSTRUCTION,PEDESTRIAN RAMP CONSTRUCTION,000,CITYWIDE,HW-0200,7137,0,985,0,6597,0,0,0,7582,0,985,0,6597,0,0,0,7582,0,1970,0,13194,0,0,0,15164,PROJECT DELAYED DUE TO BUDGETARY CONSTRAINTS,COMPLEX PED RAMP INSTALLS - BROOKLYN & STATEN ISLAND,COMPLEX PED RAMP INSTALLS - BROOKLYN & STATEN ISLAND,cpd11-20cw.pdf
HWP20MKC,Non-Standard Ped Ramp Installs - Manhattan & Brooklyn,850,DEPT OF DESIGN & CONSTRUCTION,PEDESTRIAN RAMP CONSTRUCTION,000,CITYWIDE,HW-0200,7956,175,158,7353,0,0,0,0,7686,175,158,7353,0,0,0,0,7686,350,316,14706,0,0,0,0,15372,PROJECT DELAYED DUE TO BUDGETARY CONSTRAINTS,COMPLEX PED RAMP INSTALLS - MANHATTAN & BROOKLYN,COMPLEX PED RAMP INSTALLS - MANHATTAN & BROOKLYN,cpd11-20cw.pdf
HWP20MXQC,"Non-Standard Ped Ramp Installs - Manhattan, Queens, & Bronx",850,DEPT OF DESIGN & CONSTRUCTION,PEDESTRIAN RAMP CONSTRUCTION,000,CITYWIDE,HW-0200,7244,200,549,6695,0,0,0,0,7444,200,549,6695,0,0,0,0,7444,400,1098,13390,0,0,0,0,14888,PROJECT DELAYED DUE TO BUDGETARY CONSTRAINTS,"COMPLEX PED RAMP INSTALLS - MANHATTAN, QUEENS, & BRONX","COMPLEX PED RAMP INSTALLS - MANHATTAN, QUEENS, & BRONX",cpd11-20cw.pdf
HWPEDSF1,Multi-Site Pedestrian Safety,850,DEPT OF DESIGN & CONSTRUCTION,PRIMARY STREET RECONSTRUCTION,000,CITYWIDE,HW-0001Q,3971,4697,501,0,0,0,0,0,5198,4697,501,0,0,0,0,0,5198,9394,1002,0,0,0,0,0,10396,PROJECT DELAYED DUE TO UNFORESEEN SITE/FIELD CONDITION,MULTI-SITE PEDESTRIAT SAFETY - NF & EARMARKS,PED SAFETY,cpd11-20cw.pdf
HWPEDSF3A,MULTI-SITE PEDESTRIAN SAFETY - 7 LOCATIONS,850,DEPT OF DESIGN & CONSTRUCTION,PRIMARY STREET RECONSTRUCTION,000,CITYWIDE,HW-0988 TF-0002,5583,9865,855,0,0,0,0,0,10720,9865,855,0,0,0,0,0,10720,19730,1710,0,0,0,0,0,21440,PROJECT DELAYED DUE TO UNFORESEEN SITE/FIELD CONDITION,MULTI-SITE PEDESTRIAN SAFETY - 5 LOCATIONS,MULTI-SITE PEDESTRIAN SAFETY - 5 LOCATIONS,cpd11-20cw.pdf
HWPR19MXC,Complex Upgrades Ped Ramps - Manhattan and the Bronx,850,DEPT OF DESIGN & CONSTRUCTION,PEDESTRIAN RAMP CONSTRUCTION,000,CITYWIDE,HW-0200,7510,1097,0,6955,0,0,0,0,8052,1097,0,6955,0,0,0,0,8052,2194,0,13910,0,0,0,0,16104,PROJECT DELAYED DUE TO BUDGETARY CONSTRAINTS,COMPLEX UPGRADES PED RAMPS - MANHATTAN AND THE BRONX,COMPLEX UPGRADES PED RAMPS - MANHATTAN AND THE BRONX,cpd11-20cw.pdf
HWPR19QRC,Complex Upgrades Ped Ramps - Queens and Staten Island,850,DEPT OF DESIGN & CONSTRUCTION,PEDESTRIAN RAMP CONSTRUCTION,000,CITYWIDE,HW-0200,7421,1106,0,6942,0,0,0,0,8048,1106,0,6942,0,0,0,0,8048,2212,0,13884,0,0,0,0,16096,PROJECT DELAYED DUE TO BUDGETARY CONSTRAINTS,COMPLEX UPGRADES PED RAMPS - QUEENS AND STATEN ISLAND,COMPLEX UPGRADES PED RAMPS - QUEENS AND STATEN ISLAND,cpd11-20cw.pdf
HWPR20KMC,Non-Standard Upgrades Ped Ramp - Manhattan & Brooklyn,850,DEPT OF DESIGN & CONSTRUCTION,PEDESTRIAN RAMP CONSTRUCTION,000,CITYWIDE,HW-0200,7982,532,564,7418,0,0,0,0,8514,532,564,7418,0,0,0,0,8514,1064,1128,14836,0,0,0,0,17028,PROJECT DELAYED DUE TO BUDGETARY CONSTRAINTS,COMPLEX UPGRADES PED RAMP - MANHATTAN & BROOKLYN,COMPLEX UPGRADES PED RAMP - MANHATTAN & BROOKLYN,cpd11-20cw.pdf
HWPR20MKL,Non-Standard Upgrades Ped Ramp - Manhattan & Brooklyn,850,DEPT OF DESIGN & CONSTRUCTION,PEDESTRIAN RAMP CONSTRUCTION,000,CITYWIDE,HW-0200,6816,350,478,6338,0,0,0,0,7166,350,478,6338,0,0,0,0,7166,700,956,12676,0,0,0,0,14332,PROJECT DELAYED DUE TO BUDGETARY CONSTRAINTS,COMPLEX UPGRADES PED RAMP - MANHATTAN & BROOKLYN,COMPLEX UPGRADES PED RAMP - MANHATTAN & BROOKLYN,cpd11-20cw.pdf
HWPR20MKT,Non-Standard Upgrades Ped Ramp - TA Manhattan & Brooklyn,850,DEPT OF DESIGN & CONSTRUCTION,PEDESTRIAN RAMP CONSTRUCTION,000,CITYWIDE,HW-0200,6303,700,61,0,5877,0,0,0,6638,700,61,0,5877,0,0,0,6638,1400,122,0,11754,0,0,0,13276,PROJECT DELAYED DUE TO BUDGETARY CONSTRAINTS,COMPLEX UPGRADES PED RAMP - TA MANHATTAN & BROOKLYN,COMPLEX UPGRADES PED RAMP - TA MANHATTAN & BROOKLYN,cpd11-20cw.pdf
HWPR20MQC,Non-Standard Upgrades Ped Ramp - Manhattan & Queens,850,DEPT OF DESIGN & CONSTRUCTION,PEDESTRIAN RAMP CONSTRUCTION,000,CITYWIDE,HW-0200,7641,200,0,7101,0,0,0,0,7301,200,0,7101,0,0,0,0,7301,400,0,14202,0,0,0,0,14602,PROJECT DELAYED DUE TO BUDGETARY CONSTRAINTS,COMPLEX UPGRADES PED RAMP - MANHATTAN & QUEENS,COMPLEX UPGRADES PED RAMP - MANHATTAN & QUEENS,cpd11-20cw.pdf
HWPR20MQX,"Non-Standard Upgrades Ped Ramp - TA Manhattan,Queens,&Bronx",850,DEPT OF DESIGN & CONSTRUCTION,PEDESTRIAN RAMP CONSTRUCTION,000,CITYWIDE,HW-0200,6784,150,460,6324,0,0,0,0,6934,150,460,6324,0,0,0,0,6934,300,920,12648,0,0,0,0,13868,PROJECT DELAYED DUE TO BUDGETARY CONSTRAINTS,"COMPLEX UPGRADES PED RAMP - TA MANHATTAN, QUEENS, & BRONX","COMPLEX UPGRADES PED RAMP - TA MANHATTAN, QUEENS, & BRONX",cpd11-20cw.pdf
HWPR20MX,Pedestrian Ramp Rehabilitation - Manhattan and Bronx,850,DEPT OF DESIGN & CONSTRUCTION,PEDESTRIAN RAMP CONSTRUCTION,000,CITYWIDE,HW-0200,13716,100,7862,6029,0,0,0,0,13991,100,7862,6029,0,0,0,0,13991,200,15724,12058,0,0,0,0,27982,PROJECT DELAYED DUE TO BUDGETARY CONSTRAINTS,PEDESTRIAN RAMP REHABILITATION - MANHATTAN AND BRONX,PEDESTRIAN RAMP REHABILITATION - MANHATTAN AND BRONX,cpd11-20cw.pdf
HWPR20MXC,Non-Standard Upgrades Ped Ramp - Manhattan & Bronx,850,DEPT OF DESIGN & CONSTRUCTION,PEDESTRIAN RAMP CONSTRUCTION,000,CITYWIDE,HW-0200,8136,435,575,7561,0,0,0,0,8571,435,575,7561,0,0,0,0,8571,870,1150,15122,0,0,0,0,17142,PROJECT DELAYED DUE TO BUDGETARY CONSTRAINTS,COMPLEX UPGRADES PED RAMP - MANHATTAN & BRONX,COMPLEX UPGRADES PED RAMP - MANHATTAN & BRONX,cpd11-20cw.pdf
HWPR21KR,Rehabilitation of Standard Ped Ramps - Brooklyn&Staten Islan,850,DEPT OF DESIGN & CONSTRUCTION,PEDESTRIAN RAMP CONSTRUCTION,000,CITYWIDE,HW-0200,15382,100,0,7392,7394,0,0,0,14886,100,0,7392,7394,0,0,0,14886,200,0,14784,14788,0,0,0,29772,,,REHABILITATION OF STANDARD PED RAMPS - BROOKLYN & STATEN ISLAND,cpd11-20cw.pdf
HWPR21MQ,Rehabilitation of Standard Ped Ramps - Queens & Manhattan,850,DEPT OF DESIGN & CONSTRUCTION,PEDESTRIAN RAMP CONSTRUCTION,000,CITYWIDE,HW-0200,15491,200,0,7445,7446,0,0,0,15091,200,0,7445,7446,0,0,0,15091,400,0,14890,14892,0,0,0,30182,,,REHABILITATION OF STANDARD PED RAMPS - QUEENS & MANHATTAN,cpd11-20cw.pdf
HWPR21QX,Rehabilitation of Standard Ped Ramps - Queens & Bronx,850,DEPT OF DESIGN & CONSTRUCTION,PEDESTRIAN RAMP CONSTRUCTION,000,CITYWIDE,HW-0200,14310,200,0,6877,6878,0,0,0,13955,200,0,6877,6878,0,0,0,13955,400,0,13754,13756,0,0,0,27910,,,REHABILITATION OF STANDARD PED RAMPS - QUEENS & BRONX,cpd11-20cw.pdf
HWS2006C,PRIOR NOTICE AND EMERGENCY SIDEWALKS - CW,850,DEPT OF DESIGN & CONSTRUCTION,SIDEWALK RECONSTRUCTION,000,CITYWIDE,HW-0200,6146,3925,0,0,0,0,0,1773,5698,3925,0,0,0,0,0,1773,5698,7850,0,0,0,0,0,3546,11396,,PRIOR NOTICE AND EMERGENCY SIDEWALKS - CW,PRIOR NOTICE AND EMERGENCY SIDEWALKS - CW,cpd11-20cw.pdf
HWS2009DS,PRIOR NOTICE SIDEWALKS (DISTINCTIVE) - CITYWIDE(SIM),850,DEPT OF DESIGN & CONSTRUCTION,SIDEWALK RECONSTRUCTION,000,CITYWIDE,HW-0200,0,1605,0,0,0,0,0,452,2057,1605,0,0,0,0,0,452,2057,3210,0,0,0,0,0,904,4114,,PRIOR NOTICE SIDEWALKS (DISTINCTIVE) - CITYWIDE,PRIOR NOTICE SIDEWALKS (DISTINCTIVE) - CITYWIDE,cpd11-20cw.pdf
HWS2011CW,PRIOR NOTICE SIDEWALKS - CITYWIDE (SIM),850,DEPT OF DESIGN & CONSTRUCTION,SIDEWALK RECONSTRUCTION,000,CITYWIDE,HW-0200,4885,3225,0,0,0,0,0,0,3225,3225,0,0,0,0,0,0,3225,6450,0,0,0,0,0,0,6450,PROJECT DELAYED DUE TO UNFORESEEN SITE/FIELD CONDITION,PRIOR NOTICE SIDEWALKS - CITYWIDE (SIM),PRIOR NOTICE SIDEWALKS - CITYWIDE (SIM),cpd11-20cw.pdf
HWS2012CW,PRIOR NOTICE SIDEWALKS - CITYWIDE,850,DEPT OF DESIGN & CONSTRUCTION,SIDEWALK RECONSTRUCTION,000,CITYWIDE,HW-0200,4352,315,0,0,0,0,0,71,386,315,0,0,0,0,0,71,386,630,0,0,0,0,0,142,772,PROJECT DELAYED DUE TO SCHEDULING OF UTILITY WORK,PRIOR NOTICE SIDEWALKS - CITYWIDE,PRIOR NOTICE SIDEWALKS - CITYWIDE,cpd11-20cw.pdf
HWS2020XM,Prior Notice Sidewalks- Manhattan & Bronx,850,DEPT OF DESIGN & CONSTRUCTION,SIDEWALK RECONSTRUCTION,000,CITYWIDE,HW-0200 P-1018,4759,34,3340,241,0,0,0,0,3615,34,3340,241,0,0,0,0,3615,68,6680,482,0,0,0,0,7230,PROJECT DELAYED DUE TO BUDGETARY CONSTRAINTS,PRIOR NOTICE SIDEWALKS- MANHATTAN & BRONX,PRIOR NOTICE SIDEWALKS- MANHATTAN & BRONX,cpd11-20cw.pdf
HWTRQX1,Trench Restoration - Queens and Bronx (SEX002271),850,DEPT OF DESIGN & CONSTRUCTION,PRIMARY STREET RECONSTRUCTION,,CITYWIDE,HW-0001 HW-D103,14700,1935,0,13566,0,0,0,0,15501,1935,0,13566,0,0,0,0,15501,3870,0,27132,0,0,0,0,31002,,,TRENCH RESTORARTION - QUEENS AND BRONX,cpd11-20cw.pdf
JJ1FACREN,FACILITIES RENOVATIONS,850,DEPT OF DESIGN & CONSTRUCTION,CHILD WELFARE FACILITIES,000,CITYWIDE,CS-0005,13514,80642,6704,0,0,0,0,0,87346,80642,6704,0,0,0,0,0,87346,161284,13408,0,0,0,0,0,174692,PROJECT DELAYED DUE TO UNFORESEEN SITE/FIELD CONDITION,FACILITY RENOVATION,VARIOUS FACILITY RENOVATION,cpd11-20cw.pdf
LNCA16WH1,Washington Heights - Third Floor Renovation,850,DEPT OF DESIGN & CONSTRUCTION,ESSENTIAL RECONSTRUCTION OF FACILITIES,,CITYWIDE,LN-D008 LN-0008,2701,0,0,2641,0,0,0,0,2641,0,0,2641,0,0,0,0,2641,0,0,5282,0,0,0,0,5282,PROJECT DELAYED DUE TO BUDGETARY CONSTRAINTS,,THIRD FLOOR RENOVATION,cpd11-20cw.pdf
PO141-40P,NEW 40TH PRECINCT,850,DEPT OF DESIGN & CONSTRUCTION,POLICE FACILITIES,,CITYWIDE,PO-0141,68914,70711,6530,0,0,0,0,0,77241,70711,6530,0,0,0,0,0,77241,141422,13060,0,0,0,0,0,154482,PROJECT DELAYED DUE TO BUDGETARY CONSTRAINTS,"EAST 149TH STREET AND SAINT ANNS AVENUE, BRONX",NEW 40TH PCT,cpd11-20cw.pdf
PO205-PA,CONSTRUCTION OF A NEW POLICE ACADEMY/TRAINING FACILITY,850,DEPT OF DESIGN & CONSTRUCTION,POLICE FACILITIES,000,CITYWIDE,PO-0205,1130200,876169,2000,2100,1146,0,0,0,881415,876169,2000,2100,1146,0,0,0,881415,1752338,4000,4200,2292,0,0,0,1762830,PROJECT DELAYED DUE TO BUDGETARY CONSTRAINTS,,"CONSTRUCTION OF A NEW POLICE ACADEMY AND TRAINING FACILITY, CITYWIDE",cpd11-20cw.pdf
PO79FDCW1,"Front Desk Renovations for 45th, 75th, 105th, 123rd PCTS",850,DEPT OF DESIGN & CONSTRUCTION,POLICE FACILITIES,000,CITYWIDE,PO-0079,940,345,96,1184,0,0,0,0,1625,345,96,1184,0,0,0,0,1625,690,192,2368,0,0,0,0,3250,PROJECT DELAYED DUE TO BUDGETARY CONSTRAINTS,,FRONT DESK RENOVATIONS CITY WIDE,cpd11-20cw.pdf
PO79GENER,GENERATOR REPLACEMENT AT VARIOUS PRECINCTS,850,DEPT OF DESIGN & CONSTRUCTION,POLICE FACILITIES,000,CITYWIDE,PO-0079,4421,5067,254,0,0,0,0,0,5321,5067,254,0,0,0,0,0,5321,10134,508,0,0,0,0,0,10642,PROJECT DELAYED DUE TO BUDGETARY CONSTRAINTS,CITYWIDE,GENERATORS,cpd11-20cw.pdf
PO79WNDWS,"HWY UNIT 3, 67TH, 76TH, 111TH PCT WINDOW RPLCMNT",850,DEPT OF DESIGN & CONSTRUCTION,POLICE FACILITIES,000,CITYWIDE,PO-0079,2200,2302,0,6070,0,0,0,0,8372,2302,0,6070,0,0,0,0,8372,4604,0,12140,0,0,0,0,16744,PROJECT DELAYED DUE TO UNFORESEEN SITE/FIELD CONDITION,,WINDOW REPLACEMENT,cpd11-20cw.pdf
PS-312CW,CITYWIDE REPAIRS & REHAB OF INTERCEPTING SEWERS - CITYWIDE,850,DEPT OF DESIGN & CONSTRUCTION,PLANT UPGRADING AND RECONSTRUCTION,000,CITYWIDE,WP-0269,8179,8014,90,0,0,0,0,0,8104,8014,90,0,0,0,0,0,8104,16028,180,0,0,0,0,0,16208,PROJECT DELAYED DUE TO CHANGES IN SCOPE/DESIGN,CITYWIDE REPAIRS TO AND REHABILITATION OF INTERCEPTING SEWERS THAT HAVE STRUCTURAL,CITY-WIDE REPAIRS TO AND REHABILITATION OF INTERCEPTING SEWERS THAT HAVE STRUCTURAL,cpd11-20cw.pdf
PS-312MX,CITYWIDE REPAIRS & REHAB OF INTERCEPTING SEWERS - MAN & BX,850,DEPT OF DESIGN & CONSTRUCTION,PLANT UPGRADING AND RECONSTRUCTION,000,CITYWIDE,WP-0269,13714,1021,0,19195,0,0,0,0,20216,1021,0,19195,0,0,0,0,20216,2042,0,38390,0,0,0,0,40432,PROJECT DELAYED DUE TO UNFORESEEN SITE/FIELD CONDITION,CITYWIDE REPAIRS TO AND REHABILITATION OF INTERCEPTING SEWERS THAT HAVE STRUCTURAL,CITYWIDE REPAIRS TO AND REHABILITATION OF INTERCEPTING SEWERS THAT HAVE STRUCTURAL,cpd11-20cw.pdf
PW335ALLS,Asbestos and Lead Abatement Lump Sum,850,DEPT OF DESIGN & CONSTRUCTION,LEGAL MANDATES AND CORRECTION OF UNSAFE CONDITIONS,,CITYWIDE,PW-0335,6910,1285,0,2421,0,0,0,0,3706,1285,0,2421,0,0,0,0,3706,2570,0,4842,0,0,0,0,7412,,,ASBESTOS AND LEAD ABATEMENT LUMP SUM,cpd11-20cw.pdf
PW335BSLS,Bulk Sampling Lump Sum,850,DEPT OF DESIGN & CONSTRUCTION,LEGAL MANDATES AND CORRECTION OF UNSAFE CONDITIONS,,CITYWIDE,PW-0335,1200,820,0,381,0,0,0,0,1201,820,0,381,0,0,0,0,1201,1640,0,762,0,0,0,0,2402,PROJECT DELAYED DUE TO UNFORESEEN SITE/FIELD CONDITION,,BULK SAMPLING LUMP SUM,cpd11-20cw.pdf
PW348-71,FUEL TANK REPLACEMENT,850,DEPT OF DESIGN & CONSTRUCTION,LEGAL MANDATES AND CORRECTION OF UNSAFE CONDITIONS,000,CITYWIDE,PW-0348,12385,14320,7000,7445,0,0,0,0,28765,14320,7000,7445,0,0,0,0,28765,28640,14000,14890,0,0,0,0,57530,PROJECT DELAYED DUE TO UNFORESEEN SITE/FIELD CONDITION,FUEL TANKS,FUEL TANKS,cpd11-20cw.pdf
PW348-72,FUEL TANK REPLACEMENT,850,DEPT OF DESIGN & CONSTRUCTION,LEGAL MANDATES AND CORRECTION OF UNSAFE CONDITIONS,,CITYWIDE,PW-0348,12500,14590,0,0,0,0,7826,0,22416,14590,0,0,0,0,7826,0,22416,29180,0,0,0,0,15652,0,44832,PROJECT DELAYED DUE TO BUDGETARY CONSTRAINTS,,FUEL TANKS,cpd11-20cw.pdf
PW348-73,FUEL TANK REPLACEMENT,850,DEPT OF DESIGN & CONSTRUCTION,LEGAL MANDATES AND CORRECTION OF UNSAFE CONDITIONS,,CITYWIDE,PW-0348,12500,12988,7693,0,0,0,0,0,20681,12988,7693,0,0,0,0,0,20681,25976,15386,0,0,0,0,0,41362,PROJECT DELAYED DUE TO UNFORESEEN SITE/FIELD CONDITION,,FUEL TANKS,cpd11-20cw.pdf
PW348-81,FUEL TANK REPLACEMENT,850,DEPT OF DESIGN & CONSTRUCTION,LEGAL MANDATES AND CORRECTION OF UNSAFE CONDITIONS,000,CITYWIDE,PW-0348,27500,3550,0,12250,0,0,10000,0,25800,3550,0,12250,0,0,10000,0,25800,7100,0,24500,0,0,20000,0,51600,PROJECT DELAYED DUE TO BUDGETARY CONSTRAINTS,,FUEL TANKS.,cpd11-20cw.pdf
PW348-82,FUEL TANK REPLACEMENT,850,DEPT OF DESIGN & CONSTRUCTION,LEGAL MANDATES AND CORRECTION OF UNSAFE CONDITIONS,000,CITYWIDE,PW-0348,27500,1030,9770,5000,0,0,10000,0,25800,1030,9770,5000,0,0,10000,0,25800,2060,19540,10000,0,0,20000,0,51600,PROJECT DELAYED DUE TO BUDGETARY CONSTRAINTS,,FUEL TANKS,cpd11-20cw.pdf
PW348-83,FUEL TANK REPLACEMENT,850,DEPT OF DESIGN & CONSTRUCTION,LEGAL MANDATES AND CORRECTION OF UNSAFE CONDITIONS,000,CITYWIDE,PW-0348,27400,3550,0,12250,0,0,10000,0,25800,3550,0,12250,0,0,10000,0,25800,7100,0,24500,0,0,20000,0,51600,PROJECT DELAYED DUE TO BUDGETARY CONSTRAINTS,,FUEL TANK.,cpd11-20cw.pdf
PW348-84,FUEL TANK REPLACEMENT,850,DEPT OF DESIGN & CONSTRUCTION,LEGAL MANDATES AND CORRECTION OF UNSAFE CONDITIONS,000,CITYWIDE,PW-0348,27500,3550,7000,5250,0,0,10000,0,25800,3550,7000,5250,0,0,10000,0,25800,7100,14000,10500,0,0,20000,0,51600,PROJECT DELAYED DUE TO BUDGETARY CONSTRAINTS,,FUEL TANKS.,cpd11-20cw.pdf
PWCOMPDAT,Comptroller's Office Data Center Replacement at 1 Centre St.,850,DEPT OF DESIGN & CONSTRUCTION,REHABILITATION OF CITY-OWNED OFFICE SPACE,000,CITYWIDE,PW-0077,1401,831,186,614,0,0,0,0,1631,831,186,614,0,0,0,0,1631,1662,372,1228,0,0,0,0,3262,,,COMPTROLLER'S OFFICE DATA CENTER REPLACEMENT AT 1 CENTRE ST.,cpd11-20cw.pdf
QED-1050,Install Distribution WM throughout Bronx & Queens,850,DEPT OF DESIGN & CONSTRUCTION,AUGMENTATION OF WATER SUPPLY SYSTEMS,000,CITYWIDE,WM-0001 EP-0007,4604,201,11481,0,0,0,0,0,11682,201,11481,0,0,0,0,0,11682,402,22962,0,0,0,0,0,23364,,,INSTALL DISTRIBUTION WM THROUGHOUT BRONX & QUEENS. ALL EXISTING HYDRANTS MUST BE,cpd11-20cw.pdf
RED-385,Area Contract for Water Main Replacement,850,DEPT OF DESIGN & CONSTRUCTION,TRUNK AND DISTRIBUTION MAIN EXTENSION,000,CITYWIDE,WM-0001 EP-0007,4825,8514,286,0,0,0,0,0,8800,8514,286,0,0,0,0,0,8800,17028,572,0,0,0,0,0,17600,PROJECT DELAYED DUE TO UNFORESEEN SITE/FIELD CONDITION,,CATHERINE STREET FACADE REPAIR,cpd11-20cw.pdf
RED-388,Install Distribution WM throughout Brooklyn & Staten Island,850,DEPT OF DESIGN & CONSTRUCTION,AUGMENTATION OF WATER SUPPLY SYSTEMS,000,CITYWIDE,WM-0001 EP-0007,4604,201,11987,0,0,0,0,0,12188,201,11987,0,0,0,0,0,12188,402,23974,0,0,0,0,0,24376,,,INSTALL DISTRIBUTION WM THROUGHOUT BROOKLYN & STATEN ISLAND. ALL EXISTING HYDRANTS,cpd11-20cw.pdf
SANDCONDC,Sandy Conduit Replacement - Citywide,850,DEPT OF DESIGN & CONSTRUCTION,FACILITY RECONSTRUCTION,000,CITYWIDE,HW-0003,5326,759,77,0,509,0,0,0,1345,759,77,0,509,0,0,0,1345,1518,154,0,1018,0,0,0,2690,PROJECT DELAYED DUE TO UNFORESEEN SITE/FIELD CONDITION,SANDY CONDUIT REPLACEMENT - CITYWIDE,SANDY CONDUIT REPLACEMENT - CITYWIDE,cpd11-20cw.pdf
SANDHW21,WHEN AND WHERE HURRICANE SANDY - CITYWIDE,850,DEPT OF DESIGN & CONSTRUCTION,PRIMARY STREET RECONSTRUCTION,000,CITYWIDE,SE-087HW,3147,2422,97,0,0,0,0,0,2519,2422,97,0,0,0,0,0,2519,4844,194,0,0,0,0,0,5038,PROJECT DELAYED DUE TO UNFORESEEN SITE/FIELD CONDITION,WHEN AND WHERE HURRICANE SANDY - CITYWIDE,RECONSTRUCTION OF THOMAS STREET - HURRICANE SANDY,cpd11-20cw.pdf
SANDISLND,HURRICANE SANDY DAMAGE ROCKAWAY BEACH ENTRY ISLANDS,850,DEPT OF DESIGN & CONSTRUCTION,MAJOR RECREATIONAL FACILITIES AND FACILITY RECONSTRUCTION,,CITYWIDE,P-1018,65009,5674,0,0,0,0,0,89,5763,5674,0,0,0,0,0,89,5763,11348,0,0,0,0,0,178,11526,PROJECT DELAYED DUE TO CHANGES IN SCOPE/DESIGN,,RECONSTRUCTION OF ROCKAWAY BEACH ENTRY ISLANDS,cpd11-20cw.pdf
SANDPRFAB,HURRICANE SANDY DAMAGE BEACHFRONT RESTORATION PROJECT,850,DEPT OF DESIGN & CONSTRUCTION,MAJOR RECREATIONAL FACILITIES AND FACILITY RECONSTRUCTION,,CITYWIDE,P-1018,136680,36760,17,0,0,0,0,7126,43903,36760,17,0,0,0,0,7126,43903,73520,34,0,0,0,0,14252,87806,PROJECT DELAYED DUE TO BUDGETARY CONSTRAINTS,,REPLACE MODULAR BUILDING UNITS AT VARIOUS FACILITIES,cpd11-20cw.pdf
SANDRENO,HURRCANE SANDY DAMAGE STATEN ISLAND BEACHES-VARIOUS,850,DEPT OF DESIGN & CONSTRUCTION,MAJOR RECREATIONAL FACILITIES AND FACILITY RECONSTRUCTION,,CITYWIDE,P-1018,13563,1254,0,0,0,0,0,1609,2863,1254,0,0,0,0,0,1609,2863,2508,0,0,0,0,0,3218,5726,PROJECT DELAYED DUE TO UNFORESEEN SITE/FIELD CONDITION,,NEW MODULAR STRUCTURES AT VARIOUS BEACHES IN STATEN ISLAND AND BROOKLYN,cpd11-20cw.pdf
SANDRESEP,ESCR Early Package - Reconstruction of Lesec Composting Area,850,DEPT OF DESIGN & CONSTRUCTION,MISCELLANEOUS ENERGY EFFICIENCY AND SUSTAINABILITY,000,CITYWIDE,PU-0100,2084,0,0,0,0,0,0,0,0,0,0,0,0,0,0,0,0,0,0,0,0,0,0,0,0,,,,cpd11-20cw.pdf
SANDRESM1,"Citywide Resiliency Measures, ESCR, Project Area 1",850,DEPT OF DESIGN & CONSTRUCTION,MISCELLANEOUS ENERGY EFFICIENCY AND SUSTAINABILITY,000,CITYWIDE,PU-0100 P-0508 SE-0002M,510854,3224,42497,200525,366413,350000,0,0,962659,3224,42497,200525,366413,350000,0,0,962659,6448,84994,401050,732826,700000,0,0,1925318,PROJECT DELAYED DUE TO BUDGETARY CONSTRAINTS,,CITYWIDE RESILIENCY MEASURES-EAST SIDE COASTAL RESILIENCY,cpd11-20cw.pdf
SANDRESM2,"Citywide Reiliency Measures, ESCR, Project Area 2",850,DEPT OF DESIGN & CONSTRUCTION,MISCELLANEOUS ENERGY EFFICIENCY AND SUSTAINABILITY,000,CITYWIDE,PU-0100 SE-0002M WM-0001,216235,0,14188,0,27125,0,0,0,41313,0,14188,0,27125,0,0,0,41313,0,28376,0,54250,0,0,0,82626,,,"CITYWIDE RESILIENCY MEASURES - EAST SIDE COASTAL RESILIENCY, PROJECT AREA 2",cpd11-20cw.pdf
SANDRESPC,"Citywide Reiliency Measures, ESCR, Parallel Conveyance",850,DEPT OF DESIGN & CONSTRUCTION,MISCELLANEOUS ENERGY EFFICIENCY AND SUSTAINABILITY,000,CITYWIDE,SE-0002M WM-0001 PU-0100,103633,0,51027,52606,0,0,0,0,103633,0,51027,52606,0,0,0,0,103633,0,102054,105212,0,0,0,0,207266,PROJECT DELAYED DUE TO CHANGES IN SCOPE/DESIGN,,,cpd11-20cw.pdf
SANDTWOBR,CITYWIDE RESILENCY MEASURES-Lower Manhattan Two Bridges SIRR,850,DEPT OF DESIGN & CONSTRUCTION,MISCELLANEOUS ENERGY EFFICIENCY AND SUSTAINABILITY,000,CITYWIDE,PU-0100 SE-0002M WM-0001,446383,0,0,2,0,0,0,0,2,0,0,2,0,0,0,0,2,0,0,4,0,0,0,0,4,,,,cpd11-20cw.pdf
SE-813,WATER MAIN WORK IN JEWEL STREETS AREA,850,DEPT OF DESIGN & CONSTRUCTION,REPLACEMENT OF CHRONICALLY FAILING COMPONENTS,000,CITYWIDE,SE-0200Q SE-0002K SE-0200K WM-0001,25910,1138,0,0,0,0,0,29641,30779,1138,0,0,0,0,0,29641,30779,2276,0,0,0,0,0,59282,61558,PROJECT DELAYED DUE TO CHANGES IN SCOPE/DESIGN,,WATER MAIN WORK IN JEWEL STREETS AREA COMMUNITY BOARD 10 IN QUEENS AND CB 5 BROOKLYN,cpd11-20cw.pdf
SEBLQX01,Reconstruction of existing sewers from back log QN & BX,850,DEPT OF DESIGN & CONSTRUCTION,REPLACEMENT OF CHRONICALLY FAILING COMPONENTS,000,CITYWIDE,SE-0002Q SE-0002X,9500,71,0,9500,0,0,0,0,9571,71,0,9500,0,0,0,0,9571,142,0,19000,0,0,0,0,19142,,,RECONSTRUCTION OF EXISTING SEWERS FROM BACK LOG IN QUEENS AND THE BRONX,cpd11-20cw.pdf
SEC20004V,Emergency Reconstruction of Sewers,850,DEPT OF DESIGN & CONSTRUCTION,REPLACEMENT OF CHRONICALLY FAILING COMPONENTS,,CITYWIDE,SE-0002Q,27500,34570,6002,0,0,0,0,0,40572,34570,6002,0,0,0,0,0,40572,69140,12004,0,0,0,0,0,81144,,,"EMERGENCY RECONSTRUCTION OF SEWERS, CITYWIDE",cpd11-20cw.pdf
SEC20004W,"Emergency Reconstruction of Sewers, Citywide",850,DEPT OF DESIGN & CONSTRUCTION,TRUNK AND DISTRIBUTION MAIN REPLACEMENT,000,CITYWIDE,EP-0007 SE-0002K SE-0002M SE-0002Q SE-0002R SE-0002X SE-0200K SE-0200Q SE-0200R,26129,0,23750,0,0,0,0,0,23750,0,23750,0,0,0,0,0,23750,0,47500,0,0,0,0,0,47500,,,CITYWIDE EMERGENCY RECONSTRUCTION OF SEWERS,cpd11-20cw.pdf
SE-GUN-20,"Emergency Guniting of Sewers, Citywide",850,DEPT OF DESIGN & CONSTRUCTION,REPLACEMENT OF CHRONICALLY FAILING COMPONENTS,,CITYWIDE,SE-0758,9000,135,9000,0,0,0,0,0,9135,135,9000,0,0,0,0,0,9135,270,18000,0,0,0,0,0,18270,,,"EMERGENCY GUNITING OF SEWERS, CITYWIDE",cpd11-20cw.pdf
SELCDDC09,"SEWER LINING CONTRACT, CITYWIDE",850,DEPT OF DESIGN & CONSTRUCTION,REPLACEMENT OF CHRONICALLY FAILING COMPONENTS,000,CITYWIDE,SE-0002Q SE-0002K SE-0002R SE-0002X SE-0002M,4000,7007,93,3937,0,0,0,0,11037,7007,93,3937,0,0,0,0,11037,14014,186,7874,0,0,0,0,22074,PROJECT DELAYED DUE TO UNFORESEEN SITE/FIELD CONDITION,,SEWER LINING OF NEW INTERIOR SURFACE TO SEWER WITHOUT REQUIRING OPEN TRENCH SEWER,cpd11-20cw.pdf
SELCDDC10,"SEWER LINING CONTRACT, CITYWIDE",850,DEPT OF DESIGN & CONSTRUCTION,REPLACEMENT OF CHRONICALLY FAILING COMPONENTS,000,CITYWIDE,SE-0002K SE-0002M SE-0002Q SE-0002R SE-0002X,4000,96,4001,0,0,0,0,0,4097,96,4001,0,0,0,0,0,4097,192,8002,0,0,0,0,0,8194,PROJECT DELAYED DUE TO UNFORESEEN SITE/FIELD CONDITION,,SEWER LINING OF NEW INTERIOR SURFACE TO SEWER WITHOUT REQUIRING OPEN TRENCH SEWER,cpd11-20cw.pdf
SETVDDC16,CLEANING AND TELEVISING OF SEWERS BY DDC,850,DEPT OF DESIGN & CONSTRUCTION,REPLACEMENT OF CHRONICALLY FAILING COMPONENTS,000,CITYWIDE,SE-087HW,2950,0,2954,0,0,0,0,0,2954,0,2954,0,0,0,0,0,2954,0,5908,0,0,0,0,0,5908,,,"CLEANING AND TELEVISING OF SEWERS BY DDC, CITYWIDE",cpd11-20cw.pdf
WM-LC-17,Citywide Lining Contract for Water Mains,850,DEPT OF DESIGN & CONSTRUCTION,AUGMENTATION OF WATER SUPPLY SYSTEMS,000,CITYWIDE,WM-0001,1000,5214,82,0,0,0,0,0,5296,5214,82,0,0,0,0,0,5296,10428,164,0,0,0,0,0,10592,PROJECT DELAYED DUE TO UNFORESEEN SITE/FIELD CONDITION,,CITYWIDE LINING CONTRACT FOR LINING OF WATER MAINS ON BRIDGES AND OTHER NECESSARY,cpd11-20cw.pdf
CO264CADA,CITYWIDE COURTS ADA LUMP SUM,856,DEPT OF CITYWIDE ADMIN SERVS,RECONSTRUCTION/RENOVATION OF COURT FACILITIES,,CITYWIDE,CO-0264,38139,0,0,0,0,3829,4210,17639,25678,0,0,0,0,3829,4210,17639,25678,0,0,0,0,7658,8420,35278,51356,,,CITYWIDE COURTS ADA REHABILATION,cpd11-20cw.pdf
CO264DCAS,REHABILITATION OF VARIOUS COURT FACILITES,856,DEPT OF CITYWIDE ADMIN SERVS,RECONSTRUCTION/RENOVATION OF COURT FACILITIES,000,CITYWIDE,CO-0264,1774,0,163,0,0,0,0,0,163,0,163,0,0,0,0,0,163,0,326,0,0,0,0,0,326,PROJECT DELAYED DUE TO CHANGES IN SCOPE/DESIGN,REHABILITATION OF VARIOUS COURT FACILITIES,REHABILITATION OF VARIOUS COURT FACILITIES,cpd11-20cw.pdf
CO-ADA,VARIOUS COURTS BUILDINGS - ADA WORK,856,DEPT OF CITYWIDE ADMIN SERVS,RECONSTRUCTION/RENOVATION OF COURT FACILITIES,000,CITYWIDE,CO-0264,3881,0,0,3881,0,0,0,0,3881,0,0,3881,0,0,0,0,3881,0,0,7762,0,0,0,0,7762,,,ACCESSIBILITY COMPLIANCE FOR DCAS MANAGED COURT BUILDINGS,cpd11-20cw.pdf
CO-HVAC,VARIOUS PUBLIC BUILDINGS - COURTS HVAC UPGRADES,856,DEPT OF CITYWIDE ADMIN SERVS,RECONSTRUCTION/RENOVATION OF COURT FACILITIES,000,CITYWIDE,CO-0264,18346,0,0,0,0,0,6121,12208,18329,0,0,0,0,0,6121,12208,18329,0,0,0,0,0,12242,24416,36658,,,VARIOUS PUBLIC BUILDINGS - COURTS HVAC UPGRADES,cpd11-20cw.pdf
CO-LL5,VARIOUS PUBLIC BUILDINGS - COURTS FIRE/LIFE SAFETY,856,DEPT OF CITYWIDE ADMIN SERVS,RECONSTRUCTION/RENOVATION OF COURT FACILITIES,000,CITYWIDE,CO-0264,27761,0,0,0,0,1420,0,18312,19732,0,0,0,0,1420,0,18312,19732,0,0,0,0,2840,0,36624,39464,,,VARIOUS PUBLIC BUILDINGS - COURTS FIRE/LIFE SAFETY,cpd11-20cw.pdf
CO-LL5FS,VARIOUS PUBLIC BUILDINGS - COURTS FIRE SUPPRESSION,856,DEPT OF CITYWIDE ADMIN SERVS,RECONSTRUCTION/RENOVATION OF COURT FACILITIES,000,CITYWIDE,CO-0264,43362,0,0,0,0,0,8048,39213,47261,0,0,0,0,0,8048,39213,47261,0,0,0,0,0,16096,78426,94522,,,VARIOUS PUBLIC BUILDINGS - COURTS FIRE DETECTION,cpd11-20cw.pdf
PW335ASB4,VARIOUS PUBLIC BUILDINGS- ENVIRONMENTAL REMEDIATION,856,DEPT OF CITYWIDE ADMIN SERVS,LEGAL MANDATES AND CORRECTION OF UNSAFE CONDITIONS,000,CITYWIDE,PW-0335,10774,7450,0,1334,0,0,0,0,8784,7450,0,1334,0,0,0,0,8784,14900,0,2668,0,0,0,0,17568,PROJECT DELAYED DUE TO CHANGES IN SCOPE/DESIGN,,REMEDIATE HAZARDOUS MATERIALS AT VARIOUS CITY SITES,cpd11-20cw.pdf
PW340EMAC,BOARD OF ELECTIONS,856,DEPT OF CITYWIDE ADMIN SERVS,BOARD OF ELECTIONS MODERNIZATION,000,CITYWIDE,PW-0340,18110,11575,-67,0,6030,0,0,0,17538,11575,-67,0,6030,0,0,0,17538,23150,-134,0,12060,0,0,0,35076,,,,cpd11-20cw.pdf
PW77CJC,Community Justice Center,856,DEPT OF CITYWIDE ADMIN SERVS,REHABILITATION OF CITY-OWNED OFFICE SPACE,000,CITYWIDE,PW-0077,5000,0,0,0,0,0,0,5000,5000,0,0,0,0,0,0,5000,5000,0,0,0,0,0,0,10000,10000,PROJECT DELAYED DUE TO BUDGETARY CONSTRAINTS,,COMMUNITY JUSTICE CENTER,cpd11-20cw.pdf
PW77NG911,DoITT Next Generation 911 and SDE Expansion,856,DEPT OF CITYWIDE ADMIN SERVS,COMMUNICATIONS EQUIPMENT,000,CITYWIDE,PW-0077 PW-0326,6188,0,6188,0,0,0,0,0,6188,0,6188,0,0,0,0,0,6188,0,12376,0,0,0,0,0,12376,,,,cpd11-20cw.pdf
PW77SECAM,SECURITY CAMERAS - DCAS PUBLIC BUILDINGS,856,DEPT OF CITYWIDE ADMIN SERVS,REHABILITATION OF CITY-OWNED OFFICE SPACE,000,CITYWIDE,PW-0077,4250,109,0,389,0,0,0,0,498,109,0,389,0,0,0,0,498,218,0,778,0,0,0,0,996,PROJECT DELAYED DUE TO BUDGETARY CONSTRAINTS,,SECURITY CAMERAS - DCAS PUBLIC BUILDINGS,cpd11-20cw.pdf
PWCOMPDA2,Comptroller's Office Data Center Replacement at 1 Centre St.,856,DEPT OF CITYWIDE ADMIN SERVS,REHABILITATION OF CITY-OWNED OFFICE SPACE,000,CITYWIDE,PW-0077,1283,0,1166,0,0,0,0,0,1166,0,1166,0,0,0,0,0,1166,0,2332,0,0,0,0,0,2332,,,COMPTROLLER'S OFFICE DATA CENTER REPLACEMENT AT 1 CENTRE ST.,cpd11-20cw.pdf
SOLARGR4,NYPA - SOLAR PARKING,856,DEPT OF CITYWIDE ADMIN SERVS,DISTRIBUTED GENERATION,000,CITYWIDE,PU-0025,26700,0,0,8000,0,0,0,0,8000,0,0,8000,0,0,0,0,8000,0,0,16000,0,0,0,0,16000,,,,cpd11-20cw.pdf
SOLARGR5,NYPA - RESILIENT SOLAR,856,DEPT OF CITYWIDE ADMIN SERVS,DISTRIBUTED GENERATION,000,CITYWIDE,PU-0025,10350,0,2463,4000,0,0,0,0,6463,0,2463,4000,0,0,0,0,6463,0,4926,8000,0,0,0,0,12926,,,,cpd11-20cw.pdf
CAPSOL91,VARIOUS TRANSIT PROJECTS,998,TRANSIT AUTHORITY CAPITAL,MISCELLANEOUS TRANSIT IMPROVEMENT PROJECTS,000,CITYWIDE,T-0169 T-D005,0,1458713,5000,0,0,0,0,0,1463713,1458713,5000,0,0,0,0,0,1463713,2917426,10000,0,0,0,0,0,2927426,,CITYWIDE,THIS IS A FUNDING SOURCE WHERE THE CITY CONTRIBUTES ADDITIONAL FUNDS TNEW YORK CITY,cpd11-20cw.pdf
LRCE12DOT,SASB,035,NEW YORK RESEARCH LIBRARY,ESSENTIAL RECONSTRUCTION OF FACILITIES,100 105,MANHATTAN,L-D002 L-0103 L-0101,3750,0,0,0,0,350,132,191,673,0,0,0,0,350,132,191,673,0,0,0,0,700,264,382,1346,PROJECT DELAYED DUE TO CHANGES IN SCOPE/DESIGN,,IMPROVEMENTS TO THE NYPL VICINITY,cpd11-20mn.pdf
LN18FEEL,58th Street - New Elevator (ADA Compliance),037,NEW YORK PUBLIC LIBRARY,ESSENTIAL RECONSTRUCTION OF FACILITIES,105,MANHATTAN,LN-D008,150,0,0,0,0,150,0,0,150,0,0,0,0,150,0,0,150,0,0,0,0,300,0,0,300,,,58TH STREET BRANCH--ADA COMPLIANCE - NEW ELEVATOR,cpd11-20mn.pdf
LN18HGHVA,HAMILTON GRANGE - HVAC System Replacement,037,NEW YORK PUBLIC LIBRARY,ESSENTIAL RECONSTRUCTION OF FACILITIES,109,MANHATTAN,LN-0008,1500,0,0,0,0,0,150,1350,1500,0,0,0,0,0,150,1350,1500,0,0,0,0,0,300,2700,3000,,,REPLACE HVAC,cpd11-20mn.pdf
LN18LBBOI,HEISKELL - Boilers (5) and HVAC replacement (11 units),037,NEW YORK PUBLIC LIBRARY,ESSENTIAL RECONSTRUCTION OF FACILITIES,105,MANHATTAN,LN-0008,3000,0,0,0,3000,0,0,0,3000,0,0,0,3000,0,0,0,3000,0,0,0,6000,0,0,0,6000,,,HEISKELL - BOILERS (5) AND HVAC REPLACEMENT (11 UNITS),cpd11-20mn.pdf
LN18TSHVA,TOMPKINS SQUARE - HVAC System Upgrade,037,NEW YORK PUBLIC LIBRARY,ESSENTIAL RECONSTRUCTION OF FACILITIES,103,MANHATTAN,LN-0008,1500,0,0,0,0,0,0,1500,1500,0,0,0,0,0,0,1500,1500,0,0,0,0,0,0,3000,3000,,,HVAC,cpd11-20mn.pdf
LN2058FPS,58th St - New Fire Protection Sprinkler System,037,NEW YORK PUBLIC LIBRARY,IMPROVEMENTS TO EXISTING FACILITIES,,MANHATTAN,LN-0008 LN-D008,715,0,0,0,0,131,550,0,681,0,0,0,0,131,550,0,681,0,0,0,0,262,1100,0,1362,,,PROVIDE A COMPLETELY CODE COMPLIANT FIRE PROTECTION SPRINKLER SYSTEM THROUGH OUT THE,cpd11-20mn.pdf
LNCA16INW,Inwood - Elevator,037,NEW YORK PUBLIC LIBRARY,ESSENTIAL RECONSTRUCTION OF FACILITIES,100,MANHATTAN,LN-D008,200,0,0,0,0,200,0,0,200,0,0,0,0,200,0,0,200,0,0,0,0,400,0,0,400,,,ELEVATOR,cpd11-20mn.pdf
LNMA16BLD,Bloomingdale - Roof Renovation,037,NEW YORK PUBLIC LIBRARY,ESSENTIAL RECONSTRUCTION OF FACILITIES,107,MANHATTAN,LN-M001 LN-D008,600,0,0,0,65,479,0,0,544,0,0,0,65,479,0,0,544,0,0,0,130,958,0,0,1088,,,ROOF RENOVATION,cpd11-20mn.pdf
LNMA17CSQ,CHATHAM SQUARE - Boiler Replacement,037,NEW YORK PUBLIC LIBRARY,ESSENTIAL RECONSTRUCTION OF FACILITIES,103,MANHATTAN,LN-D008 LN-M001,400,0,0,0,43,319,0,0,362,0,0,0,43,319,0,0,362,0,0,0,86,638,0,0,724,PROJECT DELAYED DUE TO BUDGETARY CONSTRAINTS,,CHATHAM SQUARE - BOILER REPLACEMENT.,cpd11-20mn.pdf
LNSSEXTFW,67th St - Building Envelope - Facade & Window Restoration,037,NEW YORK PUBLIC LIBRARY,ESSENTIAL RECONSTRUCTION OF FACILITIES,,MANHATTAN,LN-D008,1500,0,0,0,0,1500,0,0,1500,0,0,0,0,1500,0,0,1500,0,0,0,0,3000,0,0,3000,,,NYPL EAST 67TH STREET BRANCH BUILDING ENVELOPE -- FAÚADE AND WINDOW RESTORATION. FY19,cpd11-20mn.pdf
LNWBEXTFA,"Webster - Building Envelope, Facade Restoration",037,NEW YORK PUBLIC LIBRARY,ESSENTIAL RECONSTRUCTION OF FACILITIES,,MANHATTAN,LN-D008,2000,0,0,0,0,2000,0,0,2000,0,0,0,0,2000,0,0,2000,0,0,0,0,4000,0,0,4000,,,NYPL WEBSTER BRANCH BUILDING ENVELOPE -- FAÚADE RESTORATION,cpd11-20mn.pdf
BA001-021,Bathroom Upgrades,042,CITY UNIVERSITY,MISCELLANEOUS RECONSTRUCTION,100,MANHATTAN,HN-D300,292,0,292,0,0,0,0,0,292,0,292,0,0,0,0,0,292,0,584,0,0,0,0,0,584,,,ALL GENDER BATHROOMS,cpd11-20mn.pdf
BA013-013,"Data Center, UPS, and Cooling",042,CITY UNIVERSITY,MISCELLANEOUS RECONSTRUCTION,100 106,MANHATTAN,HN-D300,570,0,0,413,157,0,0,0,570,0,0,413,157,0,0,0,570,0,0,826,314,0,0,0,1140,PROJECT DELAYED DUE TO CHANGES IN SCOPE/DESIGN,,"DATA CENTER, UPS AND COOLING",cpd11-20mn.pdf
BA019-016,Library Modernization,042,CITY UNIVERSITY,MISCELLANEOUS RECONSTRUCTION,100,MANHATTAN,HN-D300,1000,1550,0,0,50,0,0,0,1600,1550,0,0,50,0,0,0,1600,3100,0,0,100,0,0,0,3200,PROJECT DELAYED DUE TO CHANGES IN SCOPE/DESIGN,,LIBRARY MODERNIZATION,cpd11-20mn.pdf
BA024-018,Modification of Main Entrance at 17 Lexington Avenue,042,CITY UNIVERSITY,MISCELLANEOUS RECONSTRUCTION,100,MANHATTAN,HN-D300,250,0,0,0,0,250,0,0,250,0,0,0,0,250,0,0,250,0,0,0,0,500,0,0,500,PROJECT DELAYED DUE TO CHANGES IN SCOPE/DESIGN,,MODIFICATION OF MAIN ENTRANCE AT 17 LEXINGTON AVE,cpd11-20mn.pdf
BA025-018,Marxe Lab/Public Space Upgrades for School of Public Affairs,042,CITY UNIVERSITY,MISCELLANEOUS RECONSTRUCTION,100,MANHATTAN,HN-D300,500,0,0,0,0,260,0,0,260,0,0,0,0,260,0,0,260,0,0,0,0,520,0,0,520,PROJECT DELAYED DUE TO CHANGES IN SCOPE/DESIGN,,MARXE LAB/PUBLIC SPACE UPGRADES FOOE SCHOOL OF PUBLIC AFFAIRS,cpd11-20mn.pdf
BA030-020,Mason Hall A/V System,042,CITY UNIVERSITY,MISCELLANEOUS RECONSTRUCTION,100,MANHATTAN,HN-M300 HN-D300,1950,0,0,0,150,1800,0,0,1950,0,0,0,150,1800,0,0,1950,0,0,0,300,3600,0,0,3900,,,MASON HALL A/V SYSTEM,cpd11-20mn.pdf
CA001-021,SLUS - Facility Upgrades,042,CITY UNIVERSITY,MISCELLANEOUS RECONSTRUCTION,100,MANHATTAN,HN-M300,150,0,150,0,0,0,0,0,150,0,150,0,0,0,0,0,150,0,300,0,0,0,0,0,300,,,SCHOOL OF LABOR UPGRADE,cpd11-20mn.pdf
CA002-021,SPS - Virtual Online Desktop - Informatics & Data Analytics,042,CITY UNIVERSITY,MISCELLANEOUS RECONSTRUCTION,100,MANHATTAN,HN-M300,100,0,100,0,0,0,0,0,100,0,100,0,0,0,0,0,100,0,200,0,0,0,0,0,200,,,SCHOOL OF PROFESSIONAL STUDIES,cpd11-20mn.pdf
CA003-021,Critical Maintenance,042,CITY UNIVERSITY,MISCELLANEOUS RECONSTRUCTION,100,MANHATTAN,HN-D004,7000,0,7000,0,0,0,0,0,7000,0,7000,0,0,0,0,0,7000,0,14000,0,0,0,0,0,14000,,,CUNY-WIDE LUMP SUM,cpd11-20mn.pdf
CA004-021,CUNY STEM Institute,042,CITY UNIVERSITY,MISCELLANEOUS RECONSTRUCTION,100,MANHATTAN,HN-D004,5000,0,0,5000,0,0,0,0,5000,0,0,5000,0,0,0,0,5000,0,0,10000,0,0,0,0,10000,,,CUNY STEM INSTITUTE,cpd11-20mn.pdf
CA005-021,CUNY SPH Renovation,042,CITY UNIVERSITY,MISCELLANEOUS RECONSTRUCTION,100,MANHATTAN,HN-M300,100,0,0,100,0,0,0,0,100,0,0,100,0,0,0,0,100,0,0,200,0,0,0,0,200,,,SCHOOL OF PUBLIC HEALTH,cpd11-20mn.pdf
CA013-008,"WEB VIDEO SYSTEMS FOR HANDICAPPED STUDENTS, CUNYWIDE",042,CITY UNIVERSITY,MISCELLANEOUS RECONSTRUCTION,,MANHATTAN,HN-D002,3998,682,0,0,0,1317,0,0,1999,682,0,0,0,1317,0,0,1999,1364,0,0,0,2634,0,0,3998,PROJECT DELAYED DUE TO CHANGES IN SCOPE/DESIGN,,"MECHANICAL, ELECTRICAL AND PLUMBING UPGRADES, CUNYWIDE",cpd11-20mn.pdf
CA027-012,Community College Laboratories,042,CITY UNIVERSITY,MISCELLANEOUS RECONSTRUCTION,100,MANHATTAN,HN-D002,2000,1322,0,0,0,669,0,0,1991,1322,0,0,0,669,0,0,1991,2644,0,0,0,1338,0,0,3982,PROJECT DELAYED DUE TO BUDGETARY CONSTRAINTS,,COMMUNITY COLLEGE LABORATORY IMPROVEMENTS,cpd11-20mn.pdf
CA032-013,Center for Innovation and Entrepreneurship,042,CITY UNIVERSITY,MISCELLANEOUS RECONSTRUCTION,100,MANHATTAN,HN-D300,2000,1787,0,0,0,213,0,0,2000,1787,0,0,0,213,0,0,2000,3574,0,0,0,426,0,0,4000,PROJECT DELAYED DUE TO CHANGES IN SCOPE/DESIGN,,CENTER FOR INNOVATION AND ENTREPRENEURSHIP,cpd11-20mn.pdf
CA049-019,CUNY In The Heights,042,CITY UNIVERSITY,MISCELLANEOUS RECONSTRUCTION,100,MANHATTAN,HN-D002,3040,2655,385,0,0,0,0,0,3040,2655,385,0,0,0,0,0,3040,5310,770,0,0,0,0,0,6080,PROJECT DELAYED DUE TO CHANGES IN SCOPE/DESIGN,,CUNY IN THE HEIGHTS,cpd11-20mn.pdf
CA050-017,"Health, Safety & ADA Projects",042,CITY UNIVERSITY,MISCELLANEOUS RECONSTRUCTION,100,MANHATTAN,HN-D002 HN-D003,7835,0,1005,0,0,0,0,0,1005,0,1005,0,0,0,0,0,1005,0,2010,0,0,0,0,0,2010,PROJECT DELAYED DUE TO CHANGES IN SCOPE/DESIGN,,"HEALTH, SAFETY & ADA PROJECTS",cpd11-20mn.pdf
CA050-019,"CUNY-Wide Community College Health, Safety & ADA Projects",042,CITY UNIVERSITY,MISCELLANEOUS RECONSTRUCTION,100,MANHATTAN,HN-D002,12000,0,0,7000,2131,2869,0,0,12000,0,0,7000,2131,2869,0,0,12000,0,0,14000,4262,5738,0,0,24000,,,"CUNY-WIDE COMMUNITY COLLEGE HEALTH, SAFETY & ADA PROJECTS",cpd11-20mn.pdf
CA054-017,CUNY Accelerated Study in Associate Programs Expansion,042,CITY UNIVERSITY,MISCELLANEOUS RECONSTRUCTION,100,MANHATTAN,HN-0206,2000,0,3109,0,0,0,0,0,3109,0,3109,0,0,0,0,0,3109,0,6218,0,0,0,0,0,6218,,,CUNY ACCELERATED STUDY IN ASSOCIATE PROGRAMS EXPANSION,cpd11-20mn.pdf
CA054-018,"CUNY Community College Health, Safety and ADA Projects",042,CITY UNIVERSITY,MISCELLANEOUS RECONSTRUCTION,100,MANHATTAN,HN-D004,10000,0,0,3027,0,0,0,0,3027,0,0,3027,0,0,0,0,3027,0,0,6054,0,0,0,0,6054,PROJECT DELAYED DUE TO CHANGES IN SCOPE/DESIGN,,"CUNY COMMUNITY COLLEGE HEALTH, SAFETY AND ADA PROJECTS",cpd11-20mn.pdf
CA054-020,"Health, Safety, and ADA Projects",042,CITY UNIVERSITY,MISCELLANEOUS RECONSTRUCTION,100,MANHATTAN,HN-D002,10000,0,0,3539,0,6461,0,0,10000,0,0,3539,0,6461,0,0,10000,0,0,7078,0,12922,0,0,20000,,,"HEALTH, SAFETY, AND ADA PROJECTS",cpd11-20mn.pdf
CA056-020,John Jay School of Law,042,CITY UNIVERSITY,MISCELLANEOUS RECONSTRUCTION,100,MANHATTAN,HN-D300,250,0,0,0,0,250,0,0,250,0,0,0,0,250,0,0,250,0,0,0,0,500,0,0,500,PROJECT DELAYED DUE TO CHANGES IN SCOPE/DESIGN,,JOHN JAY SCHOOL OF LAW,cpd11-20mn.pdf
CA200MC02,Pedestrian Plaza and Roof Replacement,042,CITY UNIVERSITY,NEW SCHOOL CONSTRUCTION,101,MANHATTAN,HN-D002 HN-0206,175,1966,0,1034,0,0,0,0,3000,1966,0,1034,0,0,0,0,3000,3932,0,2068,0,0,0,0,6000,PROJECT DELAYED DUE TO CHANGES IN SCOPE/DESIGN,,FIRE ALARM SYSTEM,cpd11-20mn.pdf
CA201MC04,BMCC RAMP & PLAZA PEDESTAL REPAIRS,042,CITY UNIVERSITY,MISCELLANEOUS RECONSTRUCTION,101,MANHATTAN,HN-D004,500,1061,0,197,0,0,0,0,1258,1061,0,197,0,0,0,0,1258,2122,0,394,0,0,0,0,2516,PROJECT DELAYED DUE TO UNFORESEEN HAZARDOUS CONDITION,,CHAMBERS ST. RAMP AND PLAZA PEDESTAL REPAIRS,cpd11-20mn.pdf
CA202MC01,ADA BATHROOM UPGRADES FOR BMCC,042,CITY UNIVERSITY,MISCELLANEOUS RECONSTRUCTION,101,MANHATTAN,HN-D002 HN-M001 HN-0206,940,3581,0,0,0,502,1,0,4084,3581,0,0,0,502,1,0,4084,7162,0,0,0,1004,2,0,8168,PROJECT DELAYED DUE TO CHANGES IN SCOPE/DESIGN,,ADA BATHROOM UPGRADES FOR 199 CHAMBERS ST.,cpd11-20mn.pdf
CC009-007,Upgrade North Academic Center Classrooms,042,CITY UNIVERSITY,MISCELLANEOUS RECONSTRUCTION,100 109,MANHATTAN,HN-D004,350,614,0,5,0,40,0,0,659,614,0,5,0,40,0,0,659,1228,0,10,0,80,0,0,1318,PROJECT DELAYED DUE TO CHANGES IN SCOPE/DESIGN,,UPGRADE NORTH ACADEMIC CENTER CLASSROOMS,cpd11-20mn.pdf
CC012-008,"RESTORATION OF LIBRARY AND BLDG, RANGEL CTR FOR PUBLIC SERV",042,CITY UNIVERSITY,MISCELLANEOUS RECONSTRUCTION,,MANHATTAN,HN-D300,40,0,0,0,0,40,0,0,40,0,0,0,0,40,0,0,40,0,0,0,0,80,0,0,80,PROJECT DELAYED DUE TO BUDGETARY CONSTRAINTS,,"RESTORATION OF LIBRARY AND BLDG, RANGEL CTR FOR PUBLIC SERVICE",cpd11-20mn.pdf
CC018-009,ARONOW THEATER UPGRADE,042,CITY UNIVERSITY,MISCELLANEOUS RECONSTRUCTION,100 109,MANHATTAN,HN-D300,1434,0,0,0,0,1174,0,0,1174,0,0,0,0,1174,0,0,1174,0,0,0,0,2348,0,0,2348,PROJECT DELAYED DUE TO BUDGETARY CONSTRAINTS,,AARON DAVIS HALL - IMPROVEMENTS TO LOBBY AND ENTRANCE,cpd11-20mn.pdf
CC022-012,Schiff House Day Care Center Upgrades,042,CITY UNIVERSITY,MISCELLANEOUS RECONSTRUCTION,100,MANHATTAN,HN-D300,1600,2078,0,0,0,322,0,0,2400,2078,0,0,0,322,0,0,2400,4156,0,0,0,644,0,0,4800,PROJECT DELAYED DUE TO CHANGES IN SCOPE/DESIGN,,SCHIFF HOUSE DAY CARE CENTER UPGRADES,cpd11-20mn.pdf
CC025-013,Dominican Studies Institute,042,CITY UNIVERSITY,MISCELLANEOUS RECONSTRUCTION,100 109,MANHATTAN,HN-D300,200,0,0,0,0,200,0,0,200,0,0,0,0,200,0,0,200,0,0,0,0,400,0,0,400,PROJECT DELAYED DUE TO BUDGETARY CONSTRAINTS,,DOMINICAN STUDIES INSTITUTE EXPANSION,cpd11-20mn.pdf
CC026-013,Aaron Davis Hall,042,CITY UNIVERSITY,MISCELLANEOUS RECONSTRUCTION,100 109,MANHATTAN,HN-M300 HN-D300,400,0,0,0,0,6096,0,0,6096,0,0,0,0,6096,0,0,6096,0,0,0,0,12192,0,0,12192,PROJECT DELAYED DUE TO CHANGES IN SCOPE/DESIGN,,AARON DAVIS HALL,cpd11-20mn.pdf
CC027-014,Max Bond Center,042,CITY UNIVERSITY,MISCELLANEOUS RECONSTRUCTION,100 109,MANHATTAN,HN-D300,500,0,0,0,0,500,0,0,500,0,0,0,0,500,0,0,500,0,0,0,0,1000,0,0,1000,PROJECT DELAYED DUE TO CHANGES IN SCOPE/DESIGN,,MAX BOND CENTER/WINGATE POOL RESTORATION/CONT. & PROF. STUDIES,cpd11-20mn.pdf
CC029-014,Network Infrastructure Modernization,042,CITY UNIVERSITY,MISCELLANEOUS RECONSTRUCTION,100 109,MANHATTAN,HN-D300,2500,0,0,0,0,2500,0,0,2500,0,0,0,0,2500,0,0,2500,0,0,0,0,5000,0,0,5000,PROJECT DELAYED DUE TO CHANGES IN SCOPE/DESIGN,,NETWORK INFRASTRUCTURE MODERNIZATION,cpd11-20mn.pdf
CC032-015,City College Computer Lab,042,CITY UNIVERSITY,MISCELLANEOUS RECONSTRUCTION,100,MANHATTAN,HN-M300,200,0,0,0,0,0,200,0,200,0,0,0,0,0,200,0,200,0,0,0,0,0,400,0,400,PROJECT DELAYED DUE TO CHANGES IN SCOPE/DESIGN,,CITY COLLEGE COMPUTER LAB,cpd11-20mn.pdf
CC034-016,Computer Lab Renovation,042,CITY UNIVERSITY,MISCELLANEOUS RECONSTRUCTION,100,MANHATTAN,HN-M300,250,0,0,0,0,0,250,0,250,0,0,0,0,0,250,0,250,0,0,0,0,0,500,0,500,PROJECT DELAYED DUE TO CHANGES IN SCOPE/DESIGN,,COMPUTER LAB RENOVATION,cpd11-20mn.pdf
CC037-017,Harlem Rooftop Garden,042,CITY UNIVERSITY,MISCELLANEOUS RECONSTRUCTION,100,MANHATTAN,HN-M300,201,0,0,201,0,0,0,0,201,0,0,201,0,0,0,0,201,0,0,402,0,0,0,0,402,PROJECT DELAYED DUE TO CHANGES IN SCOPE/DESIGN,,HARLEM ROOFTOP GARDEN,cpd11-20mn.pdf
CC039-017,Street Improvements,042,CITY UNIVERSITY,MISCELLANEOUS RECONSTRUCTION,100,MANHATTAN,HN-D300,200,0,0,0,0,200,0,0,200,0,0,0,0,200,0,0,200,0,0,0,0,400,0,0,400,PROJECT DELAYED DUE TO CHANGES IN SCOPE/DESIGN,,STREET IMPROVEMENTS,cpd11-20mn.pdf
CC041-018,Wireless Network Upgrade Expansion,042,CITY UNIVERSITY,MISCELLANEOUS RECONSTRUCTION,100,MANHATTAN,HN-D300,1800,0,0,0,0,1800,0,0,1800,0,0,0,0,1800,0,0,1800,0,0,0,0,3600,0,0,3600,PROJECT DELAYED DUE TO CHANGES IN SCOPE/DESIGN,,CITY COLLEGE WIRELESS NETWORK UPGRADE AXPANSION,cpd11-20mn.pdf
CC042-018,Facility Upgrades,042,CITY UNIVERSITY,MISCELLANEOUS RECONSTRUCTION,100,MANHATTAN,HN-D300,1252,0,0,0,0,1252,0,0,1252,0,0,0,0,1252,0,0,1252,0,0,0,0,2504,0,0,2504,PROJECT DELAYED DUE TO CHANGES IN SCOPE/DESIGN,,CITY COLLEGE FACILITY UPGRADES,cpd11-20mn.pdf
CC045-019,Kitchen Upgrade for the Culinary Program,042,CITY UNIVERSITY,MISCELLANEOUS RECONSTRUCTION,100,MANHATTAN,HN-D300,1200,0,0,0,0,1200,0,0,1200,0,0,0,0,1200,0,0,1200,0,0,0,0,2400,0,0,2400,PROJECT DELAYED DUE TO CHANGES IN SCOPE/DESIGN,,KITCHEN UPGRADE FOR THE CULINARY PROGRAM,cpd11-20mn.pdf
GR009-009,CLASSROOM EXPANSION PROJECT,042,CITY UNIVERSITY,MISCELLANEOUS RECONSTRUCTION,100 105,MANHATTAN,HN-M300,550,131,0,0,0,919,0,0,1050,131,0,0,0,919,0,0,1050,262,0,0,0,1838,0,0,2100,PROJECT DELAYED DUE TO CHANGES IN SCOPE/DESIGN,,CLASSROOM DEVELOPMENT,cpd11-20mn.pdf
GR012-011,Green Roof / Space Conversion,042,CITY UNIVERSITY,MISCELLANEOUS RECONSTRUCTION,100 105,MANHATTAN,HN-D300,1000,0,0,0,0,500,0,0,500,0,0,0,0,500,0,0,500,0,0,0,0,1000,0,0,1000,PROJECT DELAYED DUE TO BUDGETARY CONSTRAINTS,,STUDENT- FACULTY GREEN ROOF,cpd11-20mn.pdf
GR013-012,Classroom Expansion Project - Roof,042,CITY UNIVERSITY,MISCELLANEOUS RECONSTRUCTION,100 105,MANHATTAN,HN-D300,1000,0,0,0,0,1000,0,0,1000,0,0,0,0,1000,0,0,1000,0,0,0,0,2000,0,0,2000,PROJECT DELAYED DUE TO BUDGETARY CONSTRAINTS,,CLASSROOM EXPANSION PROJECT,cpd11-20mn.pdf
GR014-013,Classroom Development Project (9th Floor),042,CITY UNIVERSITY,MISCELLANEOUS RECONSTRUCTION,100 105,MANHATTAN,HN-D300,500,0,0,0,0,500,0,0,500,0,0,0,0,500,0,0,500,0,0,0,0,1000,0,0,1000,PROJECT DELAYED DUE TO BUDGETARY CONSTRAINTS,,NINETH FLOOR BUILD OUT,cpd11-20mn.pdf
GR017-014,Bathroom and HVAC Upgrades,042,CITY UNIVERSITY,MISCELLANEOUS RECONSTRUCTION,100 105,MANHATTAN,HN-M300,1000,1487,0,0,0,0,88,0,1575,1487,0,0,0,0,88,0,1575,2974,0,0,0,0,176,0,3150,PROJECT DELAYED DUE TO CHANGES IN SCOPE/DESIGN,,BATHROOM AND HVAC UPGRADES,cpd11-20mn.pdf
GR018-015,Library Renovations,042,CITY UNIVERSITY,MISCELLANEOUS RECONSTRUCTION,100,MANHATTAN,HN-D300,500,0,0,0,500,0,0,0,500,0,0,0,500,0,0,0,500,0,0,0,1000,0,0,0,1000,PROJECT DELAYED DUE TO BUDGETARY CONSTRAINTS,,BATHROOM UPGRADES,cpd11-20mn.pdf
GR023-017,Improvement of Public Spaces,042,CITY UNIVERSITY,MISCELLANEOUS RECONSTRUCTION,100,MANHATTAN,HN-D300,1200,0,0,0,0,975,0,0,975,0,0,0,0,975,0,0,975,0,0,0,0,1950,0,0,1950,PROJECT DELAYED DUE TO CHANGES IN SCOPE/DESIGN,,IMPROVEMENT OF PUBLIC SPACES,cpd11-20mn.pdf
GR029-020,AUDITORIUM SOUND SYSTEM,042,CITY UNIVERSITY,MISCELLANEOUS RECONSTRUCTION,100 105,MANHATTAN,HN-D300 HN-M300,250,0,0,0,0,125,125,0,250,0,0,0,0,125,125,0,250,0,0,0,0,250,250,0,500,PROJECT DELAYED DUE TO CHANGES IN SCOPE/DESIGN,,AUDITORIUM SOUND SYSTEM,cpd11-20mn.pdf
GR030-020,Feminist Institute Lounge,042,CITY UNIVERSITY,MISCELLANEOUS RECONSTRUCTION,100,MANHATTAN,HN-D300,250,0,0,0,0,250,0,0,250,0,0,0,0,250,0,0,250,0,0,0,0,500,0,0,500,PROJECT DELAYED DUE TO CHANGES IN SCOPE/DESIGN,,FEMINIST INSTITUTE LOUNGE,cpd11-20mn.pdf
GU031-013,New Community College Student Lab Renovations,042,CITY UNIVERSITY,MISCELLANEOUS RECONSTRUCTION,100,MANHATTAN,HN-D004,1000,0,0,0,0,1000,0,0,1000,0,0,0,0,1000,0,0,1000,0,0,0,0,2000,0,0,2000,PROJECT DELAYED DUE TO CHANGES IN SCOPE/DESIGN,,NEW COMMUNITY COLLEGE STUDENT LAB RENOVATIONS,cpd11-20mn.pdf
GU051-015,Guttman Comm. Coll. Building Canopy,042,CITY UNIVERSITY,MISCELLANEOUS RECONSTRUCTION,100,MANHATTAN,HN-D002,35,0,0,0,0,35,0,0,35,0,0,0,0,35,0,0,35,0,0,0,0,70,0,0,70,PROJECT DELAYED DUE TO CHANGES IN SCOPE/DESIGN,,GUTTMAN BUILDING CANOPY,cpd11-20mn.pdf
HC001-021,Athletic Facility Renovation,042,CITY UNIVERSITY,MISCELLANEOUS RECONSTRUCTION,100,MANHATTAN,HN-M300,100,0,100,0,0,0,0,0,100,0,100,0,0,0,0,0,100,0,200,0,0,0,0,0,200,,,ATHLETIC FACILITY RENOVATION,cpd11-20mn.pdf
HC026-011,Phone System Upgrade And Expansion,042,CITY UNIVERSITY,MISCELLANEOUS RECONSTRUCTION,100 108,MANHATTAN,HN-D300,300,0,0,300,0,0,0,0,300,0,0,300,0,0,0,0,300,0,0,600,0,0,0,0,600,PROJECT DELAYED DUE TO CHANGES IN SCOPE/DESIGN,,PHONE SYSTEM UPGRADE AND EXPANSION,cpd11-20mn.pdf
HC032-017,Athletic Facilities Renovation,042,CITY UNIVERSITY,MISCELLANEOUS RECONSTRUCTION,100,MANHATTAN,HN-M300 HN-D300,365,1082,0,0,117,0,0,0,1199,1082,0,0,117,0,0,0,1199,2164,0,0,234,0,0,0,2398,PROJECT DELAYED DUE TO CHANGES IN SCOPE/DESIGN,,ATHLETIC FACILITIES RENOVATION,cpd11-20mn.pdf
HC033-019,Expansive Glass Addition to the Building Facing West,042,CITY UNIVERSITY,MISCELLANEOUS RECONSTRUCTION,108,MANHATTAN,HN-M300 HN-D300,400,0,0,0,400,0,0,0,400,0,0,0,400,0,0,0,400,0,0,0,800,0,0,0,800,PROJECT DELAYED DUE TO CHANGES IN SCOPE/DESIGN,,EXPANSIVE GLASS ADDITION TO THE BUILDING FACING WEST,cpd11-20mn.pdf
HC034-018,Hunter Campus Atrium,042,CITY UNIVERSITY,MISCELLANEOUS RECONSTRUCTION,100,MANHATTAN,HN-D300,100,0,0,0,100,0,0,0,100,0,0,0,100,0,0,0,100,0,0,0,200,0,0,0,200,PROJECT DELAYED DUE TO CHANGES IN SCOPE/DESIGN,,HUNTER CAMPUS ATRIUM,cpd11-20mn.pdf
HC036-020,GLASS BOX,042,CITY UNIVERSITY,MISCELLANEOUS RECONSTRUCTION,100,MANHATTAN,HN-D300,400,0,0,0,400,0,0,0,400,0,0,0,400,0,0,0,400,0,0,0,800,0,0,0,800,,,GLASS BOX,cpd11-20mn.pdf
HC075-098,HVAC Improvements,042,CITY UNIVERSITY,"ELECTRICAL, MECHANICAL AND HVAC SYSTEM UPGRADING",108,MANHATTAN,HN-0244 HN-0206,3267,15747,871,0,0,0,0,0,16618,15747,871,0,0,0,0,0,16618,31494,1742,0,0,0,0,0,33236,PROJECT DELAYED DUE TO BUDGETARY CONSTRAINTS,,,cpd11-20mn.pdf
HU001-021,EQFN for the Welcome Center at the School of Education,042,CITY UNIVERSITY,MISCELLANEOUS RECONSTRUCTION,100,MANHATTAN,HN-D300,100,0,100,0,0,0,0,0,100,0,100,0,0,0,0,0,100,0,200,0,0,0,0,0,200,,,SCHOOL OF EDUCATION RENOVATION,cpd11-20mn.pdf
HU002-021,Construction of a Teaching Kitchen,042,CITY UNIVERSITY,MISCELLANEOUS RECONSTRUCTION,100,MANHATTAN,HN-D300,75,0,75,0,0,0,0,0,75,0,75,0,0,0,0,0,75,0,150,0,0,0,0,0,150,,,TEACHING KITCHEN,cpd11-20mn.pdf
HU003-021,Auditorium Renovation,042,CITY UNIVERSITY,MISCELLANEOUS RECONSTRUCTION,100,MANHATTAN,HN-D300,4000,0,0,4000,0,0,0,0,4000,0,0,4000,0,0,0,0,4000,0,0,8000,0,0,0,0,8000,,,HUNTER COLLEGE,cpd11-20mn.pdf
HU004-021,School of Education Renovation,042,CITY UNIVERSITY,MISCELLANEOUS RECONSTRUCTION,100,MANHATTAN,HN-M300,100,0,100,0,0,0,0,0,100,0,100,0,0,0,0,0,100,0,200,0,0,0,0,0,200,,,SCHOOL OF EDUCATION RENOVATION,cpd11-20mn.pdf
HU007-004,Restore Roosevelt House,042,CITY UNIVERSITY,MISCELLANEOUS RECONSTRUCTION,100 108,MANHATTAN,HN-D004,1000,786,0,0,0,207,0,0,993,786,0,0,0,207,0,0,993,1572,0,0,0,414,0,0,1986,PROJECT DELAYED DUE TO CHANGES IN SCOPE/DESIGN,,OTHER,cpd11-20mn.pdf
HU022-009,EXPERIMENTAL PSYCHOLOGY LAB BUILDOUT,042,CITY UNIVERSITY,MISCELLANEOUS RECONSTRUCTION,100 108,MANHATTAN,HN-D004 HN-M004,732,588,0,0,0,51,36,0,675,588,0,0,0,51,36,0,675,1176,0,0,0,102,72,0,1350,PROJECT DELAYED DUE TO CHANGES IN SCOPE/DESIGN,,EXPAND PSYCHOLOGY LAB,cpd11-20mn.pdf
HU026-013,Science and Health Professions Building,042,CITY UNIVERSITY,NEW SCHOOL CONSTRUCTION,100 108,MANHATTAN,HN-0300,100000,0,0,0,0,0,27750,0,27750,0,0,0,0,0,27750,0,27750,0,0,0,0,0,55500,0,55500,PROJECT DELAYED DUE TO BUDGETARY CONSTRAINTS,,SCIENCE AND HEALTH PROFESSIONS BUILDING,cpd11-20mn.pdf
HU027-013,SCHOOL OF NURSING/HEALTH SCIENCE RELOCATION TO C3,042,CITY UNIVERSITY,MISCELLANEOUS RECONSTRUCTION,100,MANHATTAN,HN-0300,47150,0,0,0,0,0,47150,0,47150,0,0,0,0,0,47150,0,47150,0,0,0,0,0,94300,0,94300,PROJECT DELAYED DUE TO BUDGETARY CONSTRAINTS,,SCHOOL OF NURSING/HEALTH SCIENCE RELOCATION TO C3,cpd11-20mn.pdf
HU028-015,Black Box Performance Space,042,CITY UNIVERSITY,MISCELLANEOUS RECONSTRUCTION,100,MANHATTAN,HN-M300,300,0,0,0,0,300,0,0,300,0,0,0,0,300,0,0,300,0,0,0,0,600,0,0,600,PROJECT DELAYED DUE TO CHANGES IN SCOPE/DESIGN,,BLACK BOX PERFORMANCE SPACE,cpd11-20mn.pdf
HU029-015,Black Box Media & Arts Flex Space Improvements,042,CITY UNIVERSITY,MISCELLANEOUS RECONSTRUCTION,100,MANHATTAN,HN-D300,375,0,0,0,0,375,0,0,375,0,0,0,0,375,0,0,375,0,0,0,0,750,0,0,750,PROJECT DELAYED DUE TO CHANGES IN SCOPE/DESIGN,,BLACK BOX MEDIA & ARTS FLEX SPACE IMPROVEMENTS,cpd11-20mn.pdf
HU035-016,Black Box Theater Renovation Black Box Theater Renovation,042,CITY UNIVERSITY,MISCELLANEOUS RECONSTRUCTION,108,MANHATTAN,HN-M003 HN-D300,612,0,0,0,0,612,0,0,612,0,0,0,0,612,0,0,612,0,0,0,0,1224,0,0,1224,PROJECT DELAYED DUE TO CHANGES IN SCOPE/DESIGN,,THEATER RENOVATION,cpd11-20mn.pdf
HU036-017,Black Box Renovation,042,CITY UNIVERSITY,MISCELLANEOUS RECONSTRUCTION,100,MANHATTAN,HN-M300 HN-D300,500,0,0,0,0,500,0,0,500,0,0,0,0,500,0,0,500,0,0,0,0,1000,0,0,1000,PROJECT DELAYED DUE TO CHANGES IN SCOPE/DESIGN,,BLACK BOX RENOVATION,cpd11-20mn.pdf
HU037-017,CUNY Performing Arts Hub,042,CITY UNIVERSITY,MISCELLANEOUS RECONSTRUCTION,100,MANHATTAN,HN-D300,5000,0,0,0,0,5000,0,0,5000,0,0,0,0,5000,0,0,5000,0,0,0,0,10000,0,0,10000,PROJECT DELAYED DUE TO CHANGES IN SCOPE/DESIGN,,CUNY PERFORMING ARTS HUB,cpd11-20mn.pdf
HU039-018,Performing Arts Hub - Renovate N Building Auditorium,042,CITY UNIVERSITY,MISCELLANEOUS RECONSTRUCTION,100,MANHATTAN,HN-D300,3500,0,0,0,0,3500,0,0,3500,0,0,0,0,3500,0,0,3500,0,0,0,0,7000,0,0,7000,PROJECT DELAYED DUE TO CHANGES IN SCOPE/DESIGN,,"RENOVATE ""N"" BUILDING AUDITORIUM",cpd11-20mn.pdf
HU040-018,Renovate Performing Arts Hub in North Building,042,CITY UNIVERSITY,MISCELLANEOUS RECONSTRUCTION,100,MANHATTAN,HN-D300,1900,0,0,0,0,1900,0,0,1900,0,0,0,0,1900,0,0,1900,0,0,0,0,3800,0,0,3800,PROJECT DELAYED DUE TO CHANGES IN SCOPE/DESIGN,,RENOVATE PERFORMING ARTS HUB IN NORTH BUILDING,cpd11-20mn.pdf
HU040-019,Computer Science 10th FL. North Expansion,042,CITY UNIVERSITY,MISCELLANEOUS RECONSTRUCTION,100,MANHATTAN,HN-M300,250,0,0,250,0,0,0,0,250,0,0,250,0,0,0,0,250,0,0,500,0,0,0,0,500,PROJECT DELAYED DUE TO CHANGES IN SCOPE/DESIGN,,COMPUTER SCIENCE 10TH FL. NORTH EXPANSION,cpd11-20mn.pdf
HU041-019,Black Box Media Flex Space,042,CITY UNIVERSITY,MISCELLANEOUS RECONSTRUCTION,100,MANHATTAN,HN-D300,2285,0,0,0,0,2285,0,0,2285,0,0,0,0,2285,0,0,2285,0,0,0,0,4570,0,0,4570,PROJECT DELAYED DUE TO CHANGES IN SCOPE/DESIGN,,HUNTER COLLEGE BLACK BOX MEDIA FLEX SPACE,cpd11-20mn.pdf
HU042-019,Thomas Hunter Hall Upgrades,042,CITY UNIVERSITY,MISCELLANEOUS RECONSTRUCTION,100,MANHATTAN,HN-D300,950,472,0,478,0,0,0,0,950,472,0,478,0,0,0,0,950,944,0,956,0,0,0,0,1900,,,THOMAS HUNTER HALL UPGRADES,cpd11-20mn.pdf
HU043-020,Auditorium Renovation in North Building,042,CITY UNIVERSITY,MISCELLANEOUS RECONSTRUCTION,100,MANHATTAN,HN-D300,4000,0,0,0,0,4000,0,0,4000,0,0,0,0,4000,0,0,4000,0,0,0,0,8000,0,0,8000,PROJECT DELAYED DUE TO CHANGES IN SCOPE/DESIGN,,AUDITORIUM RENOVATION IN NORTH BUILDING,cpd11-20mn.pdf
HU044-020,Dance Department Lobby Renovation,042,CITY UNIVERSITY,MISCELLANEOUS RECONSTRUCTION,100,MANHATTAN,HN-D300,100,0,0,100,0,0,0,0,100,0,0,100,0,0,0,0,100,0,0,200,0,0,0,0,200,,,DANCE DEPARTMENT LOBBY RENOVATION,cpd11-20mn.pdf
JJ001-021,Multimedia Distribution System,042,CITY UNIVERSITY,MISCELLANEOUS RECONSTRUCTION,100,MANHATTAN,HN-M300,100,0,100,0,0,0,0,0,100,0,100,0,0,0,0,0,100,0,200,0,0,0,0,0,200,,,MULTIMEDIA DISTRIBUTION SYSTEM,cpd11-20mn.pdf
JJ021-015,Lloyd Sealy Library Upgrade,042,CITY UNIVERSITY,MISCELLANEOUS RECONSTRUCTION,100,MANHATTAN,HN-D300,250,215,0,0,0,35,0,0,250,215,0,0,0,35,0,0,250,430,0,0,0,70,0,0,500,PROJECT DELAYED DUE TO CHANGES IN SCOPE/DESIGN,,LLOYD SEALY LIBRARY UPGRADE,cpd11-20mn.pdf
JJ024-017,Locker Rooms and Gym Entrance,042,CITY UNIVERSITY,MISCELLANEOUS RECONSTRUCTION,100,MANHATTAN,HN-D300,650,0,0,0,0,650,0,0,650,0,0,0,0,650,0,0,650,0,0,0,0,1300,0,0,1300,PROJECT DELAYED DUE TO CHANGES IN SCOPE/DESIGN,,LOCKER ROOMS AND GYM ENTRANCE,cpd11-20mn.pdf
JJ029-018,Theater ADA Upgrades,042,CITY UNIVERSITY,MISCELLANEOUS RECONSTRUCTION,100,MANHATTAN,HN-D300,1000,0,0,0,0,1000,0,0,1000,0,0,0,0,1000,0,0,1000,0,0,0,0,2000,0,0,2000,PROJECT DELAYED DUE TO CHANGES IN SCOPE/DESIGN,,THEATER ADA UPGRADES,cpd11-20mn.pdf
MC001-021,Library Interior Renovation,042,CITY UNIVERSITY,MISCELLANEOUS RECONSTRUCTION,100,MANHATTAN,HN-D004 HN-M005,1800,0,1800,0,0,0,0,0,1800,0,1800,0,0,0,0,0,1800,0,3600,0,0,0,0,0,3600,,,LIBRARY RENOVATION,cpd11-20mn.pdf
MC028-010,CUNY,042,CITY UNIVERSITY,"BUILDING CONSTRUCTION, RECONSTRUCTION OR RETROFIT",101,MANHATTAN,PU-0025 HN-M001,9900,11236,0,0,2,0,58,0,11296,11236,0,0,2,0,58,0,11296,22472,0,0,4,0,116,0,22592,PROJECT DELAYED DUE TO UNFORESEEN SITE/FIELD CONDITION,,ENERGY EFFICIENCY UPGRADE AT BOROUGH OF MANHATTAN COMMUNITY COLLEGE; 199 CHAMBERS,cpd11-20mn.pdf
MC029-012,Gymnasium Air Conditioning System,042,CITY UNIVERSITY,MISCELLANEOUS RECONSTRUCTION,100 101,MANHATTAN,HN-D004,1400,1000,0,400,0,0,0,0,1400,1000,0,400,0,0,0,0,1400,2000,0,800,0,0,0,0,2800,PROJECT DELAYED DUE TO CHANGES IN SCOPE/DESIGN,,GYMNASIUM AIR CONDITIONING SYSTEM,cpd11-20mn.pdf
MC036-016,Perimeter Security Lighting,042,CITY UNIVERSITY,MISCELLANEOUS RECONSTRUCTION,101,MANHATTAN,HN-D002 HN-M005,300,0,0,0,0,150,150,0,300,0,0,0,0,150,150,0,300,0,0,0,0,300,300,0,600,PROJECT DELAYED DUE TO CHANGES IN SCOPE/DESIGN,,PERIMETER SECURITY LIGHTING,cpd11-20mn.pdf
MC040-018,LED Conversion in Public Areas,042,CITY UNIVERSITY,MISCELLANEOUS RECONSTRUCTION,,MANHATTAN,HN-M005 HN-D004 HN-D002,1325,0,0,1325,0,0,0,0,1325,0,0,1325,0,0,0,0,1325,0,0,2650,0,0,0,0,2650,PROJECT DELAYED DUE TO BUDGETARY CONSTRAINTS,,LED CONVERSION IN PUBLIC AREAS,cpd11-20mn.pdf
MC042-018,BMCC Pedestrian Enclosed Extension,042,CITY UNIVERSITY,MISCELLANEOUS RECONSTRUCTION,100,MANHATTAN,HN-D004 HN-D002,900,202,0,248,652,1148,0,0,2250,202,0,248,652,1148,0,0,2250,404,0,496,1304,2296,0,0,4500,PROJECT DELAYED DUE TO CHANGES IN SCOPE/DESIGN,,BMCC PEDESTRIAN ENCLOSED EXTENSION,cpd11-20mn.pdf
MC044-019,New Corridor Access Controls and Doors,042,CITY UNIVERSITY,MISCELLANEOUS RECONSTRUCTION,100,MANHATTAN,HN-D002,925,0,0,0,0,925,0,0,925,0,0,0,0,925,0,0,925,0,0,0,0,1850,0,0,1850,PROJECT DELAYED DUE TO CHANGES IN SCOPE/DESIGN,,NEW CORRIDOR ACCESS AND CONTROLS,cpd11-20mn.pdf
MC045-020,Tribeca Performing Arts Center Theater 1 & 2 Lighting Upgra,042,CITY UNIVERSITY,MISCELLANEOUS RECONSTRUCTION,100,MANHATTAN,HN-M005 HN-D002,1300,0,0,0,0,1300,0,0,1300,0,0,0,0,1300,0,0,1300,0,0,0,0,2600,0,0,2600,PROJECT DELAYED DUE TO CHANGES IN SCOPE/DESIGN,,TRIBECA PERFORMING ARTS CENTER THEATER 1 & 2 LIGHTING UPGRADE INSTALLATION OF NEW,cpd11-20mn.pdf
MH040-014,Macaulay Honors College Classroom Upgrades,042,CITY UNIVERSITY,MISCELLANEOUS RECONSTRUCTION,100,MANHATTAN,HN-D300,285,0,0,0,0,285,0,0,285,0,0,0,0,285,0,0,285,0,0,0,0,570,0,0,570,PROJECT DELAYED DUE TO CHANGES IN SCOPE/DESIGN,,MACCAULEY HONORS COLLEGE CLASSROOM UPGRADES,cpd11-20mn.pdf
MH053-016,Macaulay Honors College - New Media Lab,042,CITY UNIVERSITY,MISCELLANEOUS RECONSTRUCTION,100,MANHATTAN,HN-D300,100,0,0,0,0,100,0,0,100,0,0,0,0,100,0,0,100,0,0,0,0,200,0,0,200,PROJECT DELAYED DUE TO CHANGES IN SCOPE/DESIGN,,NEW MEDIA LAB,cpd11-20mn.pdf
MH059-017,Macaulay Honors College Data Science Lab,042,CITY UNIVERSITY,MISCELLANEOUS RECONSTRUCTION,100,MANHATTAN,HN-D300,450,0,0,0,0,450,0,0,450,0,0,0,0,450,0,0,450,0,0,0,0,900,0,0,900,PROJECT DELAYED DUE TO CHANGES IN SCOPE/DESIGN,,DATA SCIENCE LAB,cpd11-20mn.pdf
MH060-020,New Media/Data Science Lab,042,CITY UNIVERSITY,MISCELLANEOUS RECONSTRUCTION,100,MANHATTAN,HN-D300,450,0,0,0,0,450,0,0,450,0,0,0,0,450,0,0,450,0,0,0,0,900,0,0,900,PROJECT DELAYED DUE TO CHANGES IN SCOPE/DESIGN,,NEW MEDIA/DATA SCIENCE LAB,cpd11-20mn.pdf
SAND-MC01,Rehabilitation and Improvements due to Hurricane Sandy,042,CITY UNIVERSITY,MISCELLANEOUS RECONSTRUCTION,100,MANHATTAN,HN-0206,2173,0,0,110,0,0,0,0,110,0,0,110,0,0,0,0,110,0,0,220,0,0,0,0,220,PROJECT DELAYED DUE TO CHANGES IN SCOPE/DESIGN,,RESTORATION AND IMPROVEMENTS OF CAPITAL FACILITIES,cpd11-20mn.pdf
SJ049-015,School of Journalism - Space Upgrades,042,CITY UNIVERSITY,MISCELLANEOUS RECONSTRUCTION,100,MANHATTAN,HN-D300,250,0,0,0,0,250,0,0,250,0,0,0,0,250,0,0,250,0,0,0,0,500,0,0,500,PROJECT DELAYED DUE TO CHANGES IN SCOPE/DESIGN,,SPACE UPGRADES,cpd11-20mn.pdf
PO79 PAL,POLICE ATHLETIC LEAGUE MASONRY,056,POLICE DEPARTMENT,POLICE FACILITIES,102,MANHATTAN,PO-0079,300,144,527,2771,2000,0,0,0,5442,144,527,2771,2000,0,0,0,5442,288,1054,5542,4000,0,0,0,10884,PROJECT DELAYED DUE TO BUDGETARY CONSTRAINTS,"24 1/2 EAST 12TH STREET, NY",TO PROVIDE FOR THE FACADE RE POINTING,cpd11-20mn.pdf
PO79137CS,137 centre street renovation,056,POLICE DEPARTMENT,POLICE FACILITIES,100,MANHATTAN,PO-0079,0,0,2025,8000,8558,0,0,0,18583,0,2025,8000,8558,0,0,0,18583,0,4050,16000,17116,0,0,0,37166,,,137 CENTRE STREET RENOVATION,cpd11-20mn.pdf
PO791PPDR,One Police Plaza Doors,056,POLICE DEPARTMENT,POLICE FACILITIES,100,MANHATTAN,PO-0079,1018,0,0,0,0,0,1018,0,1018,0,0,0,0,0,1018,0,1018,0,0,0,0,0,2036,0,2036,PROJECT DELAYED DUE TO UNFORESEEN SITE/FIELD CONDITION,,ONE POLICE PLAZA DOORS,cpd11-20mn.pdf
PO791PPF,Emergency RECONSTRUCTION OF 1 POLICE PLAZA,056,POLICE DEPARTMENT,POLICE FACILITIES,100,MANHATTAN,PO-0079,0,0,17763,0,0,0,0,0,17763,0,17763,0,0,0,0,0,17763,0,35526,0,0,0,0,0,35526,,,EMERGENCY RECONSTRUCTION OF 1 POLICE PLAZA,cpd11-20mn.pdf
PO791PPR2,ONE POLICE PLAZA & POLICE LAB ROOFS,056,POLICE DEPARTMENT,POLICE FACILITIES,100,MANHATTAN,PO-0079,9964,6111,1253,0,0,2600,0,0,9964,6111,1253,0,0,2600,0,0,9964,12222,2506,0,0,5200,0,0,19928,,,RECONSTRUCTION,cpd11-20mn.pdf
PO79BMAHO,"HVAC REPLACEMENT FOR 20TH, 24TH AND 25TH PCTS",056,POLICE DEPARTMENT,POLICE FACILITIES,100 107 111,MANHATTAN,PO-0079,2024,2422,236,0,0,0,0,0,2658,2422,236,0,0,0,0,0,2658,4844,472,0,0,0,0,0,5316,PROJECT DELAYED DUE TO CHANGES IN SCOPE/DESIGN,,HVAC SYSTEMS,cpd11-20mn.pdf
PO79BMAIZ,24th Precinct Facade,056,POLICE DEPARTMENT,POLICE FACILITIES,100,MANHATTAN,PO-0079,715,0,100,0,983,0,0,0,1083,0,100,0,983,0,0,0,1083,0,200,0,1966,0,0,0,2166,PROJECT DELAYED DUE TO UNFORESEEN SITE/FIELD CONDITION,,TO PROVIDE FOR THE FACADE REHABILITATION OF THE 24TH PCT,cpd11-20mn.pdf
PO79BMAJF,32ND PCT PARKING LOT,056,POLICE DEPARTMENT,POLICE FACILITIES,100,MANHATTAN,PO-0079,67,110,511,0,0,0,0,0,621,110,511,0,0,0,0,0,621,220,1022,0,0,0,0,0,1242,PROJECT DELAYED DUE TO UNFORESEEN SITE/FIELD CONDITION,,PARKING LOT REHABILITATION,cpd11-20mn.pdf
PO79BMAJQ,1 Police Plaza Auditorium,056,POLICE DEPARTMENT,POLICE FACILITIES,100,MANHATTAN,PO-0079,8661,0,3661,0,5000,0,0,0,8661,0,3661,0,5000,0,0,0,8661,0,7322,0,10000,0,0,0,17322,PROJECT DELAYED DUE TO CHANGES IN SCOPE/DESIGN,,ONE POLICE PLAZA AUDITOIUM,cpd11-20mn.pdf
PO79BMAKC,ELEVATOR REHABILITATION FOR MIDTOWN NORTH PCT,056,POLICE DEPARTMENT,POLICE FACILITIES,100,MANHATTAN,PO-0079,842,0,1500,0,0,0,0,0,1500,0,1500,0,0,0,0,0,1500,0,3000,0,0,0,0,0,3000,,,ESTIMATE,cpd11-20mn.pdf
PO79BMAKP,1PP STORM DRAIN,056,POLICE DEPARTMENT,POLICE FACILITIES,100,MANHATTAN,PO-0079,200,0,200,0,0,0,0,0,200,0,200,0,0,0,0,0,200,0,400,0,0,0,0,0,400,,,ESTIMATE,cpd11-20mn.pdf
PO79BMAKX,IAB HVAC REPLACEMENT,056,POLICE DEPARTMENT,POLICE FACILITIES,100,MANHATTAN,PO-0079,680,0,0,680,0,0,0,0,680,0,0,680,0,0,0,0,680,0,0,1360,0,0,0,0,1360,,,ESTIMATE,cpd11-20mn.pdf
PO79BMAKY,1PP SUMP PUMP,056,POLICE DEPARTMENT,POLICE FACILITIES,100,MANHATTAN,PO-0079,125,0,125,0,0,0,0,0,125,0,125,0,0,0,0,0,125,0,250,0,0,0,0,0,250,,,ESTIMATE,cpd11-20mn.pdf
PO79BMALA,5TH PRECINCT CONSTRUCTION RENOVATION,056,POLICE DEPARTMENT,POLICE FACILITIES,100,MANHATTAN,PO-0079,0,0,200,0,1333,0,0,0,1533,0,200,0,1333,0,0,0,1533,0,400,0,2666,0,0,0,3066,,,SCOPE DESCRIPTION,cpd11-20mn.pdf
PO79-BMS,BMS PROJECTS,056,POLICE DEPARTMENT,POLICE FACILITIES,100,MANHATTAN,PO-0079,121310,0,3837,5155,0,0,17455,83047,109494,0,3837,5155,0,0,17455,83047,109494,0,7674,10310,0,0,34910,166094,218988,PROJECT DELAYED DUE TO CHANGES IN SCOPE/DESIGN,NA,LUMP SUM,cpd11-20mn.pdf
PO79BMUPS,ONE POLICE PLAZA UPS,056,POLICE DEPARTMENT,POLICE FACILITIES,100,MANHATTAN,PO-0079,30950,0,32755,0,0,0,0,0,32755,0,32755,0,0,0,0,0,32755,0,65510,0,0,0,0,0,65510,,,RECONSTRUCTION,cpd11-20mn.pdf
PO79CAFE,RENOVATION AND UPGRADE OF ONE POLICE PLAZA CAFETERIA,056,POLICE DEPARTMENT,POLICE FACILITIES,100,MANHATTAN,PO-0079,1081,0,1350,0,0,0,0,0,1350,0,1350,0,0,0,0,0,1350,0,2700,0,0,0,0,0,2700,,,ESTIMATE,cpd11-20mn.pdf
PO79-FMS,FMS PROJECTS,056,POLICE DEPARTMENT,POLICE FACILITIES,100,MANHATTAN,PO-0079,375,0,3142,0,0,0,0,0,3142,0,3142,0,0,0,0,0,3142,0,6284,0,0,0,0,0,6284,,,LUMP SUM,cpd11-20mn.pdf
PO79P76FR,PIER 76 PIER RELOCATION,056,POLICE DEPARTMENT,POLICE FACILITIES,101,MANHATTAN,PO-0079,0,0,0,8555,0,0,0,0,8555,0,0,8555,0,0,0,0,8555,0,0,17110,0,0,0,0,17110,,,TO PROVIDE FOR LABOR AND MATERIALS REQUIRED FOR FLEET SERVICES RELOCATION FROM PIER 76,cpd11-20mn.pdf
PO79PA13,RENOVATION OF OLD POLICE ACADEMY/13TH PCT,056,POLICE DEPARTMENT,POLICE FACILITIES,100,MANHATTAN,PO-0079,20000,379,11625,2800,1000,1000,0,0,16804,379,11625,2800,1000,1000,0,0,16804,758,23250,5600,2000,2000,0,0,33608,PROJECT DELAYED DUE TO UNFORESEEN SITE/FIELD CONDITION,,PA RENOVATION,cpd11-20mn.pdf
PO79PAAUD,OLD POLICE ACADEMY AUDITORIUM RENOVATION,056,POLICE DEPARTMENT,POLICE FACILITIES,100,MANHATTAN,PO-0079,1430,3724,415,0,0,0,0,0,4139,3724,415,0,0,0,0,0,4139,7448,830,0,0,0,0,0,8278,PROJECT DELAYED DUE TO UNFORESEEN SITE/FIELD CONDITION,OLD POLICE ACADEMY AUDITORIUM RENOVATION,OLD POLICE ACADEMY AUDITORIUM RENOVATION,cpd11-20mn.pdf
PO79PCEL,REHABILITATION OF PC ELEVATOR AT 1PP,056,POLICE DEPARTMENT,POLICE FACILITIES,100,MANHATTAN,PO-0079,730,0,11695,0,0,0,0,0,11695,0,11695,0,0,0,0,0,11695,0,23390,0,0,0,0,0,23390,,,ESTIMATE,cpd11-20mn.pdf
PO79SCIF,UPGRADE OF SCIF AC UNIT AT ONE POLICE PLAZA,056,POLICE DEPARTMENT,POLICE FACILITIES,100,MANHATTAN,PO-0079,250,0,335,0,0,0,0,0,335,0,335,0,0,0,0,0,335,0,670,0,0,0,0,0,670,,,ESTIMATE,cpd11-20mn.pdf
SANDCD6,HARBOR LAUNCH RANDALL'S ISLAND ELECTRICAL,056,POLICE DEPARTMENT,POLICE FACILITIES,100,MANHATTAN,PO-0079,713,10,62,0,0,0,0,0,72,10,62,0,0,0,0,0,72,20,124,0,0,0,0,0,144,PROJECT DELAYED DUE TO UNFORESEEN SITE/FIELD CONDITION,RANDALL'S ISLND,ELECTRICAL REHABILITATION,cpd11-20mn.pdf
SANDCD7,POLICE SERVICE AREA 4 (PSA4),056,POLICE DEPARTMENT,POLICE FACILITIES,100,MANHATTAN,PO-0079,2192,10,210,0,0,0,0,0,220,10,210,0,0,0,0,0,220,20,420,0,0,0,0,0,440,PROJECT DELAYED DUE TO UNFORESEEN SITE/FIELD CONDITION,,ELECTRICAL REHABILITATION,cpd11-20mn.pdf
ACEFDN803,FDNY - Solar photo-voltaic system at SOC,057,FIRE DEPARTMENT,"BUILDING CONSTRUCTION, RECONSTRUCTION OR RETROFIT",101,MANHATTAN,PU-0025,142,38,0,103,0,0,0,0,141,38,0,103,0,0,0,0,141,76,0,206,0,0,0,0,282,,,"SOLAR PHOTO-VOLTAIC SYSTEM AT SOC TACTICAL UNIT FACILITY, ROOSEVELT ISLAND MANHATTAN",cpd11-20mn.pdf
ACEFDN901,FDNY- Solar PV at FDNY Academy Building 12,057,FIRE DEPARTMENT,"BUILDING CONSTRUCTION, RECONSTRUCTION OR RETROFIT",101,MANHATTAN,PU-0025,968,46,0,822,0,0,0,0,868,46,0,822,0,0,0,0,868,92,0,1644,0,0,0,0,1736,,,"BLDG 12, FDNY ACADEMY RANDALLS ISLAND",cpd11-20mn.pdf
F175KTE22,KITCHENT RENOVATION - EC22,057,FIRE DEPARTMENT,NEW FACILITIES AND RENOVATIONS,108,MANHATTAN,F-0175,1734,234,0,0,1500,0,0,0,1734,234,0,0,1500,0,0,0,1734,468,0,0,3000,0,0,0,3468,PROJECT DELAYED DUE TO BUDGETARY CONSTRAINTS,,KITCHENT RENOVATION - EC22,cpd11-20mn.pdf
F175MCE33,Multi-Component Renovations - EC33,057,FIRE DEPARTMENT,NEW FACILITIES AND RENOVATIONS,102,MANHATTAN,F-0175,961,638,0,35,5200,0,0,0,5873,638,0,35,5200,0,0,0,5873,1276,0,70,10400,0,0,0,11746,PROJECT DELAYED DUE TO BUDGETARY CONSTRAINTS,,HVAC AND INTERIORS - EC33,cpd11-20mn.pdf
F175MCE74,Multi-Component Renovations - EC74,057,FIRE DEPARTMENT,NEW FACILITIES AND RENOVATIONS,107,MANHATTAN,F-0175,4452,557,0,4149,0,0,0,0,4706,557,0,4149,0,0,0,0,4706,1114,0,8298,0,0,0,0,9412,PROJECT DELAYED DUE TO BUDGETARY CONSTRAINTS,,"FLOOR, KITCHEN & TOILETS L-OHD GENERATOR - EC74",cpd11-20mn.pdf
F175MCE91,Multi-Component Renovations - EC91,057,FIRE DEPARTMENT,NEW FACILITIES AND RENOVATIONS,111,MANHATTAN,F-0175,14116,1151,0,0,0,96,13000,0,14247,1151,0,0,0,96,13000,0,14247,2302,0,0,0,192,26000,0,28494,PROJECT DELAYED DUE TO BUDGETARY CONSTRAINTS,,MULTI-COMPONENT RENOVATIONS - EC91,cpd11-20mn.pdf
F175MCL20,FIREHOUSE RENOVATIONS - LC20,057,FIRE DEPARTMENT,NEW FACILITIES AND RENOVATIONS,102,MANHATTAN,F-0175,2200,1208,0,0,0,6,8520,0,9734,1208,0,0,0,6,8520,0,9734,2416,0,0,0,12,17040,0,19468,PROJECT DELAYED DUE TO BUDGETARY CONSTRAINTS,,FIREHOUSE RENOVATIONS - LC20,cpd11-20mn.pdf
F175RFE54,ROOF AND WATERPROOFING - EC54,057,FIRE DEPARTMENT,NEW FACILITIES AND RENOVATIONS,105,MANHATTAN,F-0175,3638,437,0,0,3200,0,0,0,3637,437,0,0,3200,0,0,0,3637,874,0,0,6400,0,0,0,7274,,,ROOF AND WATERPROOFING - EC54,cpd11-20mn.pdf
FD175DE95,Door Replacement - EC95,057,FIRE DEPARTMENT,NEW FACILITIES AND RENOVATIONS,112,MANHATTAN,F-D175,75,0,75,0,0,0,0,0,75,0,75,0,0,0,0,0,75,0,150,0,0,0,0,0,150,PROJECT DELAYED DUE TO BUDGETARY CONSTRAINTS,,DOOR REPLACEMENT - EC95,cpd11-20mn.pdf
FD175GE95,Generator - EC95,057,FIRE DEPARTMENT,NEW FACILITIES AND RENOVATIONS,112,MANHATTAN,F-D175 F-0175,575,91,483,0,0,0,0,0,574,91,483,0,0,0,0,0,574,182,966,0,0,0,0,0,1148,PROJECT DELAYED DUE TO BUDGETARY CONSTRAINTS,,GENERATOR - EC95,cpd11-20mn.pdf
FD175WN22,Windown Replacement - EC22,057,FIRE DEPARTMENT,NEW FACILITIES AND RENOVATIONS,108,MANHATTAN,F-D175 F-0175,587,102,485,0,0,0,0,0,587,102,485,0,0,0,0,0,587,204,970,0,0,0,0,0,1174,PROJECT DELAYED DUE TO BUDGETARY CONSTRAINTS,,WINDOW REPLACEMENT - EC22,cpd11-20mn.pdf
FD175WN28,Window Replacement - EC28,057,FIRE DEPARTMENT,NEW FACILITIES AND RENOVATIONS,103,MANHATTAN,F-D175 F-0175,511,124,409,0,0,0,0,0,533,124,409,0,0,0,0,0,533,248,818,0,0,0,0,0,1066,,,WINDOW REPLACEMENT - EC28,cpd11-20mn.pdf
FD175WN74,Window Replacement - EC74,057,FIRE DEPARTMENT,NEW FACILITIES AND RENOVATIONS,107,MANHATTAN,F-D175 F-0175,500,237,578,0,0,0,0,0,815,237,578,0,0,0,0,0,815,474,1156,0,0,0,0,0,1630,,,WINDOW REPLACEMENT - EC74,cpd11-20mn.pdf
CAPC,CHINESE AMERICAN PLANNING COUNCIL,068,ADMIN FOR CHILDREN'S SERVICES,CHILD WELFARE FACILITIES,100 103,MANHATTAN,CS-D002,100,0,0,0,100,0,0,0,100,0,0,0,100,0,0,0,100,0,0,0,200,0,0,0,200,PROJECT DELAYED PENDING RESOLUTION OF LEGAL ISSUES,,CONST.,cpd11-20mn.pdf
JSA61BWYY,JSA RELOCATION TO 61 BROADWAY,068,ADMIN FOR CHILDREN'S SERVICES,CHILD WELFARE FACILITIES,,MANHATTAN,CS-0003,2920,0,1200,0,0,0,0,0,1200,0,1200,0,0,0,0,0,1200,0,2400,0,0,0,0,0,2400,,,TBD,cpd11-20mn.pdf
NSCC,Children's Center High Needs Unit,068,ADMIN FOR CHILDREN'S SERVICES,CHILD WELFARE FACILITIES,,MANHATTAN,CS-0003,468,0,2073,2012,1741,0,0,0,5826,0,2073,2012,1741,0,0,0,5826,0,4146,4024,3482,0,0,0,11652,PROJECT DELAYED DUE TO CHANGES IN SCOPE/DESIGN,,CHILDREN'S CENTER HIGH NEEDS UNIT,cpd11-20mn.pdf
SYSUPGRAD,SYSTEM UPGRADES AT HORIZON AND CROSSROADS JUVENILE CENTERS,068,ADMIN FOR CHILDREN'S SERVICES,CHILD WELFARE FACILITIES,100,MANHATTAN,CS-0005,6000,0,1843,0,0,3000,3000,18260,26103,0,1843,0,0,3000,3000,18260,26103,0,3686,0,0,6000,6000,36520,52206,PROJECT DELAYED DUE TO CHANGES IN SCOPE/DESIGN,,THE HORIZON JUVENILE CENTER AND THE CROSSROADS JUVENILE CENTER ARE THE TWO SECURE,cpd11-20mn.pdf
DHS-LIGHT,DEPT OF HOMELESS SVCS,071,DEPT OF HOMELESS SERVICES,ROUTINE RECONSTRUCTION,106,MANHATTAN,HH-D025,50,0,0,50,0,0,0,0,50,0,0,50,0,0,0,0,50,0,0,100,0,0,0,0,100,,"400-430 EAST 30TH STREET, NEW YORK, NY",DEPARTMENT OF HOMELESS SERVICES,cpd11-20mn.pdf
HH112BLSB,BELLEVUE BASEMENT STRUCTURAL RECONSTRUCTION,071,DEPT OF HOMELESS SERVICES,SHELTERS FOR HOMELESS INDIVIDUALS,,MANHATTAN,HH-0112,38750,0,0,0,5813,8000,24937,0,38750,0,0,0,5813,8000,24937,0,38750,0,0,0,11626,16000,49874,0,77500,,,BELLEVUE BASEMENT STRUCTURAL RECONSTRUCTION,cpd11-20mn.pdf
HH112BLWB,BELLEVUE WEST BANK ELEVATORS,071,DEPT OF HOMELESS SERVICES,SHELTERS FOR HOMELESS INDIVIDUALS,,MANHATTAN,HH-0112,7546,0,0,0,1132,0,6414,0,7546,0,0,0,1132,0,6414,0,7546,0,0,0,2264,0,12828,0,15092,,,BELLEVUE WEST BANK ELEVATORS,cpd11-20mn.pdf
HH112ETEU,"282 East 3rd Street, 10009 - Exterior Upgrade",071,DEPT OF HOMELESS SERVICES,SHELTERS FOR HOMELESS INDIVIDUALS,103,MANHATTAN,HH-0112,2600,176,24,0,2400,0,0,0,2600,176,24,0,2400,0,0,0,2600,352,48,0,4800,0,0,0,5200,,,"8 EAST 3RD STREET, 10009 - EXTERIOR UPGRADE",cpd11-20mn.pdf
HH112FWBO,FT. WASHINGTON ARMORY - BOILER UPGRADE,071,DEPT OF HOMELESS SERVICES,SHELTERS FOR HOMELESS INDIVIDUALS,112,MANHATTAN,HH-0112,3586,3149,7341,0,0,0,0,0,10490,3149,7341,0,0,0,0,0,10490,6298,14682,0,0,0,0,0,20980,,,FT. WASHINGTON ARMORY - BOILER UPGRADE,cpd11-20mn.pdf
HH112FWFR,FORT WASHINGTON ARMORY-DORMITORIES FLOOR REPLACEMENT,071,DEPT OF HOMELESS SERVICES,SHELTERS FOR HOMELESS INDIVIDUALS,112,MANHATTAN,HH-0112,450,200,0,2500,0,0,0,0,2700,200,0,2500,0,0,0,0,2700,400,0,5000,0,0,0,0,5400,PROJECT DELAYED DUE TO CHANGES IN SCOPE/DESIGN,,FORT WASHINGTON ARMORY - DORMITORIES FLOOR REPLACEMENT,cpd11-20mn.pdf
HH112GDFC,GEORGE DALY FACADE AND WINDOWS,071,DEPT OF HOMELESS SERVICES,SHELTERS FOR HOMELESS INDIVIDUALS,103,MANHATTAN,HH-0112,2590,185,0,0,0,0,2405,0,2590,185,0,0,0,0,2405,0,2590,370,0,0,0,0,4810,0,5180,,,GEORGE DALY FACADE AND WINDOWS,cpd11-20mn.pdf
HH112HBAT,HARLEM 1 BATHROOM RECONSTRUCTION,071,DEPT OF HOMELESS SERVICES,SHELTERS FOR HOMELESS INDIVIDUALS,,MANHATTAN,HH-0112,2080,0,0,0,920,0,1000,0,1920,0,0,0,920,0,1000,0,1920,0,0,0,1840,0,2000,0,3840,,,RECONSTRUCT BATHROOMS,cpd11-20mn.pdf
HH112HHAC,HARLEM 1 ROOF AND VENTILATION SYSTEM,071,DEPT OF HOMELESS SERVICES,SHELTERS FOR HOMELESS INDIVIDUALS,,MANHATTAN,HH-0112,3360,0,0,0,0,280,0,3080,3360,0,0,0,0,280,0,3080,3360,0,0,0,0,560,0,6160,6720,,,RECONSTRUCT ROOF AND VENTILATION SYSTEMS,cpd11-20mn.pdf
HH112HINT,HARLEM 1 iNTERIOR RECONSTRUCTION,071,DEPT OF HOMELESS SERVICES,SHELTERS FOR HOMELESS INDIVIDUALS,,MANHATTAN,HH-0112,3000,0,250,0,2650,100,0,0,3000,0,250,0,2650,100,0,0,3000,0,500,0,5300,200,0,0,6000,,,RECONSTRUCT INTERIOR,cpd11-20mn.pdf
HH112HLET,HARLEM 1 ELECTRICAL UPGRADE,071,DEPT OF HOMELESS SERVICES,SHELTERS FOR HOMELESS INDIVIDUALS,,MANHATTAN,HH-0112,12000,0,1200,0,0,5000,7000,0,13200,0,1200,0,0,5000,7000,0,13200,0,2400,0,0,10000,14000,0,26400,,,ELECTRICAL UPGRADE,cpd11-20mn.pdf
HH112HMBL,HARLEM 1 BOILER REPLACEMENT,071,DEPT OF HOMELESS SERVICES,SHELTERS FOR HOMELESS INDIVIDUALS,,MANHATTAN,HH-0112,1475,125,1350,0,0,0,0,0,1475,125,1350,0,0,0,0,0,1475,250,2700,0,0,0,0,0,2950,,,HARLEM 1 BOILER REPLACEMENT,cpd11-20mn.pdf
HH112HMED,HARLEM 1 - ELECTRICAL PANEL UPGRADE,071,DEPT OF HOMELESS SERVICES,SHELTERS FOR HOMELESS INDIVIDUALS,,MANHATTAN,HH-0112,500,40,460,0,0,0,0,0,500,40,460,0,0,0,0,0,500,80,920,0,0,0,0,0,1000,,,HARLEM 1 - ELECTRICAL PANEL UPGRADE,cpd11-20mn.pdf
HH112HSCR,HELP SEC-COTTAGE ROOF REPLACEMENT,071,DEPT OF HOMELESS SERVICES,SHELTERS FOR HOMELESS INDIVIDUALS,,MANHATTAN,HH-0112,2210,170,2040,0,0,0,0,0,2210,170,2040,0,0,0,0,0,2210,340,4080,0,0,0,0,0,4420,,,HELP SEC- COTTAGE ROOF REPLACEMENT,cpd11-20mn.pdf
HH112HSMR,HELP SEC.-MIAN BLDG.ROOF REPLACEMENT,071,DEPT OF HOMELESS SERVICES,SHELTERS FOR HOMELESS INDIVIDUALS,,MANHATTAN,HH-0112,2340,180,2160,0,0,0,0,0,2340,180,2160,0,0,0,0,0,2340,360,4320,0,0,0,0,0,4680,,,HELP SEC.-MIAN BLDG. ROOF REPLACEMENT,cpd11-20mn.pdf
HH112HSSF,HELP SEC FENCE REPLACEMENT,071,DEPT OF HOMELESS SERVICES,SHELTERS FOR HOMELESS INDIVIDUALS,,MANHATTAN,HH-0112,1588,0,1588,0,0,0,0,0,1588,0,1588,0,0,0,0,0,1588,0,3176,0,0,0,0,0,3176,,,HELP SEC FENCE REPLACEMENT,cpd11-20mn.pdf
HH112KITC,PROJECT RENEWAL-EAST 3RD STREET KITCHEN NC#13-260288T82144,071,DEPT OF HOMELESS SERVICES,SHELTERS FOR HOMELESS INDIVIDUALS,,MANHATTAN,HH-D025 HH-0112,1540,62,1527,0,0,0,0,0,1589,62,1527,0,0,0,0,0,1589,124,3054,0,0,0,0,0,3178,PROJECT DELAYED DUE TO UNFORESEEN SITE/FIELD CONDITION,,PROJECT RENEWAL-EAST 3RD STREET SHELTER-KITCHEN RENOVATION,cpd11-20mn.pdf
HH112KNUG,KEENER ASSESSMENT SHELTER - BUILDING UPGRADE,071,DEPT OF HOMELESS SERVICES,SHELTERS FOR HOMELESS INDIVIDUALS,111,MANHATTAN,HH-0112,10782,0,0,0,829,0,9953,0,10782,0,0,0,829,0,9953,0,10782,0,0,0,1658,0,19906,0,21564,,,KEENER ASSESSMENT SHELTER - BUILDING UPGRADE,cpd11-20mn.pdf
HH112KTEX,KENTON HALL - FACADE RECONSTRUCTION,071,DEPT OF HOMELESS SERVICES,SHELTERS FOR HOMELESS INDIVIDUALS,103,MANHATTAN,HH-0112,456,0,0,0,0,37,0,419,456,0,0,0,0,37,0,419,456,0,0,0,0,74,0,838,912,,,KENTON HALL - FACADE RECONSTRUCTION,cpd11-20mn.pdf
HH112KTFR,FLUE REPLACEMENT AT KENTON HALL,071,DEPT OF HOMELESS SERVICES,EQUIPMENT,,MANHATTAN,HH-0112,880,0,880,0,0,0,0,0,880,0,880,0,0,0,0,0,880,0,1760,0,0,0,0,0,1760,,,,cpd11-20mn.pdf
HH112SWBU,Schwartz Homeless Shelter,071,DEPT OF HOMELESS SERVICES,SHELTERS FOR HOMELESS INDIVIDUALS,,MANHATTAN,HH-0112,1000,0,0,150,0,850,0,0,1000,0,0,150,0,850,0,0,1000,0,0,300,0,1700,0,0,2000,,,SCHWARTZ HOMELESS SHELTER - BUILDING UPGRADE,cpd11-20mn.pdf
HH112THBH,8 EAST THIRD ST BATHROOM RECONSTRUCTION,071,DEPT OF HOMELESS SERVICES,SHELTERS FOR HOMELESS INDIVIDUALS,,MANHATTAN,HH-0112,3600,0,0,0,300,0,3300,0,3600,0,0,0,300,0,3300,0,3600,0,0,0,600,0,6600,0,7200,,,BATHROOM RECON,cpd11-20mn.pdf
HH112THBR,282 EAST THIRD ST BOILER RECONSTRUCTION,071,DEPT OF HOMELESS SERVICES,SHELTERS FOR HOMELESS INDIVIDUALS,,MANHATTAN,HH-0112,1200,0,100,1100,0,0,0,0,1200,0,100,1100,0,0,0,0,1200,0,200,2200,0,0,0,0,2400,,,BOILER RECONSTRUCTION,cpd11-20mn.pdf
HH112THFC,8 EAST THIRD ST SHELTER FACADE AND STAIRS,071,DEPT OF HOMELESS SERVICES,SHELTERS FOR HOMELESS INDIVIDUALS,,MANHATTAN,HH-0112,1040,80,400,560,0,0,0,0,1040,80,400,560,0,0,0,0,1040,160,800,1120,0,0,0,0,2080,,,RECONSTRUCT FACADE AND STAIRS,cpd11-20mn.pdf
HH112THKS,8 EAST THIRD STREET KITCHEN STRUCTURE REHABILITATION,071,DEPT OF HOMELESS SERVICES,SHELTERS FOR HOMELESS INDIVIDUALS,,MANHATTAN,HH-0112,1011,0,1011,0,0,0,0,0,1011,0,1011,0,0,0,0,0,1011,0,2022,0,0,0,0,0,2022,,,KITCHEN STRUCTURE REHABILITATION,cpd11-20mn.pdf
HH115CTBU,78 CATHERINE STREET - BATHROOM UPGRADE,071,DEPT OF HOMELESS SERVICES,SHELTERS FOR HOMELESS FAMILIES,103,MANHATTAN,HH-0115,7350,5566,130,0,0,0,0,0,5696,5566,130,0,0,0,0,0,5696,11132,260,0,0,0,0,0,11392,,,DESIGN AND CONSTRUCTION SERVICES RE THE RENOVATION OF BATHROOMS AT THE CATHERINE,cpd11-20mn.pdf
HH115CTEF,CATHERINE STREET ELECTRICAL UPGRADE,071,DEPT OF HOMELESS SERVICES,SHELTERS FOR HOMELESS FAMILIES,,MANHATTAN,HH-0115,3950,300,0,1050,2600,0,0,0,3950,300,0,1050,2600,0,0,0,3950,600,0,2100,5200,0,0,0,7900,,,CATHERINE STREET ELECTRICAL AND FIRE SAFETY UPGRADE,cpd11-20mn.pdf
HH115JCFA,JENNIE CLARKE BACKFLOW PREVENTER,071,DEPT OF HOMELESS SERVICES,SHELTERS FOR HOMELESS FAMILIES,111,MANHATTAN,HH-0115,750,0,0,0,0,750,0,0,750,0,0,0,0,750,0,0,750,0,0,0,0,1500,0,0,1500,,,"179 - 191 EAST 100TH STREET - FA, PA SYS, BACKFLOW PREVENTION",cpd11-20mn.pdf
HH115REBO,REGENT BOILER,071,DEPT OF HOMELESS SERVICES,SHELTERS FOR HOMELESS FAMILIES,107,MANHATTAN,HH-0115,1950,150,0,1800,0,0,0,0,1950,150,0,1800,0,0,0,0,1950,300,0,3600,0,0,0,0,3900,,,REGENT BOILER,cpd11-20mn.pdf
HH115RECL,REGENT CEILINGS,071,DEPT OF HOMELESS SERVICES,SHELTERS FOR HOMELESS FAMILIES,107,MANHATTAN,HH-0115,4707,85,0,0,1758,0,0,0,1843,85,0,0,1758,0,0,0,1843,170,0,0,3516,0,0,0,3686,,,REGENT CEILINGS,cpd11-20mn.pdf
HH115RFRE,"REGENT FAMILY RESIDENCE LIFE SAFETY UPGRADE, FIRE SAFETY",071,DEPT OF HOMELESS SERVICES,SHELTERS FOR HOMELESS FAMILIES,107,MANHATTAN,HH-0115,2174,2651,834,0,0,0,0,0,3485,2651,834,0,0,0,0,0,3485,5302,1668,0,0,0,0,0,6970,PROJECT DELAYED DUE TO UNFORESEEN SITE/FIELD CONDITION,,ELECTRICAL UPGRADE THROUGHOUT THE BUILDING AND TO ADDRESS ANY CODE VIOLATIONS AT THE,cpd11-20mn.pdf
HH115RGST,REGENT - STAIR B,071,DEPT OF HOMELESS SERVICES,SHELTERS FOR HOMELESS FAMILIES,107,MANHATTAN,HH-0115,1000,1032,559,0,0,0,0,0,1591,1032,559,0,0,0,0,0,1591,2064,1118,0,0,0,0,0,3182,,,REGENT - STAIR B,cpd11-20mn.pdf
HHCN007,INSTALLATION OF BACKUP GENERATOR,071,DEPT OF HOMELESS SERVICES,SHELTERS FOR HOMELESS INDIVIDUALS,,MANHATTAN,HH-D025,301,0,0,301,0,0,0,0,301,0,0,301,0,0,0,0,301,0,0,602,0,0,0,0,602,,,INSTALLATION OF A BACKUP GENERATOR,cpd11-20mn.pdf
HHMNEW1,PROJECT RENEWAL - RENOVATE FT. WASH. ARMORY,071,DEPT OF HOMELESS SERVICES,SHELTERS FOR HOMELESS INDIVIDUALS,112,MANHATTAN,HH-M112,101,0,76,0,0,0,0,0,76,0,76,0,0,0,0,0,76,0,152,0,0,0,0,0,152,,,PROJECT RENEWAL - RENOVATE FT. WASH. ARMORY,cpd11-20mn.pdf
HHNC005,KITCHEN RENOVATION AT 8 EAST THIRD STREET HOMELESS SHELTER,071,DEPT OF HOMELESS SERVICES,SHELTERS FOR HOMELESS INDIVIDUALS,,MANHATTAN,HH-D025,378,0,0,0,378,0,0,0,378,0,0,0,378,0,0,0,378,0,0,0,756,0,0,0,756,,,KITCHEN RENOVATION AT 8 EAST THIRD STREET HOMELES SHELTER,cpd11-20mn.pdf
HHNC006,FORT WASHINGTON ARMORY - ENTRYWAY REPAIR,071,DEPT OF HOMELESS SERVICES,SHELTERS FOR HOMELESS INDIVIDUALS,,MANHATTAN,HH-D025,200,0,0,200,0,0,0,0,200,0,0,200,0,0,0,0,200,0,0,400,0,0,0,0,400,,,FORT WASHINGTON ARMORY - ENTRYWAY REPAIR,cpd11-20mn.pdf
HLCN014,"PROJECT RENEWAL , INC. - NEW PROVIDENCE BACKUP GENERATOR",071,DEPT OF HOMELESS SERVICES,SHELTERS FOR HOMELESS INDIVIDUALS,,MANHATTAN,HH-D112,275,0,0,275,0,0,0,0,275,0,0,275,0,0,0,0,275,0,0,550,0,0,0,0,550,,,"PROJECT RENEWAL , INC. - NEW PROVIDENCE BACKUP GENERATOR",cpd11-20mn.pdf
SOLARDHS1,Solar PV system - HELP SEC at 111 Sunken Garden Loop,071,DEPT OF HOMELESS SERVICES,MISCELLANEOUS ENERGY EFFICIENCY AND SUSTAINABILITY,101,MANHATTAN,PU-0025,2936,0,0,2711,0,0,0,0,2711,0,0,2711,0,0,0,0,2711,0,0,5422,0,0,0,0,5422,,,SOLAR PV SYSTEM - HELP SEC AT 111 SUNKEN GARDEN LOOP,cpd11-20mn.pdf
C75WTRMN,Replace Water Mains on Rikers Island,072,DEPARTMENT OF CORRECTION,BUILDING SYSTEMS AND INFRASTRUCTURE,100,MANHATTAN,C-0075,6175,410,0,500,0,0,4465,0,5375,410,0,500,0,0,4465,0,5375,820,0,1000,0,0,8930,0,10750,PROJECT DELAYED DUE TO BUDGETARY CONSTRAINTS,,REPLACE DOMESTIC WATER AND FIRE MAINS AT RIKERS ISLAND.,cpd11-20mn.pdf
HR2560LAC,60 Lafayette Street Construction,096,HUMAN RESOURCES ADMINISTRATION,SOCIAL SERVICES BUILDINGS,,MANHATTAN,HR-0025,750,0,0,255,0,0,0,0,255,0,0,255,0,0,0,0,255,0,0,510,0,0,0,0,510,,,,cpd11-20mn.pdf
HR25CHRYC,115 Chrystie Street Construction,096,HUMAN RESOURCES ADMINISTRATION,SOCIAL SERVICES BUILDINGS,,MANHATTAN,HR-0025,1701,0,0,600,1065,0,0,0,1665,0,0,600,1065,0,0,0,1665,0,0,1200,2130,0,0,0,3330,,,,cpd11-20mn.pdf
HR25E162C,109 East 16th Street Construction,096,HUMAN RESOURCES ADMINISTRATION,SOCIAL SERVICES BUILDINGS,,MANHATTAN,HR-0025,5245,0,500,2000,1007,0,0,0,3507,0,500,2000,1007,0,0,0,3507,0,1000,4000,2014,0,0,0,7014,,,,cpd11-20mn.pdf
HR25W125C,132 W 125th St Construction,096,HUMAN RESOURCES ADMINISTRATION,SOCIAL SERVICES BUILDINGS,,MANHATTAN,HR-0025,4609,0,633,0,0,0,0,0,633,0,633,0,0,0,0,0,633,0,1266,0,0,0,0,0,1266,,,,cpd11-20mn.pdf
AGCBCOV,CARTER BURDEN/LEONARD COVELLO,125,DEPARTMENT FOR THE AGING,DEPARTMENT FOR THE AGING BUILDING RECONSTRUCTION,111,MANHATTAN,AG-M001,0,0,0,98,0,0,0,0,98,0,0,98,0,0,0,0,98,0,0,196,0,0,0,0,196,,,CARTER BURDEN/LEONARD COVELLO SENIOR PROGRAM KITCHEN RELOCATION,cpd11-20mn.pdf
AGCBURDEN,LEONARD COVELLO Kitchen Renovation,125,DEPARTMENT FOR THE AGING,DEPARTMENT FOR THE AGING BUILDING RECONSTRUCTION,111,MANHATTAN,AG-D001,0,0,0,400,0,0,0,0,400,0,0,400,0,0,0,0,400,0,0,800,0,0,0,0,800,,,SEPT 17 PLAN 400K FOR KITCHEN RENOVATION,cpd11-20mn.pdf
AGHAMADA,"SERVICES NOW FOR ADULT PERSONS, INC.-SNAP VANS WHEELCHAIR LI",125,DEPARTMENT FOR THE AGING,DEPARTMENT FOR THE AGING BUILDING RECONSTRUCTION,109,MANHATTAN,AG-D001,0,0,0,489,0,0,0,0,489,0,0,489,0,0,0,0,489,0,0,978,0,0,0,0,978,,,HAMILTON-MADISON HOUSE INC COMMUNITY CENTER,cpd11-20mn.pdf
AGHAMADA2,"SERVICES NOW FOR ADULT PERSONS, INC.-SNAP VANS WHEELCHAIR LI",125,DEPARTMENT FOR THE AGING,DEPARTMENT FOR THE AGING BUILDING RECONSTRUCTION,109,MANHATTAN,AG-D001,0,0,0,1662,0,0,0,0,1662,0,0,1662,0,0,0,0,1662,0,0,3324,0,0,0,0,3324,,,HAMILTON-MADISON HOUSE INC COMMUNITY CENTER,cpd11-20mn.pdf
HAM14CRSR,CARVER HOUSES SENIOR CENTER COMPUTER LAB,125,DEPARTMENT FOR THE AGING,DEPARTMENT FOR THE AGING BUILDING RECONSTRUCTION,111,MANHATTAN,AG-D001,0,0,0,0,100,0,0,0,100,0,0,0,100,0,0,0,100,0,0,0,200,0,0,0,200,,,INSTALL A COMPUTER LAB AT THE SENIOR CENTER,cpd11-20mn.pdf
ACEDCA434,DCLA,126,DEPARTMENT OF CULTURAL AFFAIRS,"BUILDING CONSTRUCTION, RECONSTRUCTION OR RETROFIT",107,MANHATTAN,PU-0025,583,0,0,710,0,0,0,0,710,0,0,710,0,0,0,0,710,0,0,1420,0,0,0,0,1420,PROJECT DELAYED DUE TO CHANGES IN SCOPE/DESIGN,,REMOVAL AND REPLACEMENT OF LIGHTING CONTROLS SYSTEMS IN PUBLIC SPACESFOR 10 EXHIBIT,cpd11-20mn.pdf
PV022ANEG,MMA -Ancient Near East Gallery Renovation,126,DEPARTMENT OF CULTURAL AFFAIRS,ESSENTIAL RECONSTRUCTION OF FACILITIES,,MANHATTAN,PV-D022 PV-M022,75,0,0,0,0,3585,75,0,3660,0,0,0,0,3585,75,0,3660,0,0,0,0,7170,150,0,7320,,,MMA -ANCIENT NEAR EAST GALLERY RENOVATION,cpd11-20mn.pdf
PV022-SKY,"MMA - Metropolitan Museum Skylight Replacement for A, B, C W",126,DEPARTMENT OF CULTURAL AFFAIRS,ESSENTIAL RECONSTRUCTION OF FACILITIES,108,MANHATTAN,PV-M022 PV-0022 PV-D022 PV-0467,19738,0,0,0,0,31638,0,0,31638,0,0,0,0,31638,0,0,31638,0,0,0,0,63276,0,0,63276,,,METROPOLITAN MUSEUM OF ART,cpd11-20mn.pdf
PV034ELEV,AMNH - Elevator Upgrade,126,DEPARTMENT OF CULTURAL AFFAIRS,ESSENTIAL RECONSTRUCTION OF FACILITIES,,MANHATTAN,PV-M034 PV-D034 PV-0034,100,0,0,3475,0,0,0,0,3475,0,0,3475,0,0,0,0,3475,0,0,6950,0,0,0,0,6950,,,AMNH - ELEVATOR UPGRADE,cpd11-20mn.pdf
PV034-INF,AMNH - Security & Infrastructure Upgrade,126,DEPARTMENT OF CULTURAL AFFAIRS,ESSENTIAL RECONSTRUCTION OF FACILITIES,107,MANHATTAN,PV-M034 PV-0034 PV-D034,1803,0,0,3206,0,0,0,0,3206,0,0,3206,0,0,0,0,3206,0,0,6412,0,0,0,0,6412,PROJECT DELAYED DUE TO BUDGETARY CONSTRAINTS,"CENTRAL PARK WEST AT 79TH STREET, NEW YORK, NY",SECURITY AND INFRASTRUCTURE UPGRADE,cpd11-20mn.pdf
PV101-EDU,MJH - Museum Education Wing,126,DEPARTMENT OF CULTURAL AFFAIRS,ESSENTIAL RECONSTRUCTION OF FACILITIES,,MANHATTAN,PV-D101,0,0,0,0,0,1050,0,0,1050,0,0,0,0,1050,0,0,1050,0,0,0,0,2100,0,0,2100,,,BUILDING RENOVATION,cpd11-20mn.pdf
PV101HVAC,MJH - Museum HVAC,126,DEPARTMENT OF CULTURAL AFFAIRS,ESSENTIAL RECONSTRUCTION OF FACILITIES,,MANHATTAN,PV-D101 PV-M101 PV-0101,1150,0,0,0,0,7005,503,0,7508,0,0,0,0,7005,503,0,7508,0,0,0,0,14010,1006,0,15016,,,MJH - MUSEUM HVAC,cpd11-20mn.pdf
PV219-HLD,MCC - Fresh Air Intake,126,DEPARTMENT OF CULTURAL AFFAIRS,ESSENTIAL RECONSTRUCTION OF FACILITIES,104,MANHATTAN,PV-0467,0,0,0,0,0,550,0,0,550,0,0,0,0,550,0,0,550,0,0,0,0,1100,0,0,1100,,,ADDED FRESH AIR INTAKE TAS NEEDED FOR ONGOING RENOVATION,cpd11-20mn.pdf
PV241BOIL,MCNY - Boiler Replacement,126,DEPARTMENT OF CULTURAL AFFAIRS,ESSENTIAL RECONSTRUCTION OF FACILITIES,111,MANHATTAN,PV-D241 PV-0241 PV-0467,1512,0,0,1944,0,0,0,0,1944,0,0,1944,0,0,0,0,1944,0,0,3888,0,0,0,0,3888,PROJECT DELAYED DUE TO BUDGETARY CONSTRAINTS,"1220 5TH AVE, MANHATTAN NY",BOILER SYSTEM REPLACEMENT.,cpd11-20mn.pdf
PV241-STL,MCNY -South Terrace Lighting,126,DEPARTMENT OF CULTURAL AFFAIRS,ESSENTIAL RECONSTRUCTION OF FACILITIES,,MANHATTAN,PV-M241 PV-D241,100,0,312,0,0,0,0,0,312,0,312,0,0,0,0,0,312,0,624,0,0,0,0,0,624,,,MCNY -SOUTH TERRACE LIGHTING,cpd11-20mn.pdf
PV279ACON,NYCC - NY City Center Chiller Replacement,126,DEPARTMENT OF CULTURAL AFFAIRS,ESSENTIAL RECONSTRUCTION OF FACILITIES,,MANHATTAN,PV-D279 PV-M279,650,0,0,0,0,610,280,0,890,0,0,0,0,610,280,0,890,0,0,0,0,1220,560,0,1780,,,NYCC - NY CITY CENTER CHILLER REPLACEMENT,cpd11-20mn.pdf
PV279ELEV,NYCC - New York City Center Materials Elevator,126,DEPARTMENT OF CULTURAL AFFAIRS,ESSENTIAL RECONSTRUCTION OF FACILITIES,,MANHATTAN,PV-D279 PV-M279 PV-0279,761,0,0,0,0,192,485,0,677,0,0,0,0,192,485,0,677,0,0,0,0,384,970,0,1354,,,ELEVATOR,cpd11-20mn.pdf
PV289-DEL,NYSF - DELACORTE Theater Renovation,126,DEPARTMENT OF CULTURAL AFFAIRS,ESSENTIAL RECONSTRUCTION OF FACILITIES,107,MANHATTAN,PV-D289 PV-M289 PV-0289,9900,0,0,0,0,14150,13551,0,27701,0,0,0,0,14150,13551,0,27701,0,0,0,0,28300,27102,0,55402,,,NYSF - DELCORTE THEATER RENOVATION,cpd11-20mn.pdf
PV467PCTS,DCA PFA - Percent for Art Conservation of Public Art,126,DEPARTMENT OF CULTURAL AFFAIRS,ESSENTIAL RECONSTRUCTION OF FACILITIES,101 102,MANHATTAN,PV-0467,1992,0,0,0,0,0,992,1000,1992,0,0,0,0,0,992,1000,1992,0,0,0,0,0,1984,2000,3984,,,CONSERVATION,cpd11-20mn.pdf
PV475ROOF,NYST - NYC Ballet Roof Replacement,126,DEPARTMENT OF CULTURAL AFFAIRS,ESSENTIAL RECONSTRUCTION OF FACILITIES,,MANHATTAN,PU-0025 PV-0475 PV-M475 PV-D475,4178,0,0,1212,3714,0,0,0,4926,0,0,1212,3714,0,0,0,4926,0,0,2424,7428,0,0,0,9852,PROJECT DELAYED DUE TO CHANGES IN SCOPE/DESIGN,,DAVID H. KOCH THEATER ROOF REPLACEMENT,cpd11-20mn.pdf
PV489FTA,LCPA - FTA,126,DEPARTMENT OF CULTURAL AFFAIRS,ESSENTIAL RECONSTRUCTION OF FACILITIES,107,MANHATTAN,PV-0544,119,0,0,0,0,0,0,0,0,0,0,0,0,0,0,0,0,0,0,0,0,0,0,0,0,PROJECT DELAYED DUE TO BUDGETARY CONSTRAINTS,,RENOVATION OF FACITLITY AT1680 LEXINGTON AVENUE,cpd11-20mn.pdf
PV503ELEV,CH- Carnegie Hall Elevators,126,DEPARTMENT OF CULTURAL AFFAIRS,ESSENTIAL RECONSTRUCTION OF FACILITIES,105,MANHATTAN,PV-M503 PV-0503 PV-D503,2760,0,0,0,0,2735,0,0,2735,0,0,0,0,2735,0,0,2735,0,0,0,0,5470,0,0,5470,PROJECT DELAYED DUE TO CHANGES IN SCOPE/DESIGN,,CH- CARNEGIE HALL ELEVATORS AND SIDEWALK. FY19 EXEC SECTION 211 ADD,cpd11-20mn.pdf
PV503SDWK,CH - Carnegie Sidewalk Restoration,126,DEPARTMENT OF CULTURAL AFFAIRS,ESSENTIAL RECONSTRUCTION OF FACILITIES,,MANHATTAN,PV-M503 PV-0503 PV-D503,2025,0,0,3991,0,0,0,0,3991,0,0,3991,0,0,0,0,3991,0,0,7982,0,0,0,0,7982,,,CH - CARNEGIE SIDEWALK RESTORATION,cpd11-20mn.pdf
PV788-FAC,122C - 122 CC Facade Reconstruction,126,DEPARTMENT OF CULTURAL AFFAIRS,ESSENTIAL RECONSTRUCTION OF FACILITIES,,MANHATTAN,PV-0788 PV-D788,5650,0,538,0,4484,0,0,0,5022,0,538,0,4484,0,0,0,5022,0,1076,0,8968,0,0,0,10044,,,CONSTRUCTION,cpd11-20mn.pdf
PV788-TER,122C - 122 Community Center Roof Terrace,126,DEPARTMENT OF CULTURAL AFFAIRS,ESSENTIAL RECONSTRUCTION OF FACILITIES,,MANHATTAN,PV-M788 PV-D788 PV-0788,168,0,0,0,0,168,0,0,168,0,0,0,0,168,0,0,168,0,0,0,0,336,0,0,336,,,122 COMMUNITY CENTER ROOF TERRACE CONSTRUCTION,cpd11-20mn.pdf
125THPDIM,125th St & Park Ave - Pedestrian Improvements,801,DEPT OF SMALL BUSINESS SERVICES,MISCELLANEOUS,100,MANHATTAN,ED-D075 ED-0075 HW-0001M,1000,1581,754,0,0,0,0,0,2335,1581,754,0,0,0,0,0,2335,3162,1508,0,0,0,0,0,4670,PROJECT DELAYED DUE TO CHANGES IN SCOPE/DESIGN,,125TH & PARK AVE - EDC PUBLIC REALM PROJECT -- PEDESTRIAN IMPROVEMENTS ON 125TH STREET,cpd11-20mn.pdf
1680LEXSP,1680 Lexington Sound Proofing,801,DEPT OF SMALL BUSINESS SERVICES,MISCELLANEOUS,100,MANHATTAN,ED-D075,450,369,0,0,0,0,69,0,438,369,0,0,0,0,69,0,438,738,0,0,0,0,138,0,876,PROJECT DELAYED DUE TO CHANGES IN SCOPE/DESIGN,,1680 LEXINGTON SOUND PROOFING,cpd11-20mn.pdf
34STHELI,E. 34th Street Heliport Rehabilitation,801,DEPT OF SMALL BUSINESS SERVICES,MISCELLANEOUS,101 106 108,MANHATTAN,ED-0409,1900,5555,112,0,0,0,293,0,5960,5555,112,0,0,0,293,0,5960,11110,224,0,0,0,586,0,11920,PROJECT DELAYED DUE TO CHANGES IN SCOPE/DESIGN,,REHABILITATION OF SUB-STRUCTURE,cpd11-20mn.pdf
68201101,RENOVATION AND CONSTRUCTION OF NEW GOLDWATER NORTH LTACH,801,DEPT OF SMALL BUSINESS SERVICES,MAJOR OR PARTIAL HOSPITAL RECONSTRUCTION,100 108,MANHATTAN,ED-0075,144661,122397,0,0,0,0,0,535,122932,122397,0,0,0,0,0,535,122932,244794,0,0,0,0,0,1070,245864,PROJECT DELAYED DUE TO CHANGES IN SCOPE/DESIGN,,RENOVATE THE INTERIOR SPACE FOR A NEW LTACH AT THE FORMER NORTH GENERAL HOSPITAL,cpd11-20mn.pdf
68201102,CONSTRUCTION OF NEW GOLDWATER NORTH SNF,801,DEPT OF SMALL BUSINESS SERVICES,MAJOR OR PARTIAL HOSPITAL RECONSTRUCTION,100 108,MANHATTAN,ED-0075,118951,127685,0,0,0,0,0,178,127863,127685,0,0,0,0,0,178,127863,255370,0,0,0,0,0,356,255726,PROJECT DELAYED DUE TO CHANGES IN SCOPE/DESIGN,,"THE EXISTING GOLDWATER HOSPITAL CAMPUS, LOCATED ON ROOSEVELT ISLAND, REQUIRES",cpd11-20mn.pdf
8890PHA3,Piers 88 & 90 Cluster Encapsulation Project Phase 3,801,DEPT OF SMALL BUSINESS SERVICES,MISCELLANEOUS,100,MANHATTAN,ED-0409,10000,7105,693,579,1621,0,0,0,9998,7105,693,579,1621,0,0,0,9998,14210,1386,1158,3242,0,0,0,19996,PROJECT DELAYED DUE TO CHANGES IN SCOPE/DESIGN,,PIERS 88 & 90 CLUSTER ENCAPSULATION PROJECT PHASE 3,cpd11-20mn.pdf
8THSTPAVE,8th St Bluestone Pavement Replacement,801,DEPT OF SMALL BUSINESS SERVICES,NEIGHBORHOOD REVITALIZATION,100 102,MANHATTAN,ED-D384,50,0,0,0,0,0,0,50,50,0,0,0,0,0,0,50,50,0,0,0,0,0,0,100,100,PROJECT DELAYED DUE TO CHANGES IN SCOPE/DESIGN,,8TH ST. BLUESTONE PAVEMENT REPLACEMENT,cpd11-20mn.pdf
8THSTREET,FA - Village Alliance - Reconstruction of St. & Sidewalks,801,DEPT OF SMALL BUSINESS SERVICES,COMMERCIAL DEVELOPMENT,102,MANHATTAN,ED-0075,1001,200,0,0,0,0,0,0,200,200,0,0,0,0,0,0,200,400,0,0,0,0,0,0,400,PROJECT DELAYED DUE TO CHANGES IN SCOPE/DESIGN,MANHATTAN,VILLAGE ALLIANCE - RECONSTRUCTION OF STREET AND SIDEWALKS,cpd11-20mn.pdf
AHGREEN,Andrew Haswell Green Park - Phase 2B,801,DEPT OF SMALL BUSINESS SERVICES,MISCELLANEOUS,100,MANHATTAN,P-1018 P-0245M ED-0075 ED-0409,25603,0,3380,4620,0,0,0,0,8000,0,3380,4620,0,0,0,0,8000,0,6760,9240,0,0,0,0,16000,PROJECT DELAYED DUE TO CHANGES IN SCOPE/DESIGN,,ANDREW HASWELL GREEN PARK - PHASE 2B,cpd11-20mn.pdf
AMSTCORNR,LPCA Redevelopment Final Phase -Amsterdam Corner,801,DEPT OF SMALL BUSINESS SERVICES,ESSENTIAL RECONSTRUCTION OF FACILITIES,100,MANHATTAN,PV-0489 PV-M489 PV-D489,8398,0,0,8398,0,0,0,0,8398,0,0,8398,0,0,0,0,8398,0,0,16796,0,0,0,0,16796,,,LPCA REDEVELOPMENT FINAL PHASE -AMSTERDAM CORNER,cpd11-20mn.pdf
C5232,34th Street Ferry Landing,801,DEPT OF SMALL BUSINESS SERVICES,RECONSTRUCTION OF FERRY TERMINAL FACILITIES,101 106 108,MANHATTAN,FA-0027,22719,886,26,0,0,0,0,0,912,886,26,0,0,0,0,0,912,1772,52,0,0,0,0,0,1824,PROJECT DELAYED DUE TO CHANGES IN SCOPE/DESIGN,,,cpd11-20mn.pdf
CMPRENO,Chinatown Manpower Project - 4th Floor Renovation,801,DEPT OF SMALL BUSINESS SERVICES,MISCELLANEOUS CONSTRUCTION,100 103,MANHATTAN,ED-D075 PW-M077,546,0,0,0,546,0,0,0,546,0,0,0,546,0,0,0,546,0,0,0,1092,0,0,0,1092,PROJECT DELAYED DUE TO CHANGES IN SCOPE/DESIGN,,CHINATOWN MANPOWER PROJECT - 4TH FLOOR RENOVATION,cpd11-20mn.pdf
CWFSFERY2,New York City Ferry - Infrastructure,801,DEPT OF SMALL BUSINESS SERVICES,WATERFRONT DEVELOPMENT,100,MANHATTAN,ED-0409,84400,144029,15400,45851,0,0,0,40000,245280,144029,15400,45851,0,0,0,40000,245280,288058,30800,91702,0,0,0,80000,490560,PROJECT DELAYED DUE TO CHANGES IN SCOPE/DESIGN,,CITYWIDE FERRY SERVICE - NEW VESSEL PURCHASE & UPGRADE,cpd11-20mn.pdf
DMECODOCK,Dyckman Pier -- Ferry Access to Eco-Dock,801,DEPT OF SMALL BUSINESS SERVICES,MISCELLANEOUS,100,MANHATTAN,ED-D075,500,0,500,0,0,0,0,0,500,0,500,0,0,0,0,0,500,0,1000,0,0,0,0,0,1000,,,DYCKMAN PIER -- FERRY ACCESS TO ECO-DOCK,cpd11-20mn.pdf
E34THPIER,EAST 34TH STREET PIER- NYU PARKING LOT REHAB,801,DEPT OF SMALL BUSINESS SERVICES,REHABILITATION OF NON-WATERFRONT PROPERTIES,101,MANHATTAN,RE-0025,920,793,0,0,0,0,0,44,837,793,0,0,0,0,0,44,837,1586,0,0,0,0,0,88,1674,PROJECT DELAYED DUE TO CHANGES IN SCOPE/DESIGN,,EAST 34TH STREET PIER- NYU PARKING LOT,cpd11-20mn.pdf
EASTPLAZA,East River Plaza,801,DEPT OF SMALL BUSINESS SERVICES,COMMERCIAL DEVELOPMENT,100 111,MANHATTAN,ED-D075,2000,0,0,0,0,0,0,2000,2000,0,0,0,0,0,0,2000,2000,0,0,0,0,0,0,4000,4000,PROJECT DELAYED DUE TO CHANGES IN SCOPE/DESIGN,UPPER EAST SIDE MANHATTAN,"480 SQ FT RETAIL CENTER, 1,248 CAR PARKING GARAGE, FOUR STORY BUILDING TO BENEFIT A",cpd11-20mn.pdf
EDCLUMP,EDC Lump Sum,801,DEPT OF SMALL BUSINESS SERVICES,MISCELLANEOUS,100,MANHATTAN,ED-0075,7725,0,0,0,0,0,4345,0,4345,0,0,0,0,0,4345,0,4345,0,0,0,0,0,8690,0,8690,,,EDC LUMP SUM,cpd11-20mn.pdf
EDMFPM,FERRY PIER AT DYCKMAN MARINA,801,DEPT OF SMALL BUSINESS SERVICES,MISCELLANEOUS,100,MANHATTAN,P-0501 P-0245M P-D018 ED-D401 PU-0200,5000,0,0,5333,5000,0,11932,0,22265,0,0,5333,5000,0,11932,0,22265,0,0,10666,10000,0,23864,0,44530,PROJECT DELAYED DUE TO CHANGES IN SCOPE/DESIGN,,FERRY PIER AT DYCKMAN MARINA,cpd11-20mn.pdf
ERIVERSPS,East River Science Park - Street work,801,DEPT OF SMALL BUSINESS SERVICES,COMMERCIAL DEVELOPMENT,100 106,MANHATTAN,ED-0075,9210,6713,0,0,0,0,0,236,6949,6713,0,0,0,0,0,236,6949,13426,0,0,0,0,0,472,13898,PROJECT DELAYED DUE TO CHANGES IN SCOPE/DESIGN,,EAST RIVER SCIENCE PARK - STREET WORK,cpd11-20mn.pdf
ERVRWALL,East River Seawall Rehabilitation (BMB to Pier 16),801,DEPT OF SMALL BUSINESS SERVICES,MISCELLANEOUS,100,MANHATTAN,ED-0409,3000,2899,0,0,0,0,0,100,2999,2899,0,0,0,0,0,100,2999,5798,0,0,0,0,0,200,5998,,,ERVRWALL,cpd11-20mn.pdf
FFREEDOMS,Four Freedoms Park Utilities,801,DEPT OF SMALL BUSINESS SERVICES,MISCELLANEOUS,100,MANHATTAN,ED-D075,0,0,350,0,0,0,0,0,350,0,350,0,0,0,0,0,350,0,700,0,0,0,0,0,700,,,"EDC/RIOC - PARK UTILITIES -- CONNECTING FOUR FREEDOMS PARK TO POTABLEWATER UTILITIES,",cpd11-20mn.pdf
GOVISBL20,Governors Island - Building 20 Nolan Park Renovation,801,DEPT OF SMALL BUSINESS SERVICES,MISCELLANEOUS,,MANHATTAN,ED-0831,2727,588,500,5083,0,0,0,0,6171,588,500,5083,0,0,0,0,6171,1176,1000,10166,0,0,0,0,12342,PROJECT DELAYED DUE TO CHANGES IN SCOPE/DESIGN,,BUILDING 20 NOLAN PARK RENOVATION,cpd11-20mn.pdf
GOVISBLD2,Governors Island Building Stabilization,801,DEPT OF SMALL BUSINESS SERVICES,MISCELLANEOUS,100 101,MANHATTAN,ED-0831,4951,1739,1942,0,0,0,0,0,3681,1739,1942,0,0,0,0,0,3681,3478,3884,0,0,0,0,0,7362,PROJECT DELAYED DUE TO CHANGES IN SCOPE/DESIGN,,BUILDING STABILIZATION,cpd11-20mn.pdf
GOVISBLDG,Governors Island Building Stabilization,801,DEPT OF SMALL BUSINESS SERVICES,MISCELLANEOUS,100,MANHATTAN,ED-0831,9435,5798,529,0,0,0,0,0,6327,5798,529,0,0,0,0,0,6327,11596,1058,0,0,0,0,0,12654,PROJECT DELAYED DUE TO CHANGES IN SCOPE/DESIGN,,GOVERNORS ISLAND BUILDING STABILIZATION,cpd11-20mn.pdf
GOVISBLNP,Governor's Island Building Stabilization - Nolan Park,801,DEPT OF SMALL BUSINESS SERVICES,MISCELLANEOUS,,MANHATTAN,ED-0831,0,0,0,1000,4347,0,0,0,5347,0,0,1000,4347,0,0,0,5347,0,0,2000,8694,0,0,0,10694,,,RENOVATION OF A HISTORIC BUILDING IN NOLAN PARK ON GOVERNORS ISLAND.,cpd11-20mn.pdf
GOVISBMB2,Governors Island BMB Slip5/6 Pile Cluster&Slip 6/7FenderRack,801,DEPT OF SMALL BUSINESS SERVICES,MISCELLANEOUS,100 101,MANHATTAN,ED-0075,6031,1828,1451,0,0,0,0,0,3279,1828,1451,0,0,0,0,0,3279,3656,2902,0,0,0,0,0,6558,PROJECT DELAYED PENDING APPROVAL OF NECESSARY PERMITS,,BMB SLIP 5/6 PILE CLUSTER AND SLIP 6/7 FENDER RACK,cpd11-20mn.pdf
GOVISBMBG,Governors Island BMB SLIP 6 & SLIP 7 GANTRIES,801,DEPT OF SMALL BUSINESS SERVICES,MISCELLANEOUS,100   101,MANHATTAN,ED-0075,1206,0,1206,0,0,0,0,0,1206,0,1206,0,0,0,0,0,1206,0,2412,0,0,0,0,0,2412,,,"REHABILITATION OF THE GANTRY TOWERS AT SLIP 6 AND SLIP 7 AT THE BATTERY MARITIME BUILDING,",cpd11-20mn.pdf
GOVISELE2,Governors Island Electric Projects,801,DEPT OF SMALL BUSINESS SERVICES,MISCELLANEOUS,,MANHATTAN,ED-0831 ED-0075,17000,5389,1622,0,10000,0,0,0,17011,5389,1622,0,10000,0,0,0,17011,10778,3244,0,20000,0,0,0,34022,PROJECT DELAYED DUE TO CHANGES IN SCOPE/DESIGN,,GOVERNORS ISLAND - DESIGN PORTION OF THE FOLLOWING PROJECTS,cpd11-20mn.pdf
GOVISLND2,Governors Island Infrastructure Improvements,801,DEPT OF SMALL BUSINESS SERVICES,MISCELLANEOUS,101,MANHATTAN,ED-0831,31390,0,0,0,4000,4000,4000,17357,29357,0,0,0,4000,4000,4000,17357,29357,0,0,0,8000,8000,8000,34714,58714,PROJECT DELAYED DUE TO CHANGES IN SCOPE/DESIGN,,RECONSTRUCTION/UPGRADE OF INFRASTRUCTURE ON GOVERNORS ISLAND.,cpd11-20mn.pdf
GOVISPUMP,Governors Island Sewage Pump House,801,DEPT OF SMALL BUSINESS SERVICES,MISCELLANEOUS,,MANHATTAN,ED-0831,1500,3015,191,0,0,0,0,0,3206,3015,191,0,0,0,0,0,3206,6030,382,0,0,0,0,0,6412,PROJECT DELAYED DUE TO CHANGES IN SCOPE/DESIGN,,GOVERNOR ISLAND SEWAGE PUMP HOUSE,cpd11-20mn.pdf
GOVISSSN2,Governors Island Soissons Dock 2,801,DEPT OF SMALL BUSINESS SERVICES,MISCELLANEOUS,100,MANHATTAN,ED-0831,4896,4835,492,0,0,0,0,0,5327,4835,492,0,0,0,0,0,5327,9670,984,0,0,0,0,0,10654,PROJECT DELAYED DUE TO CHANGES IN SCOPE/DESIGN,,RECONSTRUCTION OF SOISSONS DOCK ON GOVERNORS ISLAND,cpd11-20mn.pdf
GOVISUNUT,Governors Island Underground Utilities,801,DEPT OF SMALL BUSINESS SERVICES,MISCELLANEOUS,,MANHATTAN,ED-0831,10000,1160,13260,8000,0,0,0,0,22420,1160,13260,8000,0,0,0,0,22420,2320,26520,16000,0,0,0,0,44840,PROJECT DELAYED DUE TO CHANGES IN SCOPE/DESIGN,,"GOVERNORS ISLAND UNDERGROUND UTILITIES - NORTH ISLAND, HISTORIC DISTRICT, INSTALLATION.",cpd11-20mn.pdf
GOVISWLL2,Governors Island Seawall Rehabilitation,801,DEPT OF SMALL BUSINESS SERVICES,MISCELLANEOUS,100,MANHATTAN,ED-0831,7452,0,0,4576,4375,0,0,0,8951,0,0,4576,4375,0,0,0,8951,0,0,9152,8750,0,0,0,17902,PROJECT DELAYED DUE TO CHANGES IN SCOPE/DESIGN,,REHABILITATION OF THE SEAWALL AT GOVERNORS ISLAND,cpd11-20mn.pdf
HARLEMRY,Harlem River Yards,801,DEPT OF SMALL BUSINESS SERVICES,MISCELLANEOUS,100,MANHATTAN,ED-X075,1000,0,0,0,0,0,1000,0,1000,0,0,0,0,0,1000,0,1000,0,0,0,0,0,2000,0,2000,PROJECT DELAYED DUE TO CHANGES IN SCOPE/DESIGN,,HARLEM RIVER YARDS,cpd11-20mn.pdf
HARLESPL,Harlem River Esplanade,801,DEPT OF SMALL BUSINESS SERVICES,WATERFRONT DEVELOPMENT,110,MANHATTAN,P-C018,4500,7256,0,0,0,245,0,0,7501,7256,0,0,0,245,0,0,7501,14512,0,0,0,490,0,0,15002,PROJECT DELAYED DUE TO CHANGES IN SCOPE/DESIGN,,BULKHEAD IMPROVEMENTS,cpd11-20mn.pdf
HARLMPIER,Harlem Area Piers & Bulkhead Stabilization,801,DEPT OF SMALL BUSINESS SERVICES,WATERFRONT DEVELOPMENT,109,MANHATTAN,ED-0401 ED-0075 P-C018,14619,7703,0,0,0,0,0,106,7809,7703,0,0,0,0,0,106,7809,15406,0,0,0,0,0,212,15618,PROJECT DELAYED DUE TO CHANGES IN SCOPE/DESIGN,,,cpd11-20mn.pdf
HBMA4501B,33rd Street West of 11th Avenue (Hudson Yards),801,DEPT OF SMALL BUSINESS SERVICES,BRIDGE LIFE EXTENSION AND MISCELLANEOUS WORK,100,MANHATTAN,HB-0215 HW-0001M,100000,2830,2830,10000,0,0,84340,0,100000,2830,2830,10000,0,0,84340,0,100000,5660,5660,20000,0,0,168680,0,200000,PROJECT DELAYED DUE TO CHANGES IN SCOPE/DESIGN,,REGARDING OF 33RD STREET WEST OF 11TH AVENUE (HUDSON YARDS),cpd11-20mn.pdf
HIGHLINE,High Line,801,DEPT OF SMALL BUSINESS SERVICES,"LARGE, MAJOR AND REGIONAL PARK RECONSTRUCTION",104,MANHATTAN,P-0245M P-1326 P-D018,115644,74304,0,0,0,0,0,107,74411,74304,0,0,0,0,0,107,74411,148608,0,0,0,0,0,214,148822,PROJECT DELAYED DUE TO CHANGES IN SCOPE/DESIGN,"HI LINE, MANHATTAN",HIGH-LINE,cpd11-20mn.pdf
HIGHLINE2,High Line - Section 2,801,DEPT OF SMALL BUSINESS SERVICES,"LARGE, MAJOR AND REGIONAL PARK RECONSTRUCTION",104,MANHATTAN,P-1326 P-1018,74001,39380,0,0,0,0,0,0,39380,39380,0,0,0,0,0,0,39380,78760,0,0,0,0,0,0,78760,PROJECT DELAYED DUE TO CHANGES IN SCOPE/DESIGN,,HIGH LINE SECTION 2,cpd11-20mn.pdf
HILINEM&O,WHIT - High Line M&O Facility,801,DEPT OF SMALL BUSINESS SERVICES,COMMUNITY DEVELOPMENT,104,MANHATTAN,P-1326,20490,18660,0,0,0,191,0,0,18851,18660,0,0,0,191,0,0,18851,37320,0,0,0,382,0,0,37702,PROJECT DELAYED DUE TO CHANGES IN SCOPE/DESIGN,,HIGH LINE M&O FACILITY,cpd11-20mn.pdf
HL82PHL,DOHMH PHL BUILDING CONSTRUCTION,801,DEPT OF SMALL BUSINESS SERVICES,LABORATORIES,,MANHATTAN,HL-0082,177527,47981,22985,72153,167636,167636,167636,0,646027,47981,22985,72153,167636,167636,167636,0,646027,95962,45970,144306,335272,335272,335272,0,1292054,,,ESTIMATE,cpd11-20mn.pdf
HWD10214,Hudson Sq Streetscape Improvements,801,DEPT OF SMALL BUSINESS SERVICES,PRIMARY STREET RECONSTRUCTION,100 102,MANHATTAN,HW-D102 HW-0001M,11080,6000,1001,0,0,0,0,0,7001,6000,1001,0,0,0,0,0,7001,12000,2002,0,0,0,0,0,14002,PROJECT DELAYED DUE TO CHANGES IN SCOPE/DESIGN,HUDSON SQ STREETSCAPE IMPROVEMENTS,HUDSON SQ STREETSCAPE IMPROVEMENTS,cpd11-20mn.pdf
HYDCBLVD,HYDC - MID-BLOCK BLVD AND CROSS STREETS-HUDSON YARD VICINITY,801,DEPT OF SMALL BUSINESS SERVICES,NEIGHBORHOOD REVITALIZATION,104,MANHATTAN,HW-1683 P-0245M SE-0200M,31177,279,0,0,0,0,0,9,288,279,0,0,0,0,0,9,288,558,0,0,0,0,0,18,576,PROJECT DELAYED DUE TO CHANGES IN SCOPE/DESIGN,,HUDSON YARDS DEVELOPMENT CORPORATION - BOULEVARD AND STREETSCAPE,cpd11-20mn.pdf
INTREPIDC,FA - Intrepid Museum Foundation - cooling tower,801,DEPT OF SMALL BUSINESS SERVICES,MISCELLANEOUS,104,MANHATTAN,ED-0075,4171,4072,0,0,0,0,0,99,4171,4072,0,0,0,0,0,99,4171,8144,0,0,0,0,0,198,8342,PROJECT DELAYED DUE TO CHANGES IN SCOPE/DESIGN,,INTREPID MUSEUM,cpd11-20mn.pdf
JULIABLCC,Julia de Burgos Latino Cultural Center,801,DEPT OF SMALL BUSINESS SERVICES,NEIGHBORHOOD REVITALIZATION,111,MANHATTAN,ED-0075 ED-D075,685,542,0,0,0,0,924,0,1466,542,0,0,0,0,924,0,1466,1084,0,0,0,0,1848,0,2932,PROJECT DELAYED DUE TO CHANGES IN SCOPE/DESIGN,,JULIA BORGES LATINO CULTURAL CENTER,cpd11-20mn.pdf
JULIABREN,JULIA DE BURGOS CULTURAL CENTER RENOVATIONS,801,DEPT OF SMALL BUSINESS SERVICES,NEIGHBORHOOD REVITALIZATION,100,MANHATTAN,ED-D075,500,177,161,0,0,0,162,0,500,177,161,0,0,0,162,0,500,354,322,0,0,0,324,0,1000,PROJECT DELAYED DUE TO CHANGES IN SCOPE/DESIGN,,JULIA DE BURGOS CULTURAL CENTER RENOVATIONS--CAPITAL UPGRADES THROUGHOUT THE,cpd11-20mn.pdf
LAMARQPLZ,La Marqueta Plaza Rehabilitation,801,DEPT OF SMALL BUSINESS SERVICES,NEIGHBORHOOD REVITALIZATION,100,MANHATTAN,ED-D408 ED-D075,10500,7389,3112,0,0,0,0,0,10501,7389,3112,0,0,0,0,0,10501,14778,6224,0,0,0,0,0,21002,PROJECT DELAYED DUE TO CHANGES IN SCOPE/DESIGN,,LA MARQUETA PLAZA REHABILITATION,cpd11-20mn.pdf
LAMARQUE4,La Marqueta Building 4 Exterior Envelope Rehab,801,DEPT OF SMALL BUSINESS SERVICES,MISCELLANEOUS,100,MANHATTAN,ED-0075,1400,155,119,0,0,0,1125,0,1399,155,119,0,0,0,1125,0,1399,310,238,0,0,0,2250,0,2798,PROJECT DELAYED DUE TO CHANGES IN SCOPE/DESIGN,,LA MARQUETA BUILDING #4,cpd11-20mn.pdf
LCNPARK,Lower Concourse Park,801,DEPT OF SMALL BUSINESS SERVICES,MISCELLANEOUS,100,MANHATTAN,ED-0384,35408,3434,0,0,0,30924,1050,0,35408,3434,0,0,0,30924,1050,0,35408,6868,0,0,0,61848,2100,0,70816,PROJECT DELAYED DUE TO CHANGES IN SCOPE/DESIGN,,LOWER CONCOURSE PARK,cpd11-20mn.pdf
LIFESCIEN,LIFE SCIENCES HUB,801,DEPT OF SMALL BUSINESS SERVICES,COMMERCIAL DEVELOPMENT,100,MANHATTAN,ED-0075,150000,0,0,25000,0,0,0,125000,150000,0,0,25000,0,0,0,125000,150000,0,0,50000,0,0,0,250000,300000,PROJECT DELAYED DUE TO CHANGES IN SCOPE/DESIGN,,LIFE SCIENCES HUB,cpd11-20mn.pdf
LMAQFACIL,"La Marqueta GFNYC, IBZ & NYCEDC Operations Facility",801,DEPT OF SMALL BUSINESS SERVICES,MISCELLANEOUS,100,MANHATTAN,ED-0075,1600,320,0,0,0,0,25,1256,1601,320,0,0,0,0,25,1256,1601,640,0,0,0,0,50,2512,3202,PROJECT DELAYED DUE TO CHANGES IN SCOPE/DESIGN,,"LA MARQUETA GFNYC, IBZ&NYCEDC OPERATIONS FACILITY. 10/28/14 ADDED 1.6M FROM NRELUMP FOR",cpd11-20mn.pdf
LNEA16125,125th St,801,DEPT OF SMALL BUSINESS SERVICES,ESSENTIAL RECONSTRUCTION OF FACILITIES,100,MANHATTAN,LN-0008 LN-D008 LN-M001,20000,1175,17426,0,0,0,0,0,18601,1175,17426,0,0,0,0,0,18601,2350,34852,0,0,0,0,0,37202,PROJECT DELAYED DUE TO CHANGES IN SCOPE/DESIGN,,INTERIOR AND EXTERIOR COMPREHENSIVE RENOVATION,cpd11-20mn.pdf
LNEA16FWT,FORT WASHINGTON,801,DEPT OF SMALL BUSINESS SERVICES,ESSENTIAL RECONSTRUCTION OF FACILITIES,100,MANHATTAN,LN-0008 LN-D008,20000,0,23155,0,0,0,0,0,23155,0,23155,0,0,0,0,0,23155,0,46310,0,0,0,0,0,46310,PROJECT DELAYED DUE TO CHANGES IN SCOPE/DESIGN,,MAJOR RENOVATION,cpd11-20mn.pdf
MANHGREEN,Manhattan Greenway,801,DEPT OF SMALL BUSINESS SERVICES,COMMUNITY DEVELOPMENT,100,MANHATTAN,ED-0075,100000,28603,35000,0,15000,0,0,76237,154840,28603,35000,0,15000,0,0,76237,154840,57206,70000,0,30000,0,0,152474,309680,PROJECT DELAYED DUE TO CHANGES IN SCOPE/DESIGN,,MANHATTAN GREENWAY,cpd11-20mn.pdf
MCRUISE,"Manhattan Cruise Terminal Improvements to Pier 88, 90",801,DEPT OF SMALL BUSINESS SERVICES,FINANCING COSTS,100,MANHATTAN,ED-0409,3500,0,0,0,0,0,3000,500,3500,0,0,0,0,0,3000,500,3500,0,0,0,0,0,6000,1000,7000,PROJECT DELAYED DUE TO CHANGES IN SCOPE/DESIGN,,MANHATTAN CRUISE TERMINAL IMPROVEMENTS,cpd11-20mn.pdf
MCTFEND,MCT PIER 90 FENDERING,801,DEPT OF SMALL BUSINESS SERVICES,MISCELLANEOUS,100,MANHATTAN,ED-0409,8000,0,0,0,0,0,8000,0,8000,0,0,0,0,0,8000,0,8000,0,0,0,0,0,16000,0,16000,PROJECT DELAYED DUE TO CHANGES IN SCOPE/DESIGN,,MCT PIER 90 FENDERING,cpd11-20mn.pdf
MCTPLAT,Manhattan Cruise Terminal Inshore Platform Rehabilitation,801,DEPT OF SMALL BUSINESS SERVICES,WATERFRONT DEVELOPMENT,100,MANHATTAN,ED-0409,5500,3087,0,0,0,0,0,2414,5501,3087,0,0,0,0,0,2414,5501,6174,0,0,0,0,0,4828,11002,PROJECT DELAYED DUE TO CHANGES IN SCOPE/DESIGN,,MANHATTAN CRUISE TERMINAL INSHORE PLATFORM REHABILITATION,cpd11-20mn.pdf
MCTROOF,Manhattan Cruise Terminal Roof and Viaduct Traffic Topping,801,DEPT OF SMALL BUSINESS SERVICES,MISCELLANEOUS,100,MANHATTAN,ED-0075,2000,1399,0,0,0,0,601,0,2000,1399,0,0,0,0,601,0,2000,2798,0,0,0,0,1202,0,4000,PROJECT DELAYED DUE TO CHANGES IN SCOPE/DESIGN,,MANHATTAN CRUISE TERMINAL ROOF AND VIADUCT TRAFFIC TOPPING,cpd11-20mn.pdf
MCTROOF2,Manhattan Cruise Terminal Roof - Phase 2 - Pier 88,801,DEPT OF SMALL BUSINESS SERVICES,MISCELLANEOUS,100,MANHATTAN,ED-0075,0,541,0,0,0,0,1458,0,1999,541,0,0,0,0,1458,0,1999,1082,0,0,0,0,2916,0,3998,PROJECT DELAYED DUE TO CHANGES IN SCOPE/DESIGN,,MCT ROOF - PHASE 2 - PIER 88,cpd11-20mn.pdf
MECAFIT,MECA FITNESS CENTER RENOVATION--FITNESS CENTER RENOVATION,801,DEPT OF SMALL BUSINESS SERVICES,MISCELLANEOUS,100,MANHATTAN,PW-D005,150,0,0,150,0,0,0,0,150,0,0,150,0,0,0,0,150,0,0,300,0,0,0,0,300,PROJECT DELAYED DUE TO CHANGES IN SCOPE/DESIGN,,MECA FITNESS CENTER RENOVATION--FITNESS CENTER RENOVATION,cpd11-20mn.pdf
NDF-3HRGL,NDF - Harlem River Greenway Link - New Park Development,801,DEPT OF SMALL BUSINESS SERVICES,MISCELLANEOUS,100,MANHATTAN,ED-0384,83000,3707,0,15000,0,0,59000,5293,83000,3707,0,15000,0,0,59000,5293,83000,7414,0,30000,0,0,118000,10586,166000,PROJECT DELAYED DUE TO CHANGES IN SCOPE/DESIGN,,HARLEM RIVER GREENWAY LINK - NEW PARK DEVELOPMENT,cpd11-20mn.pdf
NDF-LAMAR,La Marqueta Redevelopment,801,DEPT OF SMALL BUSINESS SERVICES,MARKET DEVELOPMENT,100,MANHATTAN,ED-0384,25000,0,0,0,0,0,0,25000,25000,0,0,0,0,0,0,25000,25000,0,0,0,0,0,0,50000,50000,PROJECT DELAYED DUE TO CHANGES IN SCOPE/DESIGN,,LA MARQUETA REDEVELOPMENT,cpd11-20mn.pdf
NDF-NWOOD,NDF - Inwood Greenway and New Parks Development,801,DEPT OF SMALL BUSINESS SERVICES,MISCELLANEOUS,100,MANHATTAN,ED-0384,50000,0,0,0,0,44542,0,5458,50000,0,0,0,0,44542,0,5458,50000,0,0,0,0,89084,0,10916,100000,PROJECT DELAYED DUE TO CHANGES IN SCOPE/DESIGN,,INWOOD GREENWAY AND NEW PARKS CONSTRUCTION,cpd11-20mn.pdf
NONTDW,Nontraditional Employment for Women - Renovation of HQ,801,DEPT OF SMALL BUSINESS SERVICES,MISCELLANEOUS,100,MANHATTAN,ED-D075,1000,0,0,0,0,1000,0,0,1000,0,0,0,0,1000,0,0,1000,0,0,0,0,2000,0,0,2000,PROJECT DELAYED DUE TO CHANGES IN SCOPE/DESIGN,,NONTRADITIONAL EMPLOYMENT FOR WOMEN - RENOVATIONS OF CITY-OWNED HEADQUARTERS,cpd11-20mn.pdf
NR COGEN,DEP,801,DEPT OF SMALL BUSINESS SERVICES,MISCELLANEOUS,100,MANHATTAN,PU-0025,5432,1888,0,1237,0,0,0,0,3125,1888,0,1237,0,0,0,0,3125,3776,0,2474,0,0,0,0,6250,PROJECT DELAYED DUE TO CHANGES IN SCOPE/DESIGN,,NORTH RIVER COGENERATION PLANT,cpd11-20mn.pdf
NYCFBARGE,New York City Ferry - Barge Expansion,801,DEPT OF SMALL BUSINESS SERVICES,MISCELLANEOUS,100,MANHATTAN,ED-0409,29633,7410,37675,0,0,0,0,0,45085,7410,37675,0,0,0,0,0,45085,14820,75350,0,0,0,0,0,90170,,,NEW YORK CITY FERRY - BARGE LANDING EXPANSION,cpd11-20mn.pdf
NYCFVAPEX,New York City Ferry - VAP3 Expansion Vessels,801,DEPT OF SMALL BUSINESS SERVICES,MISCELLANEOUS,100,MANHATTAN,ED-0409,66006,39074,3929,23003,0,0,0,0,66006,39074,3929,23003,0,0,0,0,66006,78148,7858,46006,0,0,0,0,132012,,,NEW YORK CITY FERRY - VAP3 EXPANSION VESSELS,cpd11-20mn.pdf
NYPDHRP76,Hudson River Park- Segment 6- Pier 76,801,DEPT OF SMALL BUSINESS SERVICES,"BUILDING CONSTRUCTION, RECONSTRUCTION OR RETROFIT",100,MANHATTAN,PU-0200,18808,0,607,0,0,0,7000,11201,18808,0,607,0,0,0,7000,11201,18808,0,1214,0,0,0,14000,22402,37616,PROJECT DELAYED DUE TO CHANGES IN SCOPE/DESIGN,,HUDSON RIVER PARK- SEGMENT 6- PIER 76,cpd11-20mn.pdf
P-301BATW,Battery Park - Wharf,801,DEPT OF SMALL BUSINESS SERVICES,MAJOR RECREATIONAL FACILITIES AND FACILITY RECONSTRUCTION,100,MANHATTAN,PU-0200 RE-0025,4300,4374,21,0,0,911,0,0,5306,4374,21,0,0,911,0,0,5306,8748,42,0,0,1822,0,0,10612,PROJECT DELAYED DUE TO CHANGES IN SCOPE/DESIGN,BOROUGH OF MANHATTAN,BATTERY PARK WHARF,cpd11-20mn.pdf
P-309RVP2,RIVERSIDE PARK 79 ST BOAT BASIN,801,DEPT OF SMALL BUSINESS SERVICES,"LARGE, MAJOR AND REGIONAL PARK RECONSTRUCTION",100,MANHATTAN,PU-0200 P-1018,60938,4091,0,0,44612,12235,0,0,60938,4091,0,0,44612,12235,0,0,60938,8182,0,0,89224,24470,0,0,121876,,RIVERSIDE PARK 79 ST BOAT BASIN,RIVERSIDE PARK,cpd11-20mn.pdf
P-3E103CG,FA - East 103rd street community garden,801,DEPT OF SMALL BUSINESS SERVICES,NEIGHBORHOOD PARKS AND PLAYGROUNDS,100 111,MANHATTAN,P-D018,150,0,0,0,150,0,0,0,150,0,0,0,150,0,0,0,150,0,0,0,300,0,0,0,300,PROJECT DELAYED DUE TO CHANGES IN SCOPE/DESIGN,EAST 103RD STREET,EAST 103RD STREET COMMUNITY GARDEN IN MANHATTAN,cpd11-20mn.pdf
P-3HIGHLL,FRIENDS OF THE HIGH LINE-LIFE SAFETY UPGRADES & CIRCULATION,801,DEPT OF SMALL BUSINESS SERVICES,NEIGHBORHOOD PARKS AND PLAYGROUNDS,100,MANHATTAN,P-D018,617,0,617,0,0,0,0,0,617,0,617,0,0,0,0,0,617,0,1234,0,0,0,0,0,1234,,,"MADISON SQ. PARK ETERNAL LIGHT FLAGSTAFF LANDSCAPE, MAHATTAN",cpd11-20mn.pdf
P-3HILIN3,Highline Phase 3,801,DEPT OF SMALL BUSINESS SERVICES,MISCELLANEOUS,104,MANHATTAN,P-1326 P-1018 P-M245,11000,10268,192,473,0,0,0,0,10933,10268,192,473,0,0,0,0,10933,20536,384,946,0,0,0,0,21866,,,HIGHLINE PHASE 3,cpd11-20mn.pdf
P-3HRP132,Harlem River Park 132-135,801,DEPT OF SMALL BUSINESS SERVICES,"LARGE, MAJOR AND REGIONAL PARK RECONSTRUCTION",100,MANHATTAN,PU-0200 P-0501,20216,6461,11909,0,0,126288,0,0,144658,6461,11909,0,0,126288,0,0,144658,12922,23818,0,0,252576,0,0,289316,,HARLEM RIVER PK 132-135 ST.,HARLEM RIVER PK 132-135 ST.,cpd11-20mn.pdf
P-3RETWAL,Seawall and Henry Hudson Parkway,801,DEPT OF SMALL BUSINESS SERVICES,"LARGE, MAJOR AND REGIONAL PARK RECONSTRUCTION",100,MANHATTAN,P-1018 P-1515,3286,4232,344,0,0,0,0,0,4576,4232,344,0,0,0,0,0,4576,8464,688,0,0,0,0,0,9152,PROJECT DELAYED DUE TO CHANGES IN SCOPE/DESIGN,MANHATTAN,E. RIVER PARK RETAINING WALLS,cpd11-20mn.pdf
PASSSHIP4,Manhattan Cruise Terminal - Viaduct Concrete Rehabilitation,801,DEPT OF SMALL BUSINESS SERVICES,WATERFRONT DEVELOPMENT,104,MANHATTAN,ED-0075,6000,5648,0,0,0,0,350,0,5998,5648,0,0,0,0,350,0,5998,11296,0,0,0,0,700,0,11996,PROJECT DELAYED DUE TO CHANGES IN SCOPE/DESIGN,"NEW YORK, NEW YORK 10019",MANHATTAN CRUISE TERMINAL - VIADUCT CONCRETE REHABILITATION,cpd11-20mn.pdf
PIER11DOT,Pier 11,801,DEPT OF SMALL BUSINESS SERVICES,RECONSTRUCTION OF FERRY TERMINAL FACILITIES,100,MANHATTAN,FA-0027,3750,3000,0,0,0,0,729,0,3729,3000,0,0,0,0,729,0,3729,6000,0,0,0,0,1458,0,7458,,,PIER 11,cpd11-20mn.pdf
PIER35-36,Pier 35 and 36 Rehabilitation,801,DEPT OF SMALL BUSINESS SERVICES,WATERFRONT DEVELOPMENT,103,MANHATTAN,ED-0409 SE-0200M WM-0001,6400,15555,0,0,0,282,2061,657,18555,15555,0,0,0,282,2061,657,18555,31110,0,0,0,564,4122,1314,37110,PROJECT DELAYED DUE TO CHANGES IN SCOPE/DESIGN,,REHABILITATION OF PLATFORM AT PIERS 35 AND 36,cpd11-20mn.pdf
PIER36,Pier 36 Structural Rehab,801,DEPT OF SMALL BUSINESS SERVICES,GARAGES AND FACILITIES,103,MANHATTAN,PU-0200,108594,0,0,0,0,28594,80000,0,108594,0,0,0,0,28594,80000,0,108594,0,0,0,0,57188,160000,0,217188,,,"CAPITAL REHAB/REPLACEMENT OF PILES, PILE CAPS, SLAB, TOPPING",cpd11-20mn.pdf
PIER36STR,Pier 36 Structural Rehab,801,DEPT OF SMALL BUSINESS SERVICES,GARAGES AND FACILITIES,103,MANHATTAN,PU-0200,13630,7661,5970,0,0,0,0,0,13631,7661,5970,0,0,0,0,0,13631,15322,11940,0,0,0,0,0,27262,PROJECT DELAYED DUE TO CHANGES IN SCOPE/DESIGN,,STRUCTURRAL REHAB,cpd11-20mn.pdf
PIER38,DPR-CON ED Pier-Rehab Pier on East River from 38th to 44th S,801,DEPT OF SMALL BUSINESS SERVICES,MISCELLANEOUS,100 106,MANHATTAN,ED-D401,3102,3173,0,0,527,0,0,0,3700,3173,0,0,527,0,0,0,3700,6346,0,0,1054,0,0,0,7400,PROJECT DELAYED DUE TO CHANGES IN SCOPE/DESIGN,,DPR-CON ED PIER-REHAB PIER ON EAST RIVER FROM 38TH TO 44TH ST.,cpd11-20mn.pdf
PIER4,PIER 4 Rehabilitation,801,DEPT OF SMALL BUSINESS SERVICES,WATERFRONT DEVELOPMENT,100,MANHATTAN,ED-0409,1891,466,0,0,0,0,1425,0,1891,466,0,0,0,0,1425,0,1891,932,0,0,0,0,2850,0,3782,PROJECT DELAYED DUE TO CHANGES IN SCOPE/DESIGN,,PIER 4 REHABILITATION,cpd11-20mn.pdf
PIER42CNT,Pier 42 and East River Park Connector Program,801,DEPT OF SMALL BUSINESS SERVICES,MISCELLANEOUS,100,MANHATTAN,ED-0075 P-0245M P-1018 SE-0002M,23890,1729,13167,18263,0,0,0,0,33159,1729,13167,18263,0,0,0,0,33159,3458,26334,36526,0,0,0,0,66318,PROJECT DELAYED DUE TO CHANGES IN SCOPE/DESIGN,,PIER 42,cpd11-20mn.pdf
PIER6PILE,Pier 6 Pile Rehabilitation,801,DEPT OF SMALL BUSINESS SERVICES,PORT DEVELOPMENT,100,MANHATTAN,ED-0409,4000,1749,0,0,0,0,2251,0,4000,1749,0,0,0,0,2251,0,4000,3498,0,0,0,0,4502,0,8000,PROJECT DELAYED DUE TO CHANGES IN SCOPE/DESIGN,,PIER 6 PILE REHABILITATION,cpd11-20mn.pdf
PIER79DOT,Pier 79,801,DEPT OF SMALL BUSINESS SERVICES,RECONSTRUCTION OF FERRY TERMINAL FACILITIES,100,MANHATTAN,FA-0027,5500,1996,0,0,0,0,663,0,2659,1996,0,0,0,0,663,0,2659,3992,0,0,0,0,1326,0,5318,,,PIER79,cpd11-20mn.pdf
PIERS35N6,Pier 35 & 36 Substructure Rehabilitation,801,DEPT OF SMALL BUSINESS SERVICES,MISCELLANEOUS,100,MANHATTAN,ED-0409,2000,672,1328,0,0,0,0,0,2000,672,1328,0,0,0,0,0,2000,1344,2656,0,0,0,0,0,4000,PROJECT DELAYED DUE TO CHANGES IN SCOPE/DESIGN,,PIER 35 & 36 SUBSTRUCTURE REHABILITATION,cpd11-20mn.pdf
PIERS8890,Piers 88 & 90 Cluster Encapsulation Project,801,DEPT OF SMALL BUSINESS SERVICES,MISCELLANEOUS,101,MANHATTAN,ED-0409,20500,19203,1297,0,0,0,0,0,20500,19203,1297,0,0,0,0,0,20500,38406,2594,0,0,0,0,0,41000,PROJECT DELAYED DUE TO CHANGES IN SCOPE/DESIGN,,PIERS 88 & 90 CLUSTER ENCAPSULATION PROJECT,cpd11-20mn.pdf
PROGDOMIN,COMMUNITY ASSOCIATION OF PROGRESSIVE DOMINICANS,801,DEPT OF SMALL BUSINESS SERVICES,MISCELLANEOUS,100,MANHATTAN,ED-D075 ED-M075,900,744,155,0,0,0,0,0,899,744,155,0,0,0,0,0,899,1488,310,0,0,0,0,0,1798,,,COMMUNITY ASSOCIATION OF PROGRESSIVE DOMINICANS--CONSTRUCTION RENOVATION,cpd11-20mn.pdf
PV279-STU,NYCC - New York City Center Studios Renovation,801,DEPT OF SMALL BUSINESS SERVICES,ESSENTIAL RECONSTRUCTION OF FACILITIES,,MANHATTAN,PV-M279 PV-0279 PV-D279,1350,1885,278,54,0,0,0,0,2217,1885,278,54,0,0,0,0,2217,3770,556,108,0,0,0,0,4434,PROJECT DELAYED DUE TO CHANGES IN SCOPE/DESIGN,,TBD,cpd11-20mn.pdf
PV467-BEY,DCA PFA - Percent for Art Beyond Sims,801,DEPT OF SMALL BUSINESS SERVICES,ESSENTIAL RECONSTRUCTION OF FACILITIES,101 102,MANHATTAN,PV-0467,1000,0,1000,0,0,0,0,0,1000,0,1000,0,0,0,0,0,1000,0,2000,0,0,0,0,0,2000,,,MONUMENT,cpd11-20mn.pdf
PV467ELMB,ELM- El Museo - Gallery Environmental Stabilzation Project,801,DEPT OF SMALL BUSINESS SERVICES,ESSENTIAL RECONSTRUCTION OF FACILITIES,111,MANHATTAN,PV-0103 PV-D018 PV-0467 PV-D467,2718,4103,0,150,0,538,0,0,4791,4103,0,150,0,538,0,0,4791,8206,0,300,0,1076,0,0,9582,PROJECT DELAYED DUE TO CHANGES IN SCOPE/DESIGN,"1230 FIFTH AVENUE, MANHATTAN, NY",MUSUEM GALLERY HVAC AND ENVIRONMENTAL STABILIZATION,cpd11-20mn.pdf
PV467M125,Mart 125 Development,801,DEPT OF SMALL BUSINESS SERVICES,ESSENTIAL RECONSTRUCTION OF FACILITIES,111,MANHATTAN,PV-0467 PV-D467,9000,539,0,12806,0,0,0,0,13345,539,0,12806,0,0,0,0,13345,1078,0,25612,0,0,0,0,26690,PROJECT DELAYED DUE TO CHANGES IN SCOPE/DESIGN,,DEVELOPMENT OF MART 125 CULTURAL SPACE,cpd11-20mn.pdf
PV467-PCT,DCA PFA - Percent for Art Tito P.,801,DEPT OF SMALL BUSINESS SERVICES,ESSENTIAL RECONSTRUCTION OF FACILITIES,101 102,MANHATTAN,PV-D467 PV-0467,992,0,500,0,0,0,0,0,500,0,500,0,0,0,0,0,500,0,1000,0,0,0,0,0,1000,PROJECT DELAYED DUE TO CHANGES IN SCOPE/DESIGN,"31 CHAMBERS STREET, NYC",CONSERVATION OF 3 PUBLIC ART WORKS TO BE IDENTIFIED,cpd11-20mn.pdf
RANDISSF,Randall's Island Sports Fields,801,DEPT OF SMALL BUSINESS SERVICES,MISCELLANEOUS,111,MANHATTAN,P-0944 P-1018,3950,9871,0,0,0,0,0,109,9980,9871,0,0,0,0,0,109,9980,19742,0,0,0,0,0,218,19960,PROJECT DELAYED DUE TO CHANGES IN SCOPE/DESIGN,,DESIGN IMPROVEMENTS OF RANDALL'S ISLAND SPORTS FIELDS,cpd11-20mn.pdf
RISALTMAR,Randall's Island Salt Marsh,801,DEPT OF SMALL BUSINESS SERVICES,"LARGE, MAJOR AND REGIONAL PARK RECONSTRUCTION",111,MANHATTAN,SE-0200M P-0944,4207,2472,0,0,0,0,0,8,2480,2472,0,0,0,0,0,8,2480,4944,0,0,0,0,0,16,4960,PROJECT DELAYED DUE TO CHANGES IN SCOPE/DESIGN,,RI SALT MARSH,cpd11-20mn.pdf
ROOSEDOCK,Roosevelt Island Dock,801,DEPT OF SMALL BUSINESS SERVICES,WATERFRONT DEVELOPMENT,108,MANHATTAN,ED-D401,500,0,0,0,0,0,698,0,698,0,0,0,0,0,698,0,698,0,0,0,0,0,1396,0,1396,PROJECT DELAYED DUE TO CHANGES IN SCOPE/DESIGN,,ROOSEVELT ISLAND DOCK,cpd11-20mn.pdf
ROOSEOPER,Roosevelt Island Operating Corp - Blackwell House,801,DEPT OF SMALL BUSINESS SERVICES,MISCELLANEOUS,108,MANHATTAN,ED-D075,144,0,144,0,0,0,0,0,144,0,144,0,0,0,0,0,144,0,288,0,0,0,0,0,288,,,ROOSEVELT ISLAND OPERATING CORP - BLACKWELL HOUSE -- ADDITION OF A PLAYGROUND AREA -,cpd11-20mn.pdf
ROOSISLTH,ROOSEVELT ISLAND LIGHTHOUSE,801,DEPT OF SMALL BUSINESS SERVICES,MISCELLANEOUS,100,MANHATTAN,ED-D075,700,0,0,0,0,700,0,0,700,0,0,0,0,700,0,0,700,0,0,0,0,1400,0,0,1400,PROJECT DELAYED DUE TO CHANGES IN SCOPE/DESIGN,,ROOSEVELT ISLAND LIGHTHOUSE RESTORATION FOR PUBLIC ACCESS--RESTORE THE LIGHTHOUSE OF,cpd11-20mn.pdf
SAND1101,HHC FEMA PMP BELLEVUE,801,DEPT OF SMALL BUSINESS SERVICES,MISCELLANEOUS,100,MANHATTAN,HO-0214,1316,0,0,0,0,0,0,0,0,0,0,0,0,0,0,0,0,0,0,0,0,0,0,0,0,PROJECT DELAYED DUE TO CHANGES IN SCOPE/DESIGN,,BELLEVUE,cpd11-20mn.pdf
SAND1102,HHC FEMA PMP BELLEVUE,801,DEPT OF SMALL BUSINESS SERVICES,MISCELLANEOUS,100,MANHATTAN,HO-0214,2296,0,0,0,0,0,0,0,0,0,0,0,0,0,0,0,0,0,0,0,0,0,0,0,0,,,BELLEVUE,cpd11-20mn.pdf
SAND1103,HHC FEMA PMP BELLEVUE,801,DEPT OF SMALL BUSINESS SERVICES,MISCELLANEOUS,100,MANHATTAN,HO-0214,678,0,0,0,0,0,0,0,0,0,0,0,0,0,0,0,0,0,0,0,0,0,0,0,0,PROJECT DELAYED DUE TO CHANGES IN SCOPE/DESIGN,,BELLEVUE,cpd11-20mn.pdf
SAND1104,HHC FEMA Bellevue Hospital Center Flood Protection Barrier,801,DEPT OF SMALL BUSINESS SERVICES,MISCELLANEOUS,100,MANHATTAN,HO-0214,314,0,0,0,0,0,0,0,0,0,0,0,0,0,0,0,0,0,0,0,0,0,0,0,0,PROJECT DELAYED DUE TO CHANGES IN SCOPE/DESIGN,,BELLEVUE,cpd11-20mn.pdf
SAND1105,HHC FEMA BELLEVUE HOSPITAL REPLACEMENT GENERATOR,801,DEPT OF SMALL BUSINESS SERVICES,MISCELLANEOUS,100,MANHATTAN,HO-0214,11228,0,0,0,0,0,0,0,0,0,0,0,0,0,0,0,0,0,0,0,0,0,0,0,0,PROJECT DELAYED DUE TO CHANGES IN SCOPE/DESIGN,,CONSTRUCTION OF A GENERATOR AT BELLEVUE,cpd11-20mn.pdf
SAND1106,HHC FEMA BELLEVUE HOSPITAL Civil Roadway,801,DEPT OF SMALL BUSINESS SERVICES,MISCELLANEOUS,100,MANHATTAN,HO-0214,3067,0,0,0,0,0,0,0,0,0,0,0,0,0,0,0,0,0,0,0,0,0,0,0,0,PROJECT DELAYED DUE TO CHANGES IN SCOPE/DESIGN,,BELLEVUE,cpd11-20mn.pdf
SAND1108,HHC FEMA BELLEVUE HOSPITAL PARKING LOT LIFTS,801,DEPT OF SMALL BUSINESS SERVICES,MISCELLANEOUS,100,MANHATTAN,HO-0214,2388,0,0,0,0,0,0,0,0,0,0,0,0,0,0,0,0,0,0,0,0,0,0,0,0,PROJECT DELAYED DUE TO CHANGES IN SCOPE/DESIGN,,HHC,cpd11-20mn.pdf
SAND1110,HHC FEMA BELLEVUE (MEP/VT,801,DEPT OF SMALL BUSINESS SERVICES,MISCELLANEOUS,100,MANHATTAN,HO-0214,10877,0,0,0,0,0,0,0,0,0,0,0,0,0,0,0,0,0,0,0,0,0,0,0,0,PROJECT DELAYED DUE TO CHANGES IN SCOPE/DESIGN,,BELLEVUE,cpd11-20mn.pdf
SAND1112,HHC FEMA BELLEVUE BASEMENT GENERAL CONSTRUCTION,801,DEPT OF SMALL BUSINESS SERVICES,MISCELLANEOUS,100,MANHATTAN,HO-0214,3505,0,0,0,0,0,0,0,0,0,0,0,0,0,0,0,0,0,0,0,0,0,0,0,0,PROJECT DELAYED DUE TO CHANGES IN SCOPE/DESIGN,,BAM,cpd11-20mn.pdf
SAND1113,HHC FEMA PMP BELLEVUE EXISTING VERTICAL TRANSPORTATION,801,DEPT OF SMALL BUSINESS SERVICES,MISCELLANEOUS,100,MANHATTAN,HO-0214,20000,0,0,0,0,0,0,0,0,0,0,0,0,0,0,0,0,0,0,0,0,0,0,0,0,PROJECT DELAYED DUE TO CHANGES IN SCOPE/DESIGN,,BELLEVUE HOSPITAL VERTICAL TRANSPORTATION,cpd11-20mn.pdf
SAND3702,MHC,801,DEPT OF SMALL BUSINESS SERVICES,ROUTINE RECONSTRUCTION,111,MANHATTAN,HO-0214,3600,9,0,0,0,0,309,0,318,9,0,0,0,0,309,0,318,18,0,0,0,0,618,0,636,PROJECT DELAYED DUE TO CHANGES IN SCOPE/DESIGN,"1901 FIRST AVENUE, NEW YORK, NY 10029",RECONSTRUCTION OF METROPOLITAN HOSPITAL CENTER NECESSITATED BY HURRICANE SANDY.,cpd11-20mn.pdf
SAND3703,MHC,801,DEPT OF SMALL BUSINESS SERVICES,ROUTINE RECONSTRUCTION,111,MANHATTAN,HO-0214,5256,0,0,0,0,0,0,0,0,0,0,0,0,0,0,0,0,0,0,0,0,0,0,0,0,,"1901 FIRST AVENUE, NEW YORK, NY 10029",RECONSTRUCTION OF METROPOLITAN HOSPITAL CENTER NECESSITATED BY HURRICANE SANDY.,cpd11-20mn.pdf
SAND3705,METROPOLITAN HOSPITAL FLOOD MITIGATION SYSTEM,801,DEPT OF SMALL BUSINESS SERVICES,MISCELLANEOUS,100,MANHATTAN,HO-0214,7597,0,0,0,0,0,0,0,0,0,0,0,0,0,0,0,0,0,0,0,0,0,0,0,0,PROJECT DELAYED DUE TO CHANGES IN SCOPE/DESIGN,,METRO HOSPITAL,cpd11-20mn.pdf
SAND6701,COLER,801,DEPT OF SMALL BUSINESS SERVICES,MISCELLANEOUS,100,MANHATTAN,HO-0214,11023,0,0,0,0,0,0,0,0,0,0,0,0,0,0,0,0,0,0,0,0,0,0,0,0,PROJECT DELAYED DUE TO CHANGES IN SCOPE/DESIGN,,COLER,cpd11-20mn.pdf
SAND6702,COLER,801,DEPT OF SMALL BUSINESS SERVICES,MISCELLANEOUS,100,MANHATTAN,HO-0214,1645,0,0,0,0,0,0,0,0,0,0,0,0,0,0,0,0,0,0,0,0,0,0,0,0,PROJECT DELAYED DUE TO CHANGES IN SCOPE/DESIGN,,COLER,cpd11-20mn.pdf
SAND6703,COLER,801,DEPT OF SMALL BUSINESS SERVICES,MISCELLANEOUS,100,MANHATTAN,HO-0214,657,0,0,0,0,0,0,0,0,0,0,0,0,0,0,0,0,0,0,0,0,0,0,0,0,PROJECT DELAYED DUE TO CHANGES IN SCOPE/DESIGN,,COLER,cpd11-20mn.pdf
SAND6704,COLER,801,DEPT OF SMALL BUSINESS SERVICES,MISCELLANEOUS,100,MANHATTAN,HO-0214,918,0,0,0,0,0,0,0,0,0,0,0,0,0,0,0,0,0,0,0,0,0,0,0,0,PROJECT DELAYED DUE TO CHANGES IN SCOPE/DESIGN,,COLER,cpd11-20mn.pdf
SAND6705,COLER,801,DEPT OF SMALL BUSINESS SERVICES,MISCELLANEOUS,100,MANHATTAN,HO-0214,1474,0,0,0,0,0,0,0,0,0,0,0,0,0,0,0,0,0,0,0,0,0,0,0,0,PROJECT DELAYED DUE TO CHANGES IN SCOPE/DESIGN,,COLER,cpd11-20mn.pdf
SAND6706,COLER,801,DEPT OF SMALL BUSINESS SERVICES,MISCELLANEOUS,100,MANHATTAN,HO-0214,1107,0,0,0,0,0,0,0,0,0,0,0,0,0,0,0,0,0,0,0,0,0,0,0,0,PROJECT DELAYED DUE TO CHANGES IN SCOPE/DESIGN,,COLER,cpd11-20mn.pdf
SANDCD14,PIER 76 ELECTRICAL CONDUIT,801,DEPT OF SMALL BUSINESS SERVICES,POLICE FACILITIES,100,MANHATTAN,PO-0079,2069,0,221,0,0,0,0,0,221,0,221,0,0,0,0,0,221,0,442,0,0,0,0,0,442,PROJECT DELAYED DUE TO CHANGES IN SCOPE/DESIGN,PIER 76 ELECTRICAL CONDUIT,PIER 76 ELECTRICAL CONDUIT,cpd11-20mn.pdf
SANDCD15,PIER 36 ELECTRICAL CONDUIT,801,DEPT OF SMALL BUSINESS SERVICES,POLICE FACILITIES,100,MANHATTAN,PO-0079,894,0,96,0,0,0,0,0,96,0,96,0,0,0,0,0,96,0,192,0,0,0,0,0,192,PROJECT DELAYED DUE TO CHANGES IN SCOPE/DESIGN,,PIER36 ELECTRICAL CONDUIT,cpd11-20mn.pdf
SANDHWMO,Reconstruction of Moore Street- Hurricane Sandy,801,DEPT OF SMALL BUSINESS SERVICES,PRIMARY STREET RECONSTRUCTION,100,MANHATTAN,HW-0001M,363,0,70,0,0,0,0,0,70,0,70,0,0,0,0,0,70,0,140,0,0,0,0,0,140,PROJECT DELAYED DUE TO CHANGES IN SCOPE/DESIGN,RECONSTRUCTION OF MOORE STREET HURRICANE SANDY,RECONSTRUCTION OF MOORE STREET- HURRICANE SANDY,cpd11-20mn.pdf
SANDR2BRG,Construction of Flex Barges,801,DEPT OF SMALL BUSINESS SERVICES,RECONSTRUCTION OF FERRY TERMINAL FACILITIES,100,MANHATTAN,FA-0021,12000,225,555,2220,0,0,0,0,3000,225,555,2220,0,0,0,0,3000,450,1110,4440,0,0,0,0,6000,PROJECT DELAYED DUE TO CHANGES IN SCOPE/DESIGN,,CONSTRUCTION OF FLEX BARGES,cpd11-20mn.pdf
SANDRLE34,FA Resiliency - Land Hardening E 34 street,801,DEPT OF SMALL BUSINESS SERVICES,MISCELLANEOUS,100,MANHATTAN,FA-0027,1000,20,25,205,0,0,0,0,250,20,25,205,0,0,0,0,250,40,50,410,0,0,0,0,500,PROJECT DELAYED DUE TO CHANGES IN SCOPE/DESIGN,,FA RESILIENCY - LAND HARDENING E 34 STREET,cpd11-20mn.pdf
SANDTGI,Governors Island Hurricane Sandy Repairs,801,DEPT OF SMALL BUSINESS SERVICES,MISCELLANEOUS,100 101,MANHATTAN,ED-0831,3360,0,115,0,0,0,0,0,115,0,115,0,0,0,0,0,115,0,230,0,0,0,0,0,230,,,CAPITAL PROJECTS EMERGENCY WORK AS A RESULT OF HURRICANE SANDY,cpd11-20mn.pdf
SANDTGIBS,Governors Island - Hurricane Sandy Building 110 Restoration,801,DEPT OF SMALL BUSINESS SERVICES,MISCELLANEOUS,100 101,MANHATTAN,ED-0075,2508,0,0,0,0,0,0,0,0,0,0,0,0,0,0,0,0,0,0,0,0,0,0,0,0,,,TGI HURRICANE SANDY BUILDING STABILIZATION REPAIRS,cpd11-20mn.pdf
SANDTGIEL,Governors Island - Hurricane Sandy Electrical Repairs,801,DEPT OF SMALL BUSINESS SERVICES,MISCELLANEOUS,100 101,MANHATTAN,ED-0075,6103,0,0,0,0,0,0,0,0,0,0,0,0,0,0,0,0,0,0,0,0,0,0,0,0,,,TGI HURRICANE SANDY ELECTRICAL REPAIRS,cpd11-20mn.pdf
SANDY3-01,HIghline M&O Facility Sandy Repairs,801,DEPT OF SMALL BUSINESS SERVICES,MISCELLANEOUS,100 102 104,MANHATTAN,P-1018,1119,105,0,0,0,8,0,0,113,105,0,0,0,8,0,0,113,210,0,0,0,16,0,0,226,PROJECT DELAYED DUE TO CHANGES IN SCOPE/DESIGN,,HAZARD MITIGATION WORK TO RELOCATE THE MAINTENANCE & OPERATIONS FACILITY'S ELECTRICAL,cpd11-20mn.pdf
SBSRELOCA,SBS FY18 Relocation to 1 Liberty Plaza,801,DEPT OF SMALL BUSINESS SERVICES,MISCELLANEOUS,100,MANHATTAN,ED-0075,20013,17348,3963,0,0,0,0,0,21311,17348,3963,0,0,0,0,0,21311,34696,7926,0,0,0,0,0,42622,PROJECT DELAYED DUE TO CHANGES IN SCOPE/DESIGN,,DESIGN AND CONSTRUCTION COSTS FOR SBS MOVE TO 1 LIBERTY PLAZA,cpd11-20mn.pdf
SKYPORT,Skyport Garage and Marina Rehabilitation,801,DEPT OF SMALL BUSINESS SERVICES,MISCELLANEOUS,100 106,MANHATTAN,ED-0409,5000,1132,0,0,3868,0,0,0,5000,1132,0,0,3868,0,0,0,5000,2264,0,0,7736,0,0,0,10000,PROJECT DELAYED DUE TO CHANGES IN SCOPE/DESIGN,,SKYPORT GARAGE AND MARINA REHABILITATION,cpd11-20mn.pdf
SOLAR2,CEC Stuyvesant Cove Inc.-Construction of Solar 2,801,DEPT OF SMALL BUSINESS SERVICES,WATERFRONT DEVELOPMENT,100 106,MANHATTAN,ED-D401 ED-D075 PW-0077 ED-M075 ED-0075,1500,1273,6,0,1406,0,2944,0,5629,1273,6,0,1406,0,2944,0,5629,2546,12,0,2812,0,5888,0,11258,PROJECT DELAYED DUE TO CHANGES IN SCOPE/DESIGN,,CEC STUYVESANT COVE INC.-CONSTRUCTION OF SOLAR 2,cpd11-20mn.pdf
SSRECON,South Street Reconstruction,801,DEPT OF SMALL BUSINESS SERVICES,MISCELLANEOUS,100 101,MANHATTAN,HW-0001M,8400,0,0,0,0,0,0,0,0,0,0,0,0,0,0,0,0,0,0,0,0,0,0,0,0,PROJECT DELAYED DUE TO CHANGES IN SCOPE/DESIGN,,SOUTH STREET PEDESTRIAN STREETSCAPE IMPROVEMENTS,cpd11-20mn.pdf
SSSPIER16,South Street Seaport - Pier 16 Rehab,801,DEPT OF SMALL BUSINESS SERVICES,WATERFRONT DEVELOPMENT,101,MANHATTAN,ED-0409,1700,1634,0,0,0,0,60,0,1694,1634,0,0,0,0,60,0,1694,3268,0,0,0,0,120,0,3388,PROJECT DELAYED DUE TO CHANGES IN SCOPE/DESIGN,,REHAB OF PIER 16 AND MARGINAL WHARF,cpd11-20mn.pdf
STUYBULK2,Stuyvesant Cove Park Bulkhead Park Repair,801,DEPT OF SMALL BUSINESS SERVICES,WATERFRONT DEVELOPMENT,106,MANHATTAN,ED-0409,654,146,508,0,0,0,0,0,654,146,508,0,0,0,0,0,654,292,1016,0,0,0,0,0,1308,,,"STUYVESANT COVE PARK, 18TH TO 23RD STREETS ALONG THE EAST RIVER",cpd11-20mn.pdf
TINMARKET,New Market Tin Building Demolition,801,DEPT OF SMALL BUSINESS SERVICES,MISCELLANEOUS,100,MANHATTAN,ED-0409,4331,768,5563,0,0,0,2000,0,8331,768,5563,0,0,0,2000,0,8331,1536,11126,0,0,0,4000,0,16662,PROJECT DELAYED DUE TO CHANGES IN SCOPE/DESIGN,,NEW MARKET TIN BUILDING DEMOLITION,cpd11-20mn.pdf
W125TRANS,West 125th Street/Manhattanville,801,DEPT OF SMALL BUSINESS SERVICES,COMMERCIAL DEVELOPMENT,100 109,MANHATTAN,ED-0384 ED-0075,32978,8474,1794,0,0,0,0,0,10268,8474,1794,0,0,0,0,0,10268,16948,3588,0,0,0,0,0,20536,PROJECT DELAYED DUE TO CHANGES IN SCOPE/DESIGN,,WEST 125TH STREET/MANHATTANVILLE,cpd11-20mn.pdf
WATERSIDE,WATERSIDE PIER & STUYVESANT COVE AMENITIES,801,DEPT OF SMALL BUSINESS SERVICES,MISCELLANEOUS,100,MANHATTAN,ED-D401,1050,0,0,0,0,0,50,0,50,0,0,0,0,0,50,0,50,0,0,0,0,0,100,0,100,PROJECT DELAYED DUE TO CHANGES IN SCOPE/DESIGN,,WATERSIDE PIER & STUYVESANT COVE AMENITIES--FUNDING WILL SUPPORT AMENITIES AT,cpd11-20mn.pdf
WATERST,Water Street Corridor Streetscape Improvements,801,DEPT OF SMALL BUSINESS SERVICES,MISCELLANEOUS,100,MANHATTAN,ED-0075 HW-0001M,10000,2025,203,0,0,0,0,0,2228,2025,203,0,0,0,0,0,2228,4050,406,0,0,0,0,0,4456,,,WATER STREET CORRIDOR STREETSCAPE IMPROVEMENTS,cpd11-20mn.pdf
WHARLMPK,West Harlem Piers Park,801,DEPT OF SMALL BUSINESS SERVICES,MISCELLANEOUS,100,MANHATTAN,ED-0409 P-D018,1162,0,0,0,0,1162,0,0,1162,0,0,0,0,1162,0,0,1162,0,0,0,0,2324,0,0,2324,PROJECT DELAYED DUE TO CHANGES IN SCOPE/DESIGN,,REPAIRS TO VARIOUS ASPECTS OF THE PARK,cpd11-20mn.pdf
WHITEHALL,"Whitehall Terminal Reconstruction, Manhattan",801,DEPT OF SMALL BUSINESS SERVICES,PORT DEVELOPMENT,101,MANHATTAN,ED-0405,261670,174934,0,0,0,0,0,0,174934,174934,0,0,0,0,0,0,174934,349868,0,0,0,0,0,0,349868,PROJECT DELAYED DUE TO CHANGES IN SCOPE/DESIGN,"WHITEHALL TERMINAL AND PETER MINUIT PLAZA - PETER MINUIT PLACE, STATESTREET, WHITEHALL","CONSTRUCTION OF A NEW PERMANENT FACILITY - WHITEHALL TERMINAL, THE MANTERMINUS OF THE",cpd11-20mn.pdf
WL34STHL,EAST 34TH STREET HELIPORT SUBSTRUCTURE,801,DEPT OF SMALL BUSINESS SERVICES,MISCELLANEOUS,100,MANHATTAN,ED-0409,4057,0,811,1623,1623,0,0,0,4057,0,811,1623,1623,0,0,0,4057,0,1622,3246,3246,0,0,0,8114,,,EAST 34TH STREET HELIPORT SUBSTRUCTURE,cpd11-20mn.pdf
WLWCLBWF,WATER CLUB WHARF,801,DEPT OF SMALL BUSINESS SERVICES,MISCELLANEOUS,100,MANHATTAN,ED-0409,4000,0,800,1600,1600,0,0,0,4000,0,800,1600,1600,0,0,0,4000,0,1600,3200,3200,0,0,0,8000,,,WATER CLUB WHARF,cpd11-20mn.pdf
HAM02USCC,(WHITE) UNION SETTLEMENT ASSOC. - COMM. CTR. RENOVATION,806,HOUSING PRESERVATION AND DEVEL,LOW TO MODERATE INCOME PUBLIC HOUSING UPGRADE,100 111,MANHATTAN,HA-0001 HA-D001,1008,2461,764,0,0,0,0,0,3225,2461,764,0,0,0,0,0,3225,4922,1528,0,0,0,0,0,6450,PROJECT DELAYED DUE TO BUDGETARY CONSTRAINTS,,"CREATION OF ADDITIONAL CLASSROOMS, PROGRAM SPACE AND RECONFIGURATION OF LOBBY TO",cpd11-20mn.pdf
HAM06MHEL,Manhattanville Houses Elevators,806,HOUSING PRESERVATION AND DEVEL,LOW TO MODERATE INCOME PUBLIC HOUSING UPGRADE,109,MANHATTAN,HA-0001,2970,2230,267,0,0,0,0,0,2497,2230,267,0,0,0,0,0,2497,4460,534,0,0,0,0,0,4994,PROJECT DELAYED DUE TO CHANGES IN SCOPE/DESIGN,,UPGRADING OF ELEVATORS AT MANHATTANVILLE HOUSES,cpd11-20mn.pdf
HAM07CIDC,CITIZENS CARE DAY CARE - PLAYGROUND EQUIPMENT AND MATTING,806,HOUSING PRESERVATION AND DEVEL,LOW TO MODERATE INCOME PUBLIC HOUSING UPGRADE,110,MANHATTAN,HA-D001,36,0,36,0,0,0,0,0,36,0,36,0,0,0,0,0,36,0,72,0,0,0,0,0,72,PROJECT DELAYED DUE TO CHANGES IN SCOPE/DESIGN,,PLAYGROUND EQUIPMENT AND MATTING,cpd11-20mn.pdf
HAM08HSST,HENRY STREET SETTLEMENT - GOOD COMPANIONS SR CTR RENOVATIONS,806,HOUSING PRESERVATION AND DEVEL,LOW TO MODERATE INCOME PUBLIC HOUSING UPGRADE,103,MANHATTAN,HA-M001,750,2099,51,0,0,0,0,0,2150,2099,51,0,0,0,0,0,2150,4198,102,0,0,0,0,0,4300,PROJECT DELAYED DUE TO CHANGES IN SCOPE/DESIGN,,RENOVATION OF THE HENRY STREET SETTLEMENT,cpd11-20mn.pdf
HAM08RUHI,RUTGERS HOUSES ENERGY INITIATIVES,806,HOUSING PRESERVATION AND DEVEL,LOW TO MODERATE INCOME PUBLIC HOUSING UPGRADE,103,MANHATTAN,HA-0001,7790,4875,275,0,0,0,0,0,5150,4875,275,0,0,0,0,0,5150,9750,550,0,0,0,0,0,10300,PROJECT DELAYED DUE TO CHANGES IN SCOPE/DESIGN,,RUTGERS HOUSES HEATING UPGRADES,cpd11-20mn.pdf
HAM09FWSR,"FT WASHINGTON SER FOR THE ELDERLY OFFICES, CLASSRM, COMP RM",806,HOUSING PRESERVATION AND DEVEL,LOW TO MODERATE INCOME PUBLIC HOUSING UPGRADE,112,MANHATTAN,HA-D001,200,133,67,0,0,0,0,0,200,133,67,0,0,0,0,0,200,266,134,0,0,0,0,0,400,PROJECT DELAYED DUE TO CHANGES IN SCOPE/DESIGN,,"RENOVATE CASEWORK OFFICES AND PROGRAM ROOMS TO CREATE MORE OFFICES, PROGRAM SPACE",cpd11-20mn.pdf
HAM11VLFA,"VLADECK HOUSES- GOOD COMPANIONS/HENRY ST, FIRE ALARM SYSTEM",806,HOUSING PRESERVATION AND DEVEL,LOW TO MODERATE INCOME PUBLIC HOUSING UPGRADE,103,MANHATTAN,HA-D001,250,36,214,0,0,0,0,0,250,36,214,0,0,0,0,0,250,72,428,0,0,0,0,0,500,PROJECT DELAYED DUE TO CHANGES IN SCOPE/DESIGN,,INSTALL A FIRE ALARM SYSTEM AT GOOD COMPANIONS/ HENRY STREET SETTLEMENT,cpd11-20mn.pdf
HAM13CLEV,CLINTON HOUSES ELEVATOR REHABILITATION,806,HOUSING PRESERVATION AND DEVEL,LOW TO MODERATE INCOME PUBLIC HOUSING UPGRADE,111,MANHATTAN,HA-0001,5610,4452,648,0,0,0,0,0,5100,4452,648,0,0,0,0,0,5100,8904,1296,0,0,0,0,0,10200,PROJECT DELAYED DUE TO CHANGES IN SCOPE/DESIGN,,ELEVATOR REHABILITATION,cpd11-20mn.pdf
HAM13HTET,HOLMES TOWER ENTRANCES AND LAYERED ACCESS CONTROLS,806,HOUSING PRESERVATION AND DEVEL,LOW TO MODERATE INCOME PUBLIC HOUSING UPGRADE,108,MANHATTAN,HA-D001,418,321,97,0,0,0,0,0,418,321,97,0,0,0,0,0,418,642,194,0,0,0,0,0,836,PROJECT DELAYED DUE TO BUDGETARY CONSTRAINTS,,NEW ENTRANCES AND LAYERED ACCESS CONTROLS,cpd11-20mn.pdf
HAM14MNSE,METRO NORTH PLAZA SECURITY UPGRADES,806,HOUSING PRESERVATION AND DEVEL,LOW TO MODERATE INCOME PUBLIC HOUSING UPGRADE,111,MANHATTAN,HA-D001,100,0,250,0,0,0,0,0,250,0,250,0,0,0,0,0,250,0,500,0,0,0,0,0,500,PROJECT DELAYED DUE TO CHANGES IN SCOPE/DESIGN,,SECURITY UPGRADES,cpd11-20mn.pdf
HAM15ICNB,STANLEY ISAACS UPGRADE OF SENIOR AND YOUTH CENTER COMP. UPGR,806,HOUSING PRESERVATION AND DEVEL,LOW TO MODERATE INCOME PUBLIC HOUSING UPGRADE,108,MANHATTAN,HA-D001,680,1791,211,0,0,0,0,0,2002,1791,211,0,0,0,0,0,2002,3582,422,0,0,0,0,0,4004,PROJECT DELAYED DUE TO CHANGES IN SCOPE/DESIGN,,SENIOR AND YOUTH CENTER UPGRADES,cpd11-20mn.pdf
HAM15JFSR,JEFFERSON SENIOR CENTER UPGRADE,806,HOUSING PRESERVATION AND DEVEL,DEPARTMENT FOR THE AGING BUILDING RECONSTRUCTION,111,MANHATTAN,HA-D001,450,985,86,0,0,0,0,0,1071,985,86,0,0,0,0,0,1071,1970,172,0,0,0,0,0,2142,PROJECT DELAYED DUE TO CHANGES IN SCOPE/DESIGN,,UPGRADE SENIOR CENTER,cpd11-20mn.pdf
HAM15MOGD,METRO NORTH PLAZA DAY CARE CENTER PLAYGROUND RENOVATION,806,HOUSING PRESERVATION AND DEVEL,LOW TO MODERATE INCOME PUBLIC HOUSING UPGRADE,111,MANHATTAN,HA-D001,200,0,500,0,0,0,0,0,500,0,500,0,0,0,0,0,500,0,1000,0,0,0,0,0,1000,PROJECT DELAYED DUE TO CHANGES IN SCOPE/DESIGN,,DAY CARE CENTER RENOVATION,cpd11-20mn.pdf
HAM15WSPL,WASHINGTON HOUSES DAY CARE CENTER PLAYGROUND UPGRADE,806,HOUSING PRESERVATION AND DEVEL,LOW TO MODERATE INCOME PUBLIC HOUSING UPGRADE,111,MANHATTAN,HA-D001,200,220,37,0,0,0,0,0,257,220,37,0,0,0,0,0,257,440,74,0,0,0,0,0,514,PROJECT DELAYED DUE TO CHANGES IN SCOPE/DESIGN,,DAY CARE CENTER PLAYGROUND UPGRADE,cpd11-20mn.pdf
HAM16AMBL,AMSTERDAM HOUSES BARRELS PLAYGROUND RENO,806,HOUSING PRESERVATION AND DEVEL,LOW TO MODERATE INCOME PUBLIC HOUSING UPGRADE,107,MANHATTAN,HA-D001,500,0,500,0,0,0,0,0,500,0,500,0,0,0,0,0,500,0,1000,0,0,0,0,0,1000,PROJECT DELAYED DUE TO CHANGES IN SCOPE/DESIGN,,BARRELS PLAYGROUND RENO,cpd11-20mn.pdf
HAM16AMUP,AMSTERDAM HOUSES NYCHA-UPGRADES,806,HOUSING PRESERVATION AND DEVEL,LOW TO MODERATE INCOME PUBLIC HOUSING UPGRADE,107,MANHATTAN,HA-D001,50,0,50,0,0,0,0,0,50,0,50,0,0,0,0,0,50,0,100,0,0,0,0,0,100,PROJECT DELAYED DUE TO BUDGETARY CONSTRAINTS,,AMSTERDAM HOUSES NYCHA-UPGRADES,cpd11-20mn.pdf
HAM16CRCC,CORSI HOUSES UPGRADES TO LAGUARDIA COMMUNITY CENTER,806,HOUSING PRESERVATION AND DEVEL,LOW TO MODERATE INCOME PUBLIC HOUSING UPGRADE,111,MANHATTAN,HA-D001 HA-0001,1000,0,4068,0,0,0,0,0,4068,0,4068,0,0,0,0,0,4068,0,8136,0,0,0,0,0,8136,PROJECT DELAYED DUE TO CHANGES IN SCOPE/DESIGN,,CORSI HOUSES UPGRADES TO LAGUARDIA COMMUNITY CENTER,cpd11-20mn.pdf
HAM16GHPL,GRANT HOUSES MAJOR PLAYGROUND RENOVATIONS-PLAYGROUND REPAIRS,806,HOUSING PRESERVATION AND DEVEL,LOW TO MODERATE INCOME PUBLIC HOUSING UPGRADE,109,MANHATTAN,HA-D001,450,413,37,0,0,0,0,0,450,413,37,0,0,0,0,0,450,826,74,0,0,0,0,0,900,PROJECT DELAYED DUE TO CHANGES IN SCOPE/DESIGN,,MAJOR PLAYGROUND RENOVATIONS-PLAYGROUND REPAIRS,cpd11-20mn.pdf
HAM16LGSC,282 CHERRY STREET SECURITY CAMERAS,806,HOUSING PRESERVATION AND DEVEL,LOW TO MODERATE INCOME PUBLIC HOUSING UPGRADE,103,MANHATTAN,HA-D001,70,0,170,0,0,0,0,0,170,0,170,0,0,0,0,0,170,0,340,0,0,0,0,0,340,PROJECT DELAYED DUE TO CHANGES IN SCOPE/DESIGN,,282 CHERRY STREET SECURITY CAMERAS,cpd11-20mn.pdf
HAM16LXCG,LEXINGTON HOUSES GROUND UPGRADE COMMUNITY GARDEN,806,HOUSING PRESERVATION AND DEVEL,LOW TO MODERATE INCOME PUBLIC HOUSING UPGRADE,111,MANHATTAN,HA-D001,385,315,70,0,0,0,0,0,385,315,70,0,0,0,0,0,385,630,140,0,0,0,0,0,770,PROJECT DELAYED DUE TO CHANGES IN SCOPE/DESIGN,,GROUNDS UPGRADE-COMMUNITY GARDEN,cpd11-20mn.pdf
HAM16UPGI,UNDERGROUND WATER AND FIRE DISTRIBUTION PIPING,806,HOUSING PRESERVATION AND DEVEL,LOW TO MODERATE INCOME PUBLIC HOUSING UPGRADE,100,MANHATTAN,HA-D001,8000,5207,2793,0,0,0,0,0,8000,5207,2793,0,0,0,0,0,8000,10414,5586,0,0,0,0,0,16000,,,REPLACEMENT OF UNDERGROUND WATER AND FIRE DISTRIBUTION PIPING.,cpd11-20mn.pdf
HAM16WRSC,WISE REHAB 54 W. 94TH STREET SECURITY CAMERAS,806,HOUSING PRESERVATION AND DEVEL,LOW TO MODERATE INCOME PUBLIC HOUSING UPGRADE,107,MANHATTAN,HA-D001,75,0,125,0,0,0,0,0,125,0,125,0,0,0,0,0,125,0,250,0,0,0,0,0,250,PROJECT DELAYED DUE TO CHANGES IN SCOPE/DESIGN,,WISE REHAB 54 W. 94TH STREET SECURITY CAMERAS,cpd11-20mn.pdf
HAM17CRGR,CORSI HOUSES SITTING AREA FOR SENIORS,806,HOUSING PRESERVATION AND DEVEL,LOW TO MODERATE INCOME PUBLIC HOUSING UPGRADE,111,MANHATTAN,HA-D001,300,403,47,0,0,0,0,0,450,403,47,0,0,0,0,0,450,806,94,0,0,0,0,0,900,PROJECT DELAYED DUE TO CHANGES IN SCOPE/DESIGN,,RENOVATE GROUNDS TO PROVIDE A SITTING AREA FOR SENIORS,cpd11-20mn.pdf
HAM17HRPL,HERNANDEZ PLAYGROUND RENOVATION AY 189 ALLEN STREET,806,HOUSING PRESERVATION AND DEVEL,LOW TO MODERATE INCOME PUBLIC HOUSING UPGRADE,103,MANHATTAN,HA-D001 HA-M001,165,984,353,0,0,0,0,0,1337,984,353,0,0,0,0,0,1337,1968,706,0,0,0,0,0,2674,PROJECT DELAYED DUE TO CHANGES IN SCOPE/DESIGN,,PLAYGROUND RENOVATION,cpd11-20mn.pdf
HAM18DIGV,DIGITAL VAN,806,HOUSING PRESERVATION AND DEVEL,LOW TO MODERATE INCOME PUBLIC HOUSING UPGRADE,100,MANHATTAN,HA-D001,150,0,150,0,0,0,0,0,150,0,150,0,0,0,0,0,150,0,300,0,0,0,0,0,300,,,DIGITAL VAN,cpd11-20mn.pdf
HAM18ECGR,GROUNDS RENOVATION AT ELLIOT - CHELSEA HOUSES,806,HOUSING PRESERVATION AND DEVEL,LOW TO MODERATE INCOME PUBLIC HOUSING UPGRADE,104,MANHATTAN,HA-D001,500,124,376,0,0,0,0,0,500,124,376,0,0,0,0,0,500,248,752,0,0,0,0,0,1000,,,GROUNDS RENOVATION,cpd11-20mn.pdf
HAM18GOBR,GOMPERS BOILER REPAIR,806,HOUSING PRESERVATION AND DEVEL,LOW TO MODERATE INCOME PUBLIC HOUSING UPGRADE,100,MANHATTAN,HA-0001,2500,0,2500,0,0,0,0,0,2500,0,2500,0,0,0,0,0,2500,0,5000,0,0,0,0,0,5000,,,GOMPERS BOILER REPAIR,cpd11-20mn.pdf
HAM18GRLM,GRANT HOUSES LAUNDROMAT RENOVATION,806,HOUSING PRESERVATION AND DEVEL,LOW TO MODERATE INCOME PUBLIC HOUSING UPGRADE,109,MANHATTAN,HA-M001 HA-D001,1100,0,1845,0,0,0,0,0,1845,0,1845,0,0,0,0,0,1845,0,3690,0,0,0,0,0,3690,,,GRANT HOUSES LAUNDROMAT RENOVATION,cpd11-20mn.pdf
HAM18JOCC,JOHNSON COMM. CTR. STANLEY ISACCS NBRHD ROOF GLASS PANES,806,HOUSING PRESERVATION AND DEVEL,LOW TO MODERATE INCOME PUBLIC HOUSING UPGRADE,111,MANHATTAN,HA-D001,626,0,877,0,0,0,0,0,877,0,877,0,0,0,0,0,877,0,1754,0,0,0,0,0,1754,,,JOHNSON COMM. CTR. STANLEY ISACCS NBRHD ROOF GLASS PANES & SURFACES,cpd11-20mn.pdf
HAM18LIPG,RENOVATION OF A PLAYGROUND AT LOWER EAST SIDE I INFILL,806,HOUSING PRESERVATION AND DEVEL,LOW TO MODERATE INCOME PUBLIC HOUSING UPGRADE,103,MANHATTAN,HA-D001,266,0,266,0,0,0,0,0,266,0,266,0,0,0,0,0,266,0,532,0,0,0,0,0,532,,,RENOVATION OF A PLAYGROUND AT LOWER EAST SIDE I INFILL,cpd11-20mn.pdf
HAM18URBF,URBAN FARMS,806,HOUSING PRESERVATION AND DEVEL,LOW TO MODERATE INCOME PUBLIC HOUSING UPGRADE,100,MANHATTAN,HA-D001,120,0,120,0,0,0,0,0,120,0,120,0,0,0,0,0,120,0,240,0,0,0,0,0,240,,,URBAN FARMS,cpd11-20mn.pdf
HAM18VLPG,VLADECK HOUSES PLAYGROUND UPGRADE,806,HOUSING PRESERVATION AND DEVEL,LOW TO MODERATE INCOME PUBLIC HOUSING UPGRADE,103,MANHATTAN,HA-M001,500,498,202,0,0,0,0,0,700,498,202,0,0,0,0,0,700,996,404,0,0,0,0,0,1400,,,VLADECK HOUSES PLAYGROUND. MADISON STREET BET. JACKSON AND GOUVERNEURSTREETS,cpd11-20mn.pdf
HAM18WAGD,WASHINGTON HOUSES MAKE PLAYGROUND ADA ACCESSIBLE,806,HOUSING PRESERVATION AND DEVEL,LOW TO MODERATE INCOME PUBLIC HOUSING UPGRADE,111,MANHATTAN,HA-D001,500,665,800,0,0,0,0,0,1465,665,800,0,0,0,0,0,1465,1330,1600,0,0,0,0,0,2930,,,MAKE PLAYGROUND ADA ACCESSIBLE,cpd11-20mn.pdf
HAM19AMEL,AMSTERDAM HOUSES ELEVATOR UPGRADE,806,HOUSING PRESERVATION AND DEVEL,LOW TO MODERATE INCOME PUBLIC HOUSING UPGRADE,107,MANHATTAN,HA-0001,12392,0,765,10500,0,0,0,0,11265,0,765,10500,0,0,0,0,11265,0,1530,21000,0,0,0,0,22530,,,UPGRADE ELEVATORS AT AMSTERDAM HOUSES,cpd11-20mn.pdf
HAM19DCCR,DYCKMAN HOUSES COMMUNITY CENTER RAMP,806,HOUSING PRESERVATION AND DEVEL,LOW TO MODERATE INCOME PUBLIC HOUSING UPGRADE,112,MANHATTAN,HA-D001,300,0,300,0,0,0,0,0,300,0,300,0,0,0,0,0,300,0,600,0,0,0,0,0,600,,,FUNDING FOR COMMUNITY CENTER RAMP,cpd11-20mn.pdf
HAM19DHPR,DYCKMAN HOUSES PLAYGROUND RENOVATION,806,HOUSING PRESERVATION AND DEVEL,LOW TO MODERATE INCOME PUBLIC HOUSING UPGRADE,112,MANHATTAN,HA-D001,500,0,500,0,0,0,0,0,500,0,500,0,0,0,0,0,500,0,1000,0,0,0,0,0,1000,,,FUNDING FOR DYCKMAN HOUSES PLAYGROUND RENOVATION,cpd11-20mn.pdf
HAM19ECSC,ELLIOTT-CHELSEA HOUSES SECURITY CAMERAS,806,HOUSING PRESERVATION AND DEVEL,LOW TO MODERATE INCOME PUBLIC HOUSING UPGRADE,104,MANHATTAN,HA-D001,250,0,250,0,0,0,0,0,250,0,250,0,0,0,0,0,250,0,500,0,0,0,0,0,500,,,ELLIOTT SECURITY CAMERAS,cpd11-20mn.pdf
HAM19FHSC,FULTON HOUSES SECURITY CAMERAS,806,HOUSING PRESERVATION AND DEVEL,LOW TO MODERATE INCOME PUBLIC HOUSING UPGRADE,104,MANHATTAN,HA-D001,250,0,250,0,0,0,0,0,250,0,250,0,0,0,0,0,250,0,500,0,0,0,0,0,500,,,SECURITY CAMERAS,cpd11-20mn.pdf
HAM19GHEL,GRANT HOUSES EXTERNAL LIGHTING UPGRADES,806,HOUSING PRESERVATION AND DEVEL,LOW TO MODERATE INCOME PUBLIC HOUSING UPGRADE,109,MANHATTAN,HA-D001,500,0,500,0,0,0,0,0,500,0,500,0,0,0,0,0,500,0,1000,0,0,0,0,0,1000,,,EXTERNAL LIGHTING UPGRADES,cpd11-20mn.pdf
HAM19HBBR,HARBORVIEW COMMUNITY/SENIOR CENTER BATHROOM RENOVATIONS,806,HOUSING PRESERVATION AND DEVEL,LOW TO MODERATE INCOME PUBLIC HOUSING UPGRADE,111,MANHATTAN,HA-0001,235,182,53,0,0,0,0,0,235,182,53,0,0,0,0,0,235,364,106,0,0,0,0,0,470,,,RENOVATION OF BATHROOMS IN COMMUNITY/SENIOR CENTER AT HARVORVIEW HOUSES,cpd11-20mn.pdf
HAM19RCCK,RUTGERS COMMUNITY CENTER KITCHEN RENOVATION,806,HOUSING PRESERVATION AND DEVEL,LOW TO MODERATE INCOME PUBLIC HOUSING UPGRADE,103,MANHATTAN,HA-D001,120,0,120,0,0,0,0,0,120,0,120,0,0,0,0,0,120,0,240,0,0,0,0,0,240,,,"COMMUNITY CENTER KITCHENETTE, INCLUDING A NEW STOVE AND GAS LINES",cpd11-20mn.pdf
HAM19RLTV,RANGEL HOUSES SAFE GROUNDS SECURITY INITIATIVE - CCTV,806,HOUSING PRESERVATION AND DEVEL,LOW TO MODERATE INCOME PUBLIC HOUSING UPGRADE,100,MANHATTAN,HA-M001,200,0,200,0,0,0,0,0,200,0,200,0,0,0,0,0,200,0,400,0,0,0,0,0,400,,,RANGEL HOUSES CCTV,cpd11-20mn.pdf
HAM19STEL,ST NICHOLAS HOUSES ELEVATOR UPGRADE,806,HOUSING PRESERVATION AND DEVEL,LOW TO MODERATE INCOME PUBLIC HOUSING UPGRADE,110,MANHATTAN,HA-0001,10973,0,9783,0,0,0,0,0,9783,0,9783,0,0,0,0,0,9783,0,19566,0,0,0,0,0,19566,,,UPGRADE ELEVATORS AT ST . NICHOLAS HOUSES,cpd11-20mn.pdf
HAM19VLPR,VLADECK HOUSES,806,HOUSING PRESERVATION AND DEVEL,LOW TO MODERATE INCOME PUBLIC HOUSING UPGRADE,103,MANHATTAN,HA-M001 HA-D001,600,0,600,0,0,0,0,0,600,0,600,0,0,0,0,0,600,0,1200,0,0,0,0,0,1200,,,VLADECK HOUSES,cpd11-20mn.pdf
HAM19WTOC,WISE HOUSES OUTDOOR PLAZA CAMERAS,806,HOUSING PRESERVATION AND DEVEL,LOW TO MODERATE INCOME PUBLIC HOUSING UPGRADE,107,MANHATTAN,HA-D001,275,0,275,0,0,0,0,0,275,0,275,0,0,0,0,0,275,0,550,0,0,0,0,0,550,,,OUTDOOR PLAZA CAMERAS,cpd11-20mn.pdf
HAM20BHNE,BARUCH HOUSES NEW ELEVATOR,806,HOUSING PRESERVATION AND DEVEL,LOW TO MODERATE INCOME PUBLIC HOUSING UPGRADE,103,MANHATTAN,HA-D001,1000,0,1000,0,0,0,0,0,1000,0,1000,0,0,0,0,0,1000,0,2000,0,0,0,0,0,2000,,,NEW ELEVATOR AT 72 COLUMBIA-BARUCH,cpd11-20mn.pdf
HAM20CHHT,HEATING UPGRADES- CHELSEA HOUSES,806,HOUSING PRESERVATION AND DEVEL,LOW TO MODERATE INCOME PUBLIC HOUSING UPGRADE,104,MANHATTAN,HA-D001,920,0,920,0,0,0,0,0,920,0,920,0,0,0,0,0,920,0,1840,0,0,0,0,0,1840,,,NYCHA - CHELSEA -- BURNERS AND CONTROLS ON 2 BOILERS,cpd11-20mn.pdf
HAM20CSKR,CARVER HOUSES KITCHEN RENOVATION IN SENIOR CENTER,806,HOUSING PRESERVATION AND DEVEL,LOW TO MODERATE INCOME PUBLIC HOUSING UPGRADE,111,MANHATTAN,HA-D001,500,0,500,0,0,0,0,0,500,0,500,0,0,0,0,0,500,0,1000,0,0,0,0,0,1000,,,KITCHEN RENOVATION AT SENIOR CENTER-CARVER,cpd11-20mn.pdf
HAM20CUSD,CARVER UNDERGROUND STEAM DISTRIBUTION,806,HOUSING PRESERVATION AND DEVEL,LOW TO MODERATE INCOME PUBLIC HOUSING UPGRADE,111,MANHATTAN,HA-0001,3000,0,3000,0,0,0,0,0,3000,0,3000,0,0,0,0,0,3000,0,6000,0,0,0,0,0,6000,,,CARVER UNDERGROUND STEAM DISTRIBUTION,cpd11-20mn.pdf
HAM20ELHU,HEATING UPGRADES- ELLIOTT HOUSES,806,HOUSING PRESERVATION AND DEVEL,LOW TO MODERATE INCOME PUBLIC HOUSING UPGRADE,104,MANHATTAN,HA-D001,515,0,515,0,0,0,0,0,515,0,515,0,0,0,0,0,515,0,1030,0,0,0,0,0,1030,,,NYCHA - ELLIOTT -- REPLACE 5 INSTANTANEOUS HW PRODUCING SYSTEMS,cpd11-20mn.pdf
HAM20FSHL,FULTON HOUSES STAIRWAY AND HALL LIGHTING,806,HOUSING PRESERVATION AND DEVEL,LOW TO MODERATE INCOME PUBLIC HOUSING UPGRADE,104,MANHATTAN,HA-D001,464,0,464,0,0,0,0,0,464,0,464,0,0,0,0,0,464,0,928,0,0,0,0,0,928,,,NYCHA - FULTON HOUSES -- STAIRWAY AND HALL LIGHTING,cpd11-20mn.pdf
HAM20FUHU,FULTON HOUSES HEATING UPGRADES,806,HOUSING PRESERVATION AND DEVEL,LOW TO MODERATE INCOME PUBLIC HOUSING UPGRADE,104,MANHATTAN,HA-D001,1645,0,1645,0,0,0,0,0,1645,0,1645,0,0,0,0,0,1645,0,3290,0,0,0,0,0,3290,,,NYCHA - FULTON HOUSES -- INSTANTANEOUS HOT WATER HEATERS FOR 11 BUILDINGS,cpd11-20mn.pdf
HAM20GHCL,GRANT - LAUNDROMART CONSTRUCTION,806,HOUSING PRESERVATION AND DEVEL,LOW TO MODERATE INCOME PUBLIC HOUSING UPGRADE,109,MANHATTAN,HA-D001,985,0,985,0,0,0,0,0,985,0,985,0,0,0,0,0,985,0,1970,0,0,0,0,0,1970,,,NYCHA - GRANT HOUSES LAUNDROMAT -- CONSTRUCTION OF LAUNDROMAT AT GRANT HOUSES -,cpd11-20mn.pdf
HAM20JFPG,JEFFERSON HOUSES PLAYGROUND RENOVATION,806,HOUSING PRESERVATION AND DEVEL,LOW TO MODERATE INCOME PUBLIC HOUSING CONSTRUCTION,111,MANHATTAN,HA-0001,330,0,2190,0,0,0,0,0,2190,0,2190,0,0,0,0,0,2190,0,4380,0,0,0,0,0,4380,,,RENOVATE PLAYGROUND AT JEFFERSON HOUSES,cpd11-20mn.pdf
HAM20LESD,LES INFILL 1 NEW LAYERED ACCESS DOORS,806,HOUSING PRESERVATION AND DEVEL,LOW TO MODERATE INCOME PUBLIC HOUSING UPGRADE,103,MANHATTAN,HA-D001,675,0,675,0,0,0,0,0,675,0,675,0,0,0,0,0,675,0,1350,0,0,0,0,0,1350,,,NYCHA LOWER EAST SIDE INFILL I LAYERED ACCESS DOORS -- TO FUND NEW LAYERED ACCESS DOORS,cpd11-20mn.pdf
HAM20SGCU,STRAUS HOUSES GARBAGE COMPACTOR,806,HOUSING PRESERVATION AND DEVEL,LOW TO MODERATE INCOME PUBLIC HOUSING UPGRADE,106,MANHATTAN,HA-D001,100,0,100,0,0,0,0,0,100,0,100,0,0,0,0,0,100,0,200,0,0,0,0,0,200,PROJECT DELAYED DUE TO CHANGES IN SCOPE/DESIGN,,NYCHA GARBAGE COMPACTOR UPGRADES AT STRAUS HOUSES -- GARBAGE COMPACTOR UPGRADES,cpd11-20mn.pdf
HAM20SHDR,ALFRED SMITH -DOG RUN FOR 10 CATHERINE SLIP,806,HOUSING PRESERVATION AND DEVEL,LOW TO MODERATE INCOME PUBLIC HOUSING UPGRADE,103,MANHATTAN,HA-D001,500,0,500,0,0,0,0,0,500,0,500,0,0,0,0,0,500,0,1000,0,0,0,0,0,1000,,,NYCHA ALFRED E. SMITH HOUSES DOG RUN FOR 10 CATHERINE SLIP -- TO SUPPORT DOG RUN FOR 10,cpd11-20mn.pdf
HAM20SISC,STANLEY ISAACS SENIOR CENTER BATHROOM ADA UPGRADE,806,HOUSING PRESERVATION AND DEVEL,LOW TO MODERATE INCOME PUBLIC HOUSING UPGRADE,100,MANHATTAN,HA-M001,300,0,300,0,0,0,0,0,300,0,300,0,0,0,0,0,300,0,600,0,0,0,0,0,600,,,STANLEY ISAACS NEIGHBORHOOD CENTER - SENIOR CENTER BATHROOM RENOVATIONS - ADA,cpd11-20mn.pdf
HAM20SPER,SEWARD PARK EXTENSION RENOVATIONS,806,HOUSING PRESERVATION AND DEVEL,LOW TO MODERATE INCOME PUBLIC HOUSING UPGRADE,103,MANHATTAN,HA-D001,500,0,500,0,0,0,0,0,500,0,500,0,0,0,0,0,500,0,1000,0,0,0,0,0,1000,,,"SEWARD PARK EXTENSION RENOVATIONS -- RENOVATE VACANT SPACE AT 64-66 ESSEX STREET,",cpd11-20mn.pdf
HAM20TUSD,TAFT UNDERGROUND STEAM DISTRIBUTION,806,HOUSING PRESERVATION AND DEVEL,LOW TO MODERATE INCOME PUBLIC HOUSING UPGRADE,110,MANHATTAN,HA-0001,7000,0,7000,0,0,0,0,0,7000,0,7000,0,0,0,0,0,7000,0,14000,0,0,0,0,0,14000,,,TAFT UNDERGROUND STEAM DISTRIBUTION,cpd11-20mn.pdf
HAM20WSCC,WOODSON CCTV,806,HOUSING PRESERVATION AND DEVEL,LOW TO MODERATE INCOME PUBLIC HOUSING UPGRADE,111,MANHATTAN,HA-0001,858,0,858,0,0,0,0,0,858,0,858,0,0,0,0,0,858,0,1716,0,0,0,0,0,1716,,,INSTALLATION OF CCTV,cpd11-20mn.pdf
HAM20WSLP,WOODSON LIGHT POLES,806,HOUSING PRESERVATION AND DEVEL,LOW TO MODERATE INCOME PUBLIC HOUSING UPGRADE,111,MANHATTAN,HA-0001,250,0,250,0,0,0,0,0,250,0,250,0,0,0,0,0,250,0,500,0,0,0,0,0,500,,,INSTALLATION OF NEW LED FIXTURES AT LIGHT POLES AT WOODSON,cpd11-20mn.pdf
HAM21CHIC,INTERIOR COMPACTOR AT CHELSEA HOUSES,806,HOUSING PRESERVATION AND DEVEL,LOW TO MODERATE INCOME PUBLIC HOUSING UPGRADE,104,MANHATTAN,HA-D001,0,0,981,0,0,0,0,0,981,0,981,0,0,0,0,0,981,0,1962,0,0,0,0,0,1962,,,CHELSEA HOUSES-INTERIOR COMPACTOR,cpd11-20mn.pdf
HAM21CHRE,RENOVATIONS FOR CHELSEA HOUSES,806,HOUSING PRESERVATION AND DEVEL,LOW TO MODERATE INCOME PUBLIC HOUSING UPGRADE,104,MANHATTAN,HA-D001,0,0,1177,0,0,0,0,0,1177,0,1177,0,0,0,0,0,1177,0,2354,0,0,0,0,0,2354,,,CHELSEA HOUSES-FUNDING FOR RENOVATIONS,cpd11-20mn.pdf
HAM21DYEL,DYCKMAN HOUSES ELEVATOR REPLACEMENT,806,HOUSING PRESERVATION AND DEVEL,LOW TO MODERATE INCOME PUBLIC HOUSING UPGRADE,112,MANHATTAN,HA-0001,6600,0,6500,0,0,0,0,0,6500,0,6500,0,0,0,0,0,6500,0,13000,0,0,0,0,0,13000,,,REPLACE ELEVATORS AT DYCKMAN HOUSES,cpd11-20mn.pdf
HAM21EHRE,RENOVATIONS AT ELLIOT HOUSES,806,HOUSING PRESERVATION AND DEVEL,LOW TO MODERATE INCOME PUBLIC HOUSING UPGRADE,104,MANHATTAN,HA-D001,0,0,811,0,0,0,0,0,811,0,811,0,0,0,0,0,811,0,1622,0,0,0,0,0,1622,,,ELLIOT HOUSES--FUNDING FOR RENOVATIONS,cpd11-20mn.pdf
HAM21FHEC,EXTERIOR COMPACTOR AT FULTON HOUSES,806,HOUSING PRESERVATION AND DEVEL,LOW TO MODERATE INCOME PUBLIC HOUSING UPGRADE,104,MANHATTAN,HA-D001,0,0,441,0,0,0,0,0,441,0,441,0,0,0,0,0,441,0,882,0,0,0,0,0,882,,,FULTON HOUSES-EXTERIOR COMPACTOR,cpd11-20mn.pdf
HAM21GHPS,REPAIR PAVEMENT AT GRANT HOUSES,806,HOUSING PRESERVATION AND DEVEL,LOW TO MODERATE INCOME PUBLIC HOUSING UPGRADE,109,MANHATTAN,HA-D001,0,0,365,0,0,0,0,0,365,0,365,0,0,0,0,0,365,0,730,0,0,0,0,0,730,,,PB,cpd11-20mn.pdf
HAM21JHPR,PLAYGROUND RENOVATION AT JOHNSON HOUSES,806,HOUSING PRESERVATION AND DEVEL,LOW TO MODERATE INCOME PUBLIC HOUSING UPGRADE,111,MANHATTAN,HA-D001,0,0,175,0,0,0,0,0,175,0,175,0,0,0,0,0,175,0,350,0,0,0,0,0,350,,,NYCHA JOHNSON HOUSES - PLAYGROUND RENOVATION--PLAYGROUND                              RENOVATION,cpd11-20mn.pdf
HAM21MHAS,MARBLE HILL HOUSES -ADDITIONAL SEATING,806,HOUSING PRESERVATION AND DEVEL,LOW TO MODERATE INCOME PUBLIC HOUSING UPGRADE,,MANHATTAN,HA-D001,0,0,50,0,0,0,0,0,50,0,50,0,0,0,0,0,50,0,100,0,0,0,0,0,100,,,PB,cpd11-20mn.pdf
HAM21MHEL,MELTZER HERNANDEZ HOUSES ELEVATOR REPLACEMENT,806,HOUSING PRESERVATION AND DEVEL,LOW TO MODERATE INCOME PUBLIC HOUSING UPGRADE,103,MANHATTAN,HA-0001,2295,0,2400,0,0,0,0,0,2400,0,2400,0,0,0,0,0,2400,0,4800,0,0,0,0,0,4800,,,REPLACE ELEVATORS AT MELTZER HERNANDEZ,cpd11-20mn.pdf
HAM21RCCK,CC KITCHEN RENOVATION AT RUTGERS HOUSES,806,HOUSING PRESERVATION AND DEVEL,LOW TO MODERATE INCOME PUBLIC HOUSING UPGRADE,103,MANHATTAN,HA-D001,0,0,348,0,0,0,0,0,348,0,348,0,0,0,0,0,348,0,696,0,0,0,0,0,696,,,RUTGERS HOUSES COMMUNITY CENTER - KITCHEN,cpd11-20mn.pdf
HAM21SHLD,LAYERED ACCESS ENTRY FOR LOBBY DOORS AT STRAUS HOUSES,806,HOUSING PRESERVATION AND DEVEL,LOW TO MODERATE INCOME PUBLIC HOUSING UPGRADE,106,MANHATTAN,HA-D001,0,0,300,0,0,0,0,0,300,0,300,0,0,0,0,0,300,0,600,0,0,0,0,0,600,,,STRAUS HOUSES - LAYERED ACCESS ENTRY FOR LOBBY DOORS-FUNDING FOR DOORS,cpd11-20mn.pdf
HAM21SIDE,SIDEWALK REPAIRS AT LOWER EAST SIDE I INFILL,806,HOUSING PRESERVATION AND DEVEL,LOW TO MODERATE INCOME PUBLIC HOUSING UPGRADE,103,MANHATTAN,HA-D001,0,0,156,0,0,0,0,0,156,0,156,0,0,0,0,0,156,0,312,0,0,0,0,0,312,,,SIDEWALK REPAIRS IN FRONT OF 175 ELDRIDGE-TO,cpd11-20mn.pdf
HAM21SPCC,SEWARD PARK- COMMUNITY CENTER RENOVATIONS,806,HOUSING PRESERVATION AND DEVEL,LOW TO MODERATE INCOME PUBLIC HOUSING UPGRADE,103,MANHATTAN,HA-D001,0,0,100,0,0,0,0,0,100,0,100,0,0,0,0,0,100,0,200,0,0,0,0,0,200,,,NYCHA SEWARD PARK - VISION URBANA COMMUNITY CENTER RENOVATIONS--ACCESSI BILITY,cpd11-20mn.pdf
HAM21SPMO,SEWARD PARK EXT- VISION URBANA HQ RENO,806,HOUSING PRESERVATION AND DEVEL,LOW TO MODERATE INCOME PUBLIC HOUSING UPGRADE,103,MANHATTAN,HA-D001,0,0,100,0,0,0,0,0,100,0,100,0,0,0,0,0,100,0,200,0,0,0,0,0,200,,,NYCHA- VISION URBANA HEADQUARTERS RENOVATION--CAPITAL FUNDING IS REQUESTED TO,cpd11-20mn.pdf
HAM21SWTI,STEPHEN WISE TOWERS NYCHA - INFRASTRUCTURE-,806,HOUSING PRESERVATION AND DEVEL,LOW TO MODERATE INCOME PUBLIC HOUSING UPGRADE,107,MANHATTAN,HA-D001,0,0,600,0,0,0,0,0,600,0,600,0,0,0,0,0,600,0,1200,0,0,0,0,0,1200,,,STEPHEN WISE TOWERS NYCHA - INFRASTRUCTURE-,cpd11-20mn.pdf
HAM21THCR,COMPACTOR REPLACEMENT AT TAFT HOUSES,806,HOUSING PRESERVATION AND DEVEL,LOW TO MODERATE INCOME PUBLIC HOUSING UPGRADE,110,MANHATTAN,HA-D001,0,0,310,0,0,0,0,0,310,0,310,0,0,0,0,0,310,0,620,0,0,0,0,0,620,,,NYCHA TAFT HOUSES - COMPACTOR REPLACEMENT-,cpd11-20mn.pdf
HAM21USPR,JOHNSON- UNION SETTLEMENT PLAYGROUND RENO,806,HOUSING PRESERVATION AND DEVEL,LOW TO MODERATE INCOME PUBLIC HOUSING UPGRADE,111,MANHATTAN,HA-M001,0,0,175,0,0,0,0,0,175,0,175,0,0,0,0,0,175,0,350,0,0,0,0,0,350,,,NYCHA- UNION SETTLEMENT PLAYGROUND RENOVATIONS- JOHNSON HOUSES--FUNDING TOWARDS,cpd11-20mn.pdf
HAM21WATC,REPLACING TRASH COMPACTORS AT WALD HOUSE,806,HOUSING PRESERVATION AND DEVEL,LOW TO MODERATE INCOME PUBLIC HOUSING UPGRADE,103,MANHATTAN,HA-D001,0,0,70,0,0,0,0,0,70,0,70,0,0,0,0,0,70,0,140,0,0,0,0,0,140,,,PB,cpd11-20mn.pdf
HAM21WHBC,NYCHA WAGNER HOUSES-BASKETBALL COURT RENOVATIONS,806,HOUSING PRESERVATION AND DEVEL,LOW TO MODERATE INCOME PUBLIC HOUSING UPGRADE,111,MANHATTAN,HA-D001,0,0,1500,0,0,0,0,0,1500,0,1500,0,0,0,0,0,1500,0,3000,0,0,0,0,0,3000,,,NYCHA WAGNER HOUSES-BASKETBALL COURT RENOVATIONS,cpd11-20mn.pdf
HAM21WHCC,WAGNER HOUSES- COMMUNITY CENTER,806,HOUSING PRESERVATION AND DEVEL,LOW TO MODERATE INCOME PUBLIC HOUSING UPGRADE,111,MANHATTAN,HA-0001,0,0,15000,0,0,0,0,0,15000,0,15000,0,0,0,0,0,15000,0,30000,0,0,0,0,0,30000,,,WAGNER HOUSES- COMMUNITY CENTER,cpd11-20mn.pdf
HAM21WSUG,GARBAGE ENCLOSURES AT WSUR BROWNSTONES,806,HOUSING PRESERVATION AND DEVEL,LOW TO MODERATE INCOME PUBLIC HOUSING UPGRADE,107,MANHATTAN,HA-D001,0,0,70,0,0,0,0,0,70,0,70,0,0,0,0,0,70,0,140,0,0,0,0,0,140,,,PB,cpd11-20mn.pdf
HAM22SMGR,SMITH HOUSES INSTALLATION OF GAS RISERS #7,806,HOUSING PRESERVATION AND DEVEL,LOW TO MODERATE INCOME PUBLIC HOUSING UPGRADE,103,MANHATTAN,HA-0001,9075,0,0,250,0,0,8000,0,8250,0,0,250,0,0,8000,0,8250,0,0,500,0,0,16000,0,16500,,,INSTALLATION OF GAS RISERS #7,cpd11-20mn.pdf
HAM22TAEL,TAFT HOUSES ELEVATOR REHABILITATION,806,HOUSING PRESERVATION AND DEVEL,LOW TO MODERATE INCOME PUBLIC HOUSING UPGRADE,111,MANHATTAN,HA-0001,9075,0,0,250,0,8000,0,0,8250,0,0,250,0,8000,0,0,8250,0,0,500,0,16000,0,0,16500,,,ELEVATOE UPGRADES,cpd11-20mn.pdf
HAM22WAGR,WAGNER HOUSES GAS RISER REPLACEMENTS,806,HOUSING PRESERVATION AND DEVEL,LOW TO MODERATE INCOME PUBLIC HOUSING UPGRADE,111,MANHATTAN,HA-0001,10230,0,0,4000,5300,0,0,0,9300,0,0,4000,5300,0,0,0,9300,0,0,8000,10600,0,0,0,18600,,,GAS RISER REPLACEMENT,cpd11-20mn.pdf
NDF-18BOI,Replace boilers at Lehman Village and Wilson Houses,806,HOUSING PRESERVATION AND DEVEL,NEIGHBORHOOD REVITALIZATION,100,MANHATTAN,ED-0384,13200,0,0,0,0,0,13200,0,13200,0,0,0,0,0,13200,0,13200,0,0,0,0,0,26400,0,26400,,,REPLACE BOILERS AT LEHMAN VILLAGE AND WILSON HOUSES,cpd11-20mn.pdf
NDF-18ECC,Renovations at Early Childhood Centers in East Harlem,806,HOUSING PRESERVATION AND DEVEL,NEIGHBORHOOD REVITALIZATION,100,MANHATTAN,ED-0384,7700,0,0,0,0,0,7700,0,7700,0,0,0,0,0,7700,0,7700,0,0,0,0,0,15400,0,15400,,,RENOVATIONS AT EARLY CHILDHOOD CENTERS IN EAST HARLEM,cpd11-20mn.pdf
NDF-18ELV,New Elevators at 335 East 111th Street,806,HOUSING PRESERVATION AND DEVEL,NEIGHBORHOOD REVITALIZATION,100,MANHATTAN,ED-0384,1000,0,0,0,0,0,1000,0,1000,0,0,0,0,0,1000,0,1000,0,0,0,0,0,2000,0,2000,,,NEW ELEVATORS AT 335 EAST 111TH STREET,cpd11-20mn.pdf
NDF-18GAS,Install new gas risers at Johnson Houses Install new gas ris,806,HOUSING PRESERVATION AND DEVEL,NEIGHBORHOOD REVITALIZATION,100,MANHATTAN,ED-0384,5500,0,0,0,0,0,5500,0,5500,0,0,0,0,0,5500,0,5500,0,0,0,0,0,11000,0,11000,,,INSTALL NEW GAS RISERS AT JOHNSON HOUSES,cpd11-20mn.pdf
NDF-18ROF,Conduct roof and parapet work at UPACA (Site 5),806,HOUSING PRESERVATION AND DEVEL,NEIGHBORHOOD REVITALIZATION,100,MANHATTAN,ED-0384,2500,0,0,0,0,0,2500,0,2500,0,0,0,0,0,2500,0,2500,0,0,0,0,0,5000,0,5000,,,CONDUCT ROOF AND PARAPET WORK AT UPACA (SITE 5),cpd11-20mn.pdf
NDF-18VNT,Modernize ventilation systems in 17 East Harlem Developments,806,HOUSING PRESERVATION AND DEVEL,NEIGHBORHOOD REVITALIZATION,100,MANHATTAN,ED-0384,20000,0,0,0,0,0,20000,0,20000,0,0,0,0,0,20000,0,20000,0,0,0,0,0,40000,0,40000,,,MODERNIZE VENTILATION SYSTEMS IN 17 EAST HARLEM DEVELOPMENTS,cpd11-20mn.pdf
NSENDERO,Sendero Verde - 1681 Madison Avenue,806,HOUSING PRESERVATION AND DEVEL,NEW FACILITIES,100,MANHATTAN,HD-D021,0,550,500,0,0,0,0,0,1050,550,500,0,0,0,0,0,1050,1100,1000,0,0,0,0,0,2100,,"TO FUND THE REDEVELOPMENT OF THE BLOCK BETWEEN 111TH AND 112TH STREETS, AND PARK AND",A MIXED-USE DEVELOPMENT THAT WILL PROVIDE OVER 650 AFFORDABLE HOUSING UNITS AND,cpd11-20mn.pdf
P-3WAGNER,"Wagner Playground, Manhattan",806,HOUSING PRESERVATION AND DEVEL,NEIGHBORHOOD PARKS AND PLAYGROUNDS,100,MANHATTAN,P-D018,500,0,500,0,0,0,0,0,500,0,500,0,0,0,0,0,500,0,1000,0,0,0,0,0,1000,,WAGNER PLAYGROUND -- TO PROVIDE FUNDING FOR OVERALL PLAYGROUND RENOVATIONS,WAGNER PLAYGROUND -- TO PROVIDE FUNDING FOR OVERALL PLAYGROUND RENOVATIONS,cpd11-20mn.pdf
ACEDOH501,DOHMH - LIGHTING UPGRADES,816,DEPARTMENT OF HEALTH AND MENTAL HYGIENE,"BUILDING CONSTRUCTION, RECONSTRUCTION OR RETROFIT",101,MANHATTAN,HL-0082,539,421,69,0,0,0,0,0,490,421,69,0,0,0,0,0,490,842,138,0,0,0,0,0,980,PROJECT DELAYED DUE TO CHANGES IN SCOPE/DESIGN,,LIGHTING UPGRADES,cpd11-20mn.pdf
ACEDOH502,DOHMH - LED LIGHTING UPGRADE,816,DEPARTMENT OF HEALTH AND MENTAL HYGIENE,"BUILDING CONSTRUCTION, RECONSTRUCTION OR RETROFIT",101,MANHATTAN,HL-0082,1456,0,410,0,0,0,0,0,410,0,410,0,0,0,0,0,410,0,820,0,0,0,0,0,820,PROJECT DELAYED DUE TO UNFORESEEN SITE/FIELD CONDITION,,LED LIGHTING UPGRADE,cpd11-20mn.pdf
HL82ACDOG,DOHMH ANIMAL CARE CENTERS - RECONSTRUCTION OF DOG KENNELS,816,DEPARTMENT OF HEALTH AND MENTAL HYGIENE,ANIMAL CARE,,MANHATTAN,HL-D001,250,0,250,0,0,0,0,0,250,0,250,0,0,0,0,0,250,0,500,0,0,0,0,0,500,PROJECT DELAYED DUE TO CHANGES IN SCOPE/DESIGN,,DOHMH ANIMAL CARE CENTERS - RECONSTRUCTION OF DOG KENNELS,cpd11-20mn.pdf
HL82CHRHC,Central Harlem Health Center interior renovation,816,DEPARTMENT OF HEALTH AND MENTAL HYGIENE,CLINIC RENOVATION AND REHABILITATION,,MANHATTAN,HL-0082,9500,0,0,0,0,500,0,0,500,0,0,0,0,500,0,0,500,0,0,0,0,1000,0,0,1000,PROJECT DELAYED DUE TO BUDGETARY CONSTRAINTS,,CENTRAL HARLEM HEALTH CENTER INTERIOR RENOVATION,cpd11-20mn.pdf
HL82EASTH,EAST HARLEM HEALTH HUB,816,DEPARTMENT OF HEALTH AND MENTAL HYGIENE,CLINIC RENOVATION AND REHABILITATION,,MANHATTAN,HL-D001,600,0,600,0,0,0,0,0,600,0,600,0,0,0,0,0,600,0,1200,0,0,0,0,0,1200,PROJECT DELAYED DUE TO CHANGES IN SCOPE/DESIGN,,EAAT HARLEM HEALTH HUB BUILD OUT OF MAIN BUILDING TO CREATE HUB,cpd11-20mn.pdf
HL82EHREL,EAST HARLEM HEALTH CENTER ELEVATOR MODERNIZATION,816,DEPARTMENT OF HEALTH AND MENTAL HYGIENE,CLINIC RENOVATION AND REHABILITATION,,MANHATTAN,HL-0082,350,0,350,0,0,0,0,0,350,0,350,0,0,0,0,0,350,0,700,0,0,0,0,0,700,,,EAST HARLEM HEALTH CENTER ELEVATOR MODERNIZATION,cpd11-20mn.pdf
HL82EHRHC,East Harlem Health Center interior renovation,816,DEPARTMENT OF HEALTH AND MENTAL HYGIENE,CLINIC RENOVATION AND REHABILITATION,,MANHATTAN,HL-0082,9000,0,0,0,397,3575,0,0,3972,0,0,0,397,3575,0,0,3972,0,0,0,794,7150,0,0,7944,PROJECT DELAYED DUE TO CHANGES IN SCOPE/DESIGN,,EAST HARLEM HEALTH CENTER INTERIOR RENOVATION,cpd11-20mn.pdf
HL82OCMEX,OCME - New Medical Examiner Facility,816,DEPARTMENT OF HEALTH AND MENTAL HYGIENE,OCME,101,MANHATTAN,HL-0083,30331,2967,0,0,0,500,0,0,3467,2967,0,0,0,500,0,0,3467,5934,0,0,0,1000,0,0,6934,PROJECT DELAYED DUE TO BUDGETARY CONSTRAINTS,HL82OCMEX,CONSTRUCTION OF NEW FACILITY,cpd11-20mn.pdf
HL82PHLNB,DOHMH FACILITIES,816,DEPARTMENT OF HEALTH AND MENTAL HYGIENE,CLINIC RENOVATION AND REHABILITATION,100,MANHATTAN,HL-0082,121113,1680,20,0,744,0,0,0,2444,1680,20,0,744,0,0,0,2444,3360,40,0,1488,0,0,0,4888,PROJECT DELAYED DUE TO CHANGES IN SCOPE/DESIGN,,PUBLIC HEALTH LAB NEW BUILDING,cpd11-20mn.pdf
HL82WASHT,WASHINGTON HEIGHTS HEALTH CENTER FACADE RENOVATION,816,DEPARTMENT OF HEALTH AND MENTAL HYGIENE,CLINIC RENOVATION AND REHABILITATION,,MANHATTAN,HL-0082,3234,0,0,0,1378,2892,13300,0,17570,0,0,0,1378,2892,13300,0,17570,0,0,0,2756,5784,26600,0,35140,PROJECT DELAYED DUE TO CHANGES IN SCOPE/DESIGN,,WASHINGTON HEIGHTS HEALTH CENTER FACADE REPAIR PER LOCAL LAW 11,cpd11-20mn.pdf
HL99ANIC1,ANIMAL CARE & CONTROL OF NEW YORK CITY,816,DEPARTMENT OF HEALTH AND MENTAL HYGIENE,CLINIC RENOVATION AND REHABILITATION,111,MANHATTAN,HL-D001,535,0,35,0,0,0,0,0,35,0,35,0,0,0,0,0,35,0,70,0,0,0,0,0,70,PROJECT DELAYED DUE TO CHANGES IN SCOPE/DESIGN,,RENOVATE GARAGE FACILITY AT 326 EAST 100TH STREET SUPPORT LOCATION,cpd11-20mn.pdf
02200901,CENTRAL OFFICE,819,HEALTH AND HOSPITALS CORP,ROUTINE RECONSTRUCTION,,MANHATTAN,HO-D003,1329,714,0,807,0,0,0,0,1521,714,0,807,0,0,0,0,1521,1428,0,1614,0,0,0,0,3042,PROJECT DELAYED DUE TO CHANGES IN SCOPE/DESIGN,"346 BROADWAY, CSS, 12E",THE PURPOSE OF THIS PROJEC T IS TO RENOVATE PRIMARY CARE INITIATIVE CLINICS THROUGHTOUT,cpd11-20mn.pdf
02201805,LWH,819,HEALTH AND HOSPITALS CORP,ROUTINE RECONSTRUCTION,,MANHATTAN,HO-0214,866,801,0,65,0,0,0,0,866,801,0,65,0,0,0,0,866,1602,0,130,0,0,0,0,1732,PROJECT DELAYED DUE TO CHANGES IN SCOPE/DESIGN,"1721-35 AMSTERDAM AVENUE, NEW YORK, NY",REPLACE COOLING TOWER AND UPGRADES TO CHILLER & BOILER AT THE NYC HEALTH + HOSPITALS,cpd11-20mn.pdf
02201901,H+H,819,HEALTH AND HOSPITALS CORP,ROUTINE RECONSTRUCTION,,MANHATTAN,HO-0214,4403,3756,0,647,25597,0,0,0,30000,3756,0,647,25597,0,0,0,30000,7512,0,1294,51194,0,0,0,60000,PROJECT DELAYED DUE TO CHANGES IN SCOPE/DESIGN,"50 WATER STREET, NEW YORK, NY",NYC HEALTH + HOSPITALS,cpd11-20mn.pdf
11200912,BELLEVUE,819,HEALTH AND HOSPITALS CORP,ROUTINE RECONSTRUCTION,106,MANHATTAN,HO-0214,577,524,0,0,0,53,0,0,577,524,0,0,0,53,0,0,577,1048,0,0,0,106,0,0,1154,PROJECT DELAYED DUE TO CHANGES IN SCOPE/DESIGN,"462 FIRST AVENUE, NEW YORK, NY 10016",THE FACILITY REQUESTS FUNDING TO REPLACE THE 30 AND 14 INCH CONDENSING PIPING LOCATED ON,cpd11-20mn.pdf
11201001,BHC,819,HEALTH AND HOSPITALS CORP,ROUTINE RECONSTRUCTION,106,MANHATTAN,HO-0214,3200,2943,257,0,0,0,0,0,3200,2943,257,0,0,0,0,0,3200,5886,514,0,0,0,0,0,6400,PROJECT DELAYED DUE TO CHANGES IN SCOPE/DESIGN,"462 FIRST AVENUE, NEW YORK, NY 10016",UPGRADE OPERATING ROOMS ON THE 11TH FLOOR AT BELLEVUE.,cpd11-20mn.pdf
11201601,BELLEVUE,819,HEALTH AND HOSPITALS CORP,ROUTINE RECONSTRUCTION,106,MANHATTAN,HO-0214,2033,1528,0,0,505,0,0,0,2033,1528,0,0,505,0,0,0,2033,3056,0,0,1010,0,0,0,4066,PROJECT DELAYED DUE TO CHANGES IN SCOPE/DESIGN,"462 FIRST AVENUE, NEW YORK, NY 10016",REPLACE TWO INDOOR COOLING TOWERS AT BELLEVUE HOSPITAL CENTER.,cpd11-20mn.pdf
11201705,BHC,819,HEALTH AND HOSPITALS CORP,ROUTINE RECONSTRUCTION,106,MANHATTAN,HO-0214,886,25,4256,0,0,0,0,0,4281,25,4256,0,0,0,0,0,4281,50,8512,0,0,0,0,0,8562,,"462 FIRST AVENUE, NEW YORK, NY 10016",BELLEVUE HOSPITAL CENTER,cpd11-20mn.pdf
11201803,BHC,819,HEALTH AND HOSPITALS CORP,ROUTINE RECONSTRUCTION,,MANHATTAN,HO-0214,1046,886,160,0,0,0,0,0,1046,886,160,0,0,0,0,0,1046,1772,320,0,0,0,0,0,2092,,"462 FIRST AVENUE, NEW YORK, NY 10016",EXPAND HEIGHT OF GUARDRAILS IN THE ACB ATRIUM,cpd11-20mn.pdf
11201901,BHC,819,HEALTH AND HOSPITALS CORP,ROUTINE RECONSTRUCTION,,MANHATTAN,HO-0214,700,0,0,700,0,0,0,0,700,0,0,700,0,0,0,0,700,0,0,1400,0,0,0,0,1400,PROJECT DELAYED DUE TO CHANGES IN SCOPE/DESIGN,"462 FIRST AVENUE, NEW YORK, NY 10016",CONVERT SPACE TO CREATE 4 PYXIS MEDICATION ROOMS FOR THE INPATIENT PHYCHIATRIC MENTAL,cpd11-20mn.pdf
11201903,BELLEVUE,819,HEALTH AND HOSPITALS CORP,ROUTINE RECONSTRUCTION,,MANHATTAN,HO-M001 HO-D003,951,0,200,751,0,0,0,0,951,0,200,751,0,0,0,0,951,0,400,1502,0,0,0,0,1902,,"462 FIRST AVENUE, NEW YORK, NY, 10016",BELLEVUE,cpd11-20mn.pdf
11201904,BHC,819,HEALTH AND HOSPITALS CORP,ROUTINE RECONSTRUCTION,,MANHATTAN,HO-0214,796,722,537,0,0,0,0,0,1259,722,537,0,0,0,0,0,1259,1444,1074,0,0,0,0,0,2518,,"425 FIRST AVENUE, NEW YORK, NY 10016",UPGRADE UNDERGROUND STORAGE TANK SUMPS ON THE BELLEVUE CAMPUS.,cpd11-20mn.pdf
11202001,BELLEVUE,819,HEALTH AND HOSPITALS CORP,ROUTINE RECONSTRUCTION,,MANHATTAN,HO-0214,261,0,261,0,0,0,0,0,261,0,261,0,0,0,0,0,261,0,522,0,0,0,0,0,522,,"462 FIRST AVENUE, NEW YORK NY 10016",DOOR LOCK MONITORING SYSTEM,cpd11-20mn.pdf
11202101,BELLEVUE,819,HEALTH AND HOSPITALS CORP,ROUTINE RECONSTRUCTION,,MANHATTAN,HO-D003 HO-M001,940,0,940,0,0,0,0,0,940,0,940,0,0,0,0,0,940,0,1880,0,0,0,0,0,1880,,"462 FIRST AVENUE, MANHATTAN, NY 10016",REPLACE EMERGENCY DEPT NURSE STATION,cpd11-20mn.pdf
12201501,GOUVERNEUR,819,HEALTH AND HOSPITALS CORP,ROUTINE RECONSTRUCTION,103,MANHATTAN,HO-M001 HO-D003,1000,811,0,284,0,0,0,0,1095,811,0,284,0,0,0,0,1095,1622,0,568,0,0,0,0,2190,PROJECT DELAYED DUE TO CHANGES IN SCOPE/DESIGN,"540 EAST 13TH STREET, NEW YORK, NY 10009",GOUVERNEUR,cpd11-20mn.pdf
12201801,GHS,819,HEALTH AND HOSPITALS CORP,ROUTINE RECONSTRUCTION,,MANHATTAN,HO-0214,291,246,45,0,0,0,0,0,291,246,45,0,0,0,0,0,291,492,90,0,0,0,0,0,582,,"227 MADISON STREET, NEW YORK, NY",REHABILITATE FACADE - CYCLE 7B AMENDED AND CYCLE 8B AT GOUVERNEUR HEALTHCARE SERVICES,cpd11-20mn.pdf
12201902,GOUVERNEUR,819,HEALTH AND HOSPITALS CORP,ROUTINE RECONSTRUCTION,,MANHATTAN,HO-D003 HO-0214,248,0,0,382,0,0,0,0,382,0,0,382,0,0,0,0,382,0,0,764,0,0,0,0,764,,"277 MADISON STREET, NEW YORK, NY 10002",NA,cpd11-20mn.pdf
12201903,GHS,819,HEALTH AND HOSPITALS CORP,ROUTINE RECONSTRUCTION,,MANHATTAN,HO-0214,56,0,40,2,0,0,0,0,42,0,40,2,0,0,0,0,42,0,80,4,0,0,0,0,84,,"34 SPRING STREET, NEW YORK, NY 10012","INSTALL CHIMNEY LINER AT GOTHAM HEALTH, JUDSON",cpd11-20mn.pdf
12202001,GOUVERNEUR,819,HEALTH AND HOSPITALS CORP,ROUTINE RECONSTRUCTION,,MANHATTAN,HO-0214,52,0,52,0,0,0,0,0,52,0,52,0,0,0,0,0,52,0,104,0,0,0,0,0,104,,"227 MADISON STREET, MANHATTAN, NY 10002",REPLACING PIPING TO DIESEL GENERATOR,cpd11-20mn.pdf
12202101,EXPRESS CARE,819,HEALTH AND HOSPITALS CORP,ROUTINE RECONSTRUCTION,,MANHATTAN,HO-0214,4300,0,276,4024,0,0,0,0,4300,0,276,4024,0,0,0,0,4300,0,552,8048,0,0,0,0,8600,,"227 MADISON STREET, MANHATTAN, 10002",EXPRESS CARE CONSTRUCTION,cpd11-20mn.pdf
13200571,HARLEM,819,HEALTH AND HOSPITALS CORP,ROUTINE RECONSTRUCTION,110,MANHATTAN,HO-D003,3765,2611,0,0,0,303,0,0,2914,2611,0,0,0,303,0,0,2914,5222,0,0,0,606,0,0,5828,PROJECT DELAYED DUE TO CHANGES IN SCOPE/DESIGN,"506 LENOX AVENUE, NEW YORK, N. Y. 10037","MURALS REMOVAL, PRESERVATION AND RE-INSTALLATION IN LOBBY OF NEW PAVILION AT HARLEM",cpd11-20mn.pdf
13200573,HARLEM,819,HEALTH AND HOSPITALS CORP,ROUTINE RECONSTRUCTION,110,MANHATTAN,HO-0377,3500,0,150,1350,0,0,0,0,1500,0,150,1350,0,0,0,0,1500,0,300,2700,0,0,0,0,3000,PROJECT DELAYED DUE TO CHANGES IN SCOPE/DESIGN,"506 LENOX AVENUE, NEW YORK, NY 10037",CONSTRUCT NEW PARKING FACILITY AT HARLEM HOSPITAL CENTER THAT WILL ADD 99 ADDITIOANL,cpd11-20mn.pdf
13200601,HARLEM HOUSE RELOCATION AND RENOVATION,819,HEALTH AND HOSPITALS CORP,ROUTINE RECONSTRUCTION,110,MANHATTAN,HO-0214,945,389,0,0,0,55,0,0,444,389,0,0,0,55,0,0,444,778,0,0,0,110,0,0,888,PROJECT DELAYED DUE TO CHANGES IN SCOPE/DESIGN,"WEST 118TH STREET, NEW YORK NY",HARLEM HOUSE PROVIDES COMMUNITY SERVICES FOR PATIENTS WHO REQUIRE PSYCHIATRIC,cpd11-20mn.pdf
13201101,HARLEM,819,HEALTH AND HOSPITALS CORP,ROUTINE RECONSTRUCTION,,MANHATTAN,HO-D003 HO-0214,2500,3294,-1,0,0,170,0,0,3463,3294,-1,0,0,170,0,0,3463,6588,-2,0,0,340,0,0,6926,PROJECT DELAYED DUE TO CHANGES IN SCOPE/DESIGN,"WEST 118TH STREET, NEW YORK NY",THE FPURPOSE OF THIS PROJECT IS TO RENOVATE SPACE AT 118TH STREET (DCAS BUIDING) IN ORDER,cpd11-20mn.pdf
13201301,HARLEM,819,HEALTH AND HOSPITALS CORP,ROUTINE RECONSTRUCTION,110,MANHATTAN,HO-D003,600,76,524,0,0,0,0,0,600,76,524,0,0,0,0,0,600,152,1048,0,0,0,0,0,1200,PROJECT DELAYED DUE TO BUDGETARY CONSTRAINTS,"506 LENOX AVENUE, NEW YORK, NY 10037",RENOVATE POST PARTUM UNIT AT HARLEM HOSPITAL CENTER.,cpd11-20mn.pdf
13201401,HARLEM,819,HEALTH AND HOSPITALS CORP,ROUTINE RECONSTRUCTION,110,MANHATTAN,HO-D003,3261,3123,0,0,0,122,0,0,3245,3123,0,0,0,122,0,0,3245,6246,0,0,0,244,0,0,6490,PROJECT DELAYED DUE TO CHANGES IN SCOPE/DESIGN,"506 LENOX AVENUE NEW YORK, NY 10037",CONSTRUCT GERIATRICS CENTER AT HARLEM HOSPITAL CENTER.,cpd11-20mn.pdf
13201501,HARLEM,819,HEALTH AND HOSPITALS CORP,ROUTINE RECONSTRUCTION,110,MANHATTAN,HO-0214 HO-D003,300,43,0,757,0,0,0,0,800,43,0,757,0,0,0,0,800,86,0,1514,0,0,0,0,1600,PROJECT DELAYED DUE TO CHANGES IN SCOPE/DESIGN,"506 LENOX AVENUE, NEW YORK, NY 10037",DESIGN AND INSTALL PROPER VENTILATION FOR BOILER ROOM. HARLEM HOSPITAL CENTER WAS,cpd11-20mn.pdf
13201502,HARLEM,819,HEALTH AND HOSPITALS CORP,ROUTINE RECONSTRUCTION,110,MANHATTAN,HO-0214,8300,16415,144,2409,0,0,0,0,18968,16415,144,2409,0,0,0,0,18968,32830,288,4818,0,0,0,0,37936,PROJECT DELAYED DUE TO CHANGES IN SCOPE/DESIGN,"506 LENOX AVENUE, NEW YORK, NY 10037",UPGRADE ELECTRICAL SYSTEM AT HARLEM HOSPITAL CENTER TO COMPLY WITH NFPA LIFE SAFETY,cpd11-20mn.pdf
13201602,HARLEM,819,HEALTH AND HOSPITALS CORP,ROUTINE RECONSTRUCTION,110,MANHATTAN,HO-0214,15966,1060,3305,9913,1688,0,0,0,15966,1060,3305,9913,1688,0,0,0,15966,2120,6610,19826,3376,0,0,0,31932,,506 LENOX AVENUE,THEPURPOSE OF THIS PROJECT IS TO REHABILITATE THE EXTERIOR FASCADE OF MILK BUILDING AT,cpd11-20mn.pdf
13201603,HARLEM,819,HEALTH AND HOSPITALS CORP,ROUTINE RECONSTRUCTION,110,MANHATTAN,HO-0214,28184,9714,0,0,0,13463,0,0,23177,9714,0,0,0,13463,0,0,23177,19428,0,0,0,26926,0,0,46354,,"506 LENOX AVENUE NEW YORK, NY 10037",THE PURPOSE OF THIS PROJECT IS TO DECANT AND DEMOLISH THE WP ROOM AT HARLEM HOSPITAL,cpd11-20mn.pdf
13201701,HARLEM,819,HEALTH AND HOSPITALS CORP,ROUTINE RECONSTRUCTION,110,MANHATTAN,HO-D003,335,248,0,0,0,87,0,0,335,248,0,0,0,87,0,0,335,496,0,0,0,174,0,0,670,PROJECT DELAYED DUE TO CHANGES IN SCOPE/DESIGN,"506 LENOX AVENUE, NEW YORK, NY 10037",RENOVATE SPACE TO CONSTRUCT A RESPITE CENTER FOR FIRST RESPONDERS AT HARLEM HOSPITAL,cpd11-20mn.pdf
13201803,HARLEM,819,HEALTH AND HOSPITALS CORP,ROUTINE RECONSTRUCTION,,MANHATTAN,HO-0214,173,15,158,0,0,0,0,0,173,15,158,0,0,0,0,0,173,30,316,0,0,0,0,0,346,PROJECT DELAYED DUE TO CHANGES IN SCOPE/DESIGN,"506 LENOX AVENUE, NEW YORK, NY 10037",NYC HEALTH + HOSPITALS ¦ HARLEM,cpd11-20mn.pdf
13201901,HARLEM,819,HEALTH AND HOSPITALS CORP,ROUTINE RECONSTRUCTION,,MANHATTAN,HO-0214,450,0,0,0,0,450,0,0,450,0,0,0,0,450,0,0,450,0,0,0,0,900,0,0,900,,"506 LENOX AVENUE, NEW YORK, NY 10002",THE PROJECT SCOPE IS TO RENOVATE THE MP DIALYSIS UNIT AT NYC HEALTH + HOSPITALS / HARLEM.,cpd11-20mn.pdf
13202001,HARLEM,819,HEALTH AND HOSPITALS CORP,ROUTINE RECONSTRUCTION,,MANHATTAN,HO-0214,5008,345,4663,0,0,0,0,0,5008,345,4663,0,0,0,0,0,5008,690,9326,0,0,0,0,0,10016,,MLK PAVILION,HARLEM HOSPITAL CENTER,cpd11-20mn.pdf
13202101,ELEVATOR MER HVAC UPGRADE,819,HEALTH AND HOSPITALS CORP,ROUTINE RECONSTRUCTION,,MANHATTAN,HO-0214,150,0,150,0,0,0,0,0,150,0,150,0,0,0,0,0,150,0,300,0,0,0,0,0,300,,"506 LENOX AVE, NEW YORK NY 10037",ELEVATOR MER HVAC UPGRADE FOR NYC H+H/ HARLEM,cpd11-20mn.pdf
18202001,SYDENHAM,819,HEALTH AND HOSPITALS CORP,ROUTINE RECONSTRUCTION,,MANHATTAN,HO-0214,1093,0,118,975,0,0,0,0,1093,0,118,975,0,0,0,0,1093,0,236,1950,0,0,0,0,2186,,"264 WEST 118TH STREET, NEW YORK NY 10026",SYDENHAM,cpd11-20mn.pdf
37201301,MHC,819,HEALTH AND HOSPITALS CORP,ROUTINE RECONSTRUCTION,111,MANHATTAN,HO-D003,2420,286,2134,0,0,0,0,0,2420,286,2134,0,0,0,0,0,2420,572,4268,0,0,0,0,0,4840,,"1901 FIRST AVENUE, NEW YORK, NY 10029",RENOVATE/FURNISH CLINIC SPACE THAT IS CURRENTLY IN MAJOR DISREPAIR ONTHE 6TH FLLOR (6C),cpd11-20mn.pdf
37201401,MHC,819,HEALTH AND HOSPITALS CORP,ROUTINE RECONSTRUCTION,111,MANHATTAN,HO-D003,900,454,445,0,0,0,0,0,899,454,445,0,0,0,0,0,899,908,890,0,0,0,0,0,1798,PROJECT DELAYED DUE TO CHANGES IN SCOPE/DESIGN,"1901 FIRST AVENUE, NEW YORK , NY10029",THE PURPOSE OF THIS PROJECT IS TO INSTALL PERIMETER FENCING AND A GATE TO PROVIDE A,cpd11-20mn.pdf
37201501,MHC,819,HEALTH AND HOSPITALS CORP,ROUTINE RECONSTRUCTION,111,MANHATTAN,HO-D003 HO-0214,2100,249,2450,0,0,0,0,0,2699,249,2450,0,0,0,0,0,2699,498,4900,0,0,0,0,0,5398,PROJECT DELAYED PENDING APPROVAL OF NECESSARY PERMITS,"1901 FIRST AVNUE, NEW YORK, NY 10029",RENOVATE AND OUTFIT SPACE ON THE FIRST FLOOR OF METROPOLITAN HOSPITAL'S OURPATIENT,cpd11-20mn.pdf
37201601,MHC,819,HEALTH AND HOSPITALS CORP,ROUTINE RECONSTRUCTION,111,MANHATTAN,HO-0214,399,332,67,0,0,0,0,0,399,332,67,0,0,0,0,0,399,664,134,0,0,0,0,0,798,PROJECT DELAYED DUE TO CHANGES IN SCOPE/DESIGN,"1901 FIRST AVENUE, NEW YORK, NY 10029",RESTORE EXTERIOR FACADE ON THE CAMPUS OF METROPOLITAN HOSPITAL CENTERTO COMPLY WITH,cpd11-20mn.pdf
37201901,MHC,819,HEALTH AND HOSPITALS CORP,ROUTINE RECONSTRUCTION,,MANHATTAN,HO-0214,648,0,648,0,0,0,0,0,648,0,648,0,0,0,0,0,648,0,1296,0,0,0,0,0,1296,,"1901 FIRST AVENUE, NEW YORK, NY 10029",REPLACE MEDIUM PRESSURE STEAM CONDENSATE RETURN RISER AT METROPOLITANHOSPITAL,cpd11-20mn.pdf
37202001,METROPOLITAN,819,HEALTH AND HOSPITALS CORP,ROUTINE RECONSTRUCTION,,MANHATTAN,HO-D003,3800,0,252,3548,0,0,0,0,3800,0,252,3548,0,0,0,0,3800,0,504,7096,0,0,0,0,7600,,"1901 FIRST AVENUE , NEW YORK, NY 10029",REPLACE MRI UNIT AT MODULAR MRI BUILDING FOR HEALTH + HOSPITALS/METROPOLITAN,cpd11-20mn.pdf
37202002,METROPOLITAN,819,HEALTH AND HOSPITALS CORP,ROUTINE RECONSTRUCTION,,MANHATTAN,HO-0214,13000,266,0,12734,0,0,0,0,13000,266,0,12734,0,0,0,0,13000,532,0,25468,0,0,0,0,26000,,,METROPOLITAN,cpd11-20mn.pdf
37202003,MET,819,HEALTH AND HOSPITALS CORP,ROUTINE RECONSTRUCTION,,MANHATTAN,HO-0214,25000,261,0,12383,12356,0,0,0,25000,261,0,12383,12356,0,0,0,25000,522,0,24766,24712,0,0,0,50000,,"1901 FIRST AVENUE, NEW YORK, NY 10029",EMERGENCY POWER SEPARATION AND UPGRADES AT METROPOLITAN HOSPITAL CENTER,cpd11-20mn.pdf
37202004,METROPOLITAN,819,HEALTH AND HOSPITALS CORP,ROUTINE RECONSTRUCTION,,MANHATTAN,HO-0214,1664,0,0,0,1664,0,0,0,1664,0,0,0,1664,0,0,0,1664,0,0,0,3328,0,0,0,3328,,"1901 FIRST AVENUE, NEW YORK, NY 10038",HHC METROPOLITAN,cpd11-20mn.pdf
37202005,METROPOLITAN,819,HEALTH AND HOSPITALS CORP,ROUTINE RECONSTRUCTION,,MANHATTAN,HO-0214,1698,0,1698,0,0,0,0,0,1698,0,1698,0,0,0,0,0,1698,0,3396,0,0,0,0,0,3396,,"1901 FIRST AVENUE , NEW YORK, NY 10029",REPLACEMENT OF ROOFS AT OPD AND MENTAL HEALTH BUILDINGS FOR HEALTH + HOSPITALS /,cpd11-20mn.pdf
37202101,METROPOLITAN,819,HEALTH AND HOSPITALS CORP,ROUTINE RECONSTRUCTION,,MANHATTAN,HO-D003,1800,0,1800,0,0,0,0,0,1800,0,1800,0,0,0,0,0,1800,0,3600,0,0,0,0,0,3600,,"1901 FIRST AVENUE, NY 10029",RENOVATION OF INFUSION CENTER,cpd11-20mn.pdf
37202102,CHILLER PLANT UPGRADE,819,HEALTH AND HOSPITALS CORP,ROUTINE RECONSTRUCTION,,MANHATTAN,HO-0214,12624,0,12624,0,0,0,0,0,12624,0,12624,0,0,0,0,0,12624,0,25248,0,0,0,0,0,25248,,"1901 FIRST AVENUE, MANHATTAN, NY 10029",CHILLER PLANT UPGRADE AT METROPOLITAN,cpd11-20mn.pdf
37202103,FIRE PROTECTION UPGRADES,819,HEALTH AND HOSPITALS CORP,ROUTINE RECONSTRUCTION,,MANHATTAN,HO-0214,2267,0,0,2267,0,0,0,0,2267,0,0,2267,0,0,0,0,2267,0,0,4534,0,0,0,0,4534,,"1901 FIRST AVENUE, MANHATTAN, NY 10029",FIRE PROTECTION UPGRADES,cpd11-20mn.pdf
37202104,FACADE RESTORATION CYCLE 9,819,HEALTH AND HOSPITALS CORP,ROUTINE RECONSTRUCTION,,MANHATTAN,HO-0214,541,0,541,0,0,0,0,0,541,0,541,0,0,0,0,0,541,0,1082,0,0,0,0,0,1082,,"1901 FIRST AVENUE, NEW YORK, NY 10029",FACADE RESTORATION CYCLE 9 FOR NYC HEALTH + HOSPITALS/ METROPOLITAN,cpd11-20mn.pdf
67200901,COLER,819,HEALTH AND HOSPITALS CORP,ROUTINE RECONSTRUCTION,,MANHATTAN,HO-D003,300,4,0,0,0,296,0,0,300,4,0,0,0,296,0,0,300,8,0,0,0,592,0,0,600,PROJECT DELAYED DUE TO CHANGES IN SCOPE/DESIGN,"900 MAINS STR. ROOSEVELT NEW YORK , NY 10044",THE PURPOSE OF THIS PROJECT IS TO RENOVATE THE NURSING FACILITY DAY ROOM AT COLER,cpd11-20mn.pdf
67201170,COLER,819,HEALTH AND HOSPITALS CORP,ROUTINE RECONSTRUCTION,,MANHATTAN,HO-0214,12826,10868,0,0,0,1958,0,0,12826,10868,0,0,0,1958,0,0,12826,21736,0,0,0,3916,0,0,25652,,THE PURPOSE OF THIS PROJECT IS TO REPLACE WINDORS AND REHABILITATE THE FACADE AT COLER,THE PURPOSE OF THIS PROJECT IS TO REPLACE WINDORS AND REHABILITATE THE FACADE AT COLER,cpd11-20mn.pdf
72202001,CHS OUTPOSTED THERAPEUTIC UNITS,819,HEALTH AND HOSPITALS CORP,ROUTINE RECONSTRUCTION,,MANHATTAN,HO-0214,0,0,21000,15000,249000,41000,0,0,326000,0,21000,15000,249000,41000,0,0,326000,0,42000,30000,498000,82000,0,0,652000,,"462 FIRST AVENUE, NEW YORK, NY, 10016",CHS OUTPOSTED UNITS,cpd11-20mn.pdf
ACEHHC403,HARLEM HOSPITAL CENTER ENERGY UPGRADE,819,HEALTH AND HOSPITALS CORP,"BUILDING CONSTRUCTION, RECONSTRUCTION OR RETROFIT",101,MANHATTAN,HO-0214,10682,10681,176,0,0,0,0,0,10857,10681,176,0,0,0,0,0,10857,21362,352,0,0,0,0,0,21714,PROJECT DELAYED DUE TO CHANGES IN SCOPE/DESIGN,,HARLEM HOSPITAL CENTER ACE PROGRAM,cpd11-20mn.pdf
ACEHHC406,HHC- BELLEVUE HOSPITAL CHILLERS,819,HEALTH AND HOSPITALS CORP,"BUILDING CONSTRUCTION, RECONSTRUCTION OR RETROFIT",102,MANHATTAN,PU-0025 HO-0214,4493,4165,0,327,0,0,0,0,4492,4165,0,327,0,0,0,0,4492,8330,0,654,0,0,0,0,8984,PROJECT DELAYED DUE TO CHANGES IN SCOPE/DESIGN,,CHILLERS,cpd11-20mn.pdf
ACEHHC408,HHC Coler Hospital Boiler Replacement,819,HEALTH AND HOSPITALS CORP,"BUILDING CONSTRUCTION, RECONSTRUCTION OR RETROFIT",111,MANHATTAN,PU-0025 HO-0214,21355,18189,0,1458,0,447,0,0,20094,18189,0,1458,0,447,0,0,20094,36378,0,2916,0,894,0,0,40188,PROJECT DELAYED DUE TO CHANGES IN SCOPE/DESIGN,,INSTALL NEW LPS BOILER PLANT & ALL ASSOCIATED ANCILLARY EQUIPMENT. INSTALL NEW,cpd11-20mn.pdf
ACEHHC602,BHC LIGHTTING AND CONTROLS UPGRADE,819,HEALTH AND HOSPITALS CORP,ROUTINE RECONSTRUCTION,,MANHATTAN,HO-0214 PU-0025,14851,13875,0,297,679,0,0,0,14851,13875,0,297,679,0,0,0,14851,27750,0,594,1358,0,0,0,29702,PROJECT DELAYED DUE TO CHANGES IN SCOPE/DESIGN,"462 FIRST AVENUE, NEW YORK, NY 10016",LIGHTING AND CONTROLS UPGRADE AT BELLEVUE,cpd11-20mn.pdf
SAND1117,BHC,819,HEALTH AND HOSPITALS CORP,ROUTINE RECONSTRUCTION,,MANHATTAN,HO-0214,15914,797,734,0,0,0,0,0,1531,797,734,0,0,0,0,0,1531,1594,1468,0,0,0,0,0,3062,,"462 FIRST AVENUE, NEW YORK, NY 10016",MEP MITIGATION PROJECT TO ENSURE THAT NYC HEALTH + HOSPITALS ¦ BELLEVUE WILL BE,cpd11-20mn.pdf
SAND1121,BHC,819,HEALTH AND HOSPITALS CORP,ROUTINE RECONSTRUCTION,,MANHATTAN,HO-0214,5500,0,550,0,0,0,0,0,550,0,550,0,0,0,0,0,550,0,1100,0,0,0,0,0,1100,,"462 FIRST AVENUE, NEW YORK, NY 10016",MEP MITIGATION PROJECT TO ENSURE THAT NYC HEALTH + HOSPITALS ¦ BELLEVUE WILL BE,cpd11-20mn.pdf
SAND11B,BELLEVUE RECONSTRUCTION AS A RESULT OF SANDY,819,HEALTH AND HOSPITALS CORP,ROUTINE RECONSTRUCTION,106,MANHATTAN,HO-0214,67500,5240,0,0,0,504,0,0,5744,5240,0,0,0,504,0,0,5744,10480,0,0,0,1008,0,0,11488,PROJECT DELAYED DUE TO CHANGES IN SCOPE/DESIGN,"462 FIRST AVENUE, NEW YORK, NY 10016",RECONSTRUCTION OF BELLEVUE HOSPITAL CENTER NECESSITATED BY HURRICANE SANDY.,cpd11-20mn.pdf
SAND3706,MHC,819,HEALTH AND HOSPITALS CORP,ROUTINE RECONSTRUCTION,111,MANHATTAN,HO-0214,5230,1000,15,292,0,0,0,0,1307,1000,15,292,0,0,0,0,1307,2000,30,584,0,0,0,0,2614,,"1901 FIRST AVENUE, NEW YORK, NY 10029",INSTALL ELECTRIC AND CHILLER QUICK CONNECTS FOR THREE ROLL-UP TYPE GENERATORS AND ONE,cpd11-20mn.pdf
ACEDEP502,DEP - WARDS ISLAND SHAFT MIXERS,826,DEPT ENVIRONMENTAL PROTECTION,"BUILDING CONSTRUCTION, RECONSTRUCTION OR RETROFIT",100,MANHATTAN,WP-0112,6568,6984,61,0,0,0,0,0,7045,6984,61,0,0,0,0,0,7045,13968,122,0,0,0,0,0,14090,PROJECT DELAYED DUE TO BUDGETARY CONSTRAINTS,,WARDS ISLAND SHAFT MIXERS,cpd11-20mn.pdf
MED669,"Dist. WM work in 7th Ave between W 14th & W 34th Street, MN",826,DEPT ENVIRONMENTAL PROTECTION,AUGMENTATION OF WATER SUPPLY SYSTEMS,104 105,MANHATTAN,WM-0001,42638,0,0,0,0,0,42638,0,42638,0,0,0,0,0,42638,0,42638,0,0,0,0,0,85276,0,85276,,,"NEW WATER MAIN WORK IN 7TH AVENUE BETWEEN 14TH STREET & 34TH STREET, BOROUGH OF",cpd11-20mn.pdf
MED-672,Install Distribution Water mains throughout Manhattan,826,DEPT ENVIRONMENTAL PROTECTION,AUGMENTATION OF WATER SUPPLY SYSTEMS,100,MANHATTAN,WM-0001,4604,0,0,0,0,0,4000,0,4000,0,0,0,0,0,4000,0,4000,0,0,0,0,0,8000,0,8000,,,"ALLL EXISTING HYDRANTS MUST BE REPAINTED AND STENCILED , A CONCRETE PAD MUST BE",cpd11-20mn.pdf
NR-111-L,RECONSTRUCTION OF PRIMARY TANKS AT NORTH RIVER WPCP,826,DEPT ENVIRONMENTAL PROTECTION,PLANT UPGRADING AND RECONSTRUCTION,100 109,MANHATTAN,WP-0112,38154,826,0,0,0,0,0,79000,79826,826,0,0,0,0,0,79000,79826,1652,0,0,0,0,0,158000,159652,PROJECT DELAYED DUE TO BUDGETARY CONSTRAINTS,"WEST 135TH STREET & 12TH AVENUE, MANHATTANVILLE STSTION, NEW YORK, N.Y. 10027",RECONSTRUCTION OF PRIMARY TANKS AT NORTH RIVER WPCP,cpd11-20mn.pdf
NR-115-L,RECONSTRUCT POWER DISTRIBUTION EQUIPMENT @ NORTH RIVER WWTP,826,DEPT ENVIRONMENTAL PROTECTION,PLANT UPGRADING AND RECONSTRUCTION,100 109,MANHATTAN,WP-0112,36505,2841,0,6200,0,0,0,41800,50841,2841,0,6200,0,0,0,41800,50841,5682,0,12400,0,0,0,83600,101682,,"135TH ST., & 12TH AVENUE, MAHNATTANVILLE STATION, N.Y., N.Y. 10027",RECONSTRUCT POWER DISTRIBUTION EQUIPMENT @ NORTH RIVER WWTP,cpd11-20mn.pdf
NR-124,RECONSTRUCT DIGESTER GAS SYSTEM AT NORTH RIVER WPCP,826,DEPT ENVIRONMENTAL PROTECTION,PLANT UPGRADING AND RECONSTRUCTION,100,MANHATTAN,WP-0112,15000,0,0,1500,0,0,16500,0,18000,0,0,1500,0,0,16500,0,18000,0,0,3000,0,0,33000,0,36000,,,RECONSTRUCT DIGESTER GAS SYSTEM AT NORTH RIVER WPCP,cpd11-20mn.pdf
NR-131-L,RECONSTRUCTION OF MAIN HYDRAULIC SYSTEM @ NORTH RIVER WWTP,826,DEPT ENVIRONMENTAL PROTECTION,PLANT UPGRADING AND RECONSTRUCTION,100,MANHATTAN,WP-0112,5665,6795,95,0,0,0,0,0,6890,6795,95,0,0,0,0,0,6890,13590,190,0,0,0,0,0,13780,,"725 W. 135TH STREET, NEW YORK, N.Y. 10031",REMOVE EXISTING MAIN HYDRAULIC SYSTEM AND INSTALL TEN (10) INDIVIDUALACTUATORS FOR THE,cpd11-20mn.pdf
NR-33,PROCESS CONTROL,826,DEPT ENVIRONMENTAL PROTECTION,CONSENT DECREE UPGRADING AND CONSTRUCTION,199,MANHATTAN,WP-0164,146790,189814,258,0,0,0,0,0,190072,189814,258,0,0,0,0,0,190072,379628,516,0,0,0,0,0,380144,PROJECT DELAYED DUE TO BUDGETARY CONSTRAINTS,NA,,cpd11-20mn.pdf
NR-COGEN,NORTH RIVER WWTP COGENERATION AND ELECTRIFICATION,826,DEPT ENVIRONMENTAL PROTECTION,PLANT COMPONENT STABILIZATION,100 109,MANHATTAN,WP-0164,319977,276241,40665,0,0,0,0,0,316906,276241,40665,0,0,0,0,0,316906,552482,81330,0,0,0,0,0,633812,,,BASED ON THE FEBRUARY 2012 INVESTMENT GRADE FEASIBILITY STUDY FOR COGENERATION AT THE,cpd11-20mn.pdf
NR-STRUCT,STRUCTURAL IMPROVEMENTS AT NORTH RIVER WPCP,826,DEPT ENVIRONMENTAL PROTECTION,PLANT UPGRADING AND RECONSTRUCTION,100 109,MANHATTAN,WP-0164,360000,39740,0,0,0,49500,0,195000,284240,39740,0,0,0,49500,0,195000,284240,79480,0,0,0,99000,0,390000,568480,,,"STRUCTURAL IMPROVEMENTS TO THE ROOF, INTERMEDIATE STRUCTURE AND UNDERDECK OF THE",cpd11-20mn.pdf
PS-278,PARK DRIVE EAST,826,DEPT ENVIRONMENTAL PROTECTION,PLANT UPGRADING AND RECONSTRUCTION,100,MANHATTAN,WP-0269,5000,0,0,0,0,22000,0,0,22000,0,0,0,0,22000,0,0,22000,0,0,0,0,44000,0,0,44000,,PARK DRIVE EAST,PARK DRIVE EAST,cpd11-20mn.pdf
PS-289,19TH STREET PUMPING STATION,826,DEPT ENVIRONMENTAL PROTECTION,PLANT UPGRADING AND RECONSTRUCTION,100 106,MANHATTAN,WP-0269,4690,0,0,0,0,0,2000,22000,24000,0,0,0,0,0,2000,22000,24000,0,0,0,0,0,4000,44000,48000,,19TH STREET PUMPING STATION,19TH STREET PUMPING STATION,cpd11-20mn.pdf
PS-313,RECONSTRUCTION OF 235TH STREET PUMPING STATION,826,DEPT ENVIRONMENTAL PROTECTION,PLANT UPGRADING AND RECONSTRUCTION,100,MANHATTAN,WP-0269,5750,1180,21537,0,0,0,0,0,22717,1180,21537,0,0,0,0,0,22717,2360,43074,0,0,0,0,0,45434,,,RECONSTRUCTION OF 235TH STREET PUMPING STATION - MANHATTAN,cpd11-20mn.pdf
PS-348,REHABILITATION OF DAMAGED NORTH RIVER INTERCEPTOR,826,DEPT ENVIRONMENTAL PROTECTION,PLANT UPGRADING AND RECONSTRUCTION,100,MANHATTAN,WP-0269,1150,0,1150,0,0,0,0,0,1150,0,1150,0,0,0,0,0,1150,0,2300,0,0,0,0,0,2300,,,REHABILITATION OF DAMAGED NORTH RIVER INTERCEPTOR,cpd11-20mn.pdf
SANDNR,STORM MITIGATION WORK ATTHE NORTH RIVER WPCP,826,DEPT ENVIRONMENTAL PROTECTION,PLANT UPGRADING AND RECONSTRUCTION,100 109,MANHATTAN,WP-0164,3000,500,0,0,0,0,0,2574,3074,500,0,0,0,0,0,2574,3074,1000,0,0,0,0,0,5148,6148,PROJECT DELAYED DUE TO BUDGETARY CONSTRAINTS,,INSTALLATION AND CONSTRUCTION OF STORM MITIGATION WORK AT THE NORTH RIVER WATER,cpd11-20mn.pdf
SEN002180,Replcmt of combined sewers & dist WM in West 33 St MH,826,DEPT ENVIRONMENTAL PROTECTION,REPLACEMENT OR AUGMENTATION OF EXISTING SYSTEMS,104,MANHATTAN,SE-0002M WM-0001,11364,0,606,0,10758,0,0,0,11364,0,606,0,10758,0,0,0,11364,0,1212,0,21516,0,0,0,22728,,,REPLACEMENT OF COMBINED SEWERS AND DISTRIBUTION WATER MAINS IN WEST 33RD STREET,cpd11-20mn.pdf
SHAFT21,"RECONSTRUCTION OF SHAFT 21, MANHATTAN, Cont., 602",826,DEPT ENVIRONMENTAL PROTECTION,FACILITY PURCHASES AND RECONSTRUCTION,103,MANHATTAN,EP-0006,29116,8676,300,0,0,0,0,0,8976,8676,300,0,0,0,0,0,8976,17352,600,0,0,0,0,0,17952,PROJECT DELAYED DUE TO BUDGETARY CONSTRAINTS,,,cpd11-20mn.pdf
WFF-CPR,WATER EFICIENCY UPGRADES AT CENTRAL PARK RECIRCULATION,826,DEPT ENVIRONMENTAL PROTECTION,WATER FOR THE FUTURE,100,MANHATTAN,EP-0009,14246,0,0,0,0,0,0,14246,14246,0,0,0,0,0,0,14246,14246,0,0,0,0,0,0,28492,28492,,,WATER EFFICIENCY UPGRADES AT CENTRAL PARK RECIRCULATION,cpd11-20mn.pdf
WI-279-L,INSTALLATION OF EMERGENCY GENERATORS AT WARDS ISAND WPCP,826,DEPT ENVIRONMENTAL PROTECTION,PLANT UPGRADING AND RECONSTRUCTION,100,MANHATTAN,WP-0112,96500,847,0,7000,0,0,67000,0,74847,847,0,7000,0,0,67000,0,74847,1694,0,14000,0,0,134000,0,149694,,"WARDS ISLAND, NEW YORK, N.Y. 10035",INSTALLATION OF EMERGENCY GENERATORS AT WARDS ISLAND WPCP,cpd11-20mn.pdf
WI-280-L,RECONSTRUCTION OF MAN/BR GRIT SCREENS AT WARDS ISLAND WPCP,826,DEPT ENVIRONMENTAL PROTECTION,PLANT UPGRADING AND RECONSTRUCTION,100 111,MANHATTAN,WP-0112,18979,18129,1589,0,0,0,0,0,19718,18129,1589,0,0,0,0,0,19718,36258,3178,0,0,0,0,0,39436,,"WARDS ISLAND, NEW YORK, N.Y. 10035",RECONSTRUCTION OF MAIN/BR GRIT SCREENS AT WARDS ISLAND WPCP,cpd11-20mn.pdf
WI-281-L,RECONSTRUCTION OF (39) FINAL TANKS AT WARDS ISLAND,826,DEPT ENVIRONMENTAL PROTECTION,PLANT UPGRADING AND RECONSTRUCTION,100 111,MANHATTAN,WP-0112,87240,141152,586,0,0,0,0,0,141738,141152,586,0,0,0,0,0,141738,282304,1172,0,0,0,0,0,283476,,"WARDS ISLAND, NEW YORK, N.Y. 10035",RECONSTRUCTION OF (39) FINAL TANKS AT WARDS ISLAND WPCP,cpd11-20mn.pdf
WI-284-L,RECONSTRUCTION OF PRIMARY TANKS AT WARDS ISLAND WPCP,826,DEPT ENVIRONMENTAL PROTECTION,PLANT UPGRADING AND RECONSTRUCTION,100 111,MANHATTAN,WP-0112,35633,5635,0,0,0,2460,0,39000,47095,5635,0,0,0,2460,0,39000,47095,11270,0,0,0,4920,0,78000,94190,,"WARDS ISLAND NEW YORK, N.Y 10035",RECONSTRUCTION OF PRIMARY TANKS AT WARDS ISLAND WPCP,cpd11-20mn.pdf
WI-292-L,RECONSTRUCTION OF POWER DISTRIBUTION @ THE WARDS ISLAND WWTP,826,DEPT ENVIRONMENTAL PROTECTION,PLANT UPGRADING AND RECONSTRUCTION,100 111,MANHATTAN,WP-0112,57098,9381,0,0,0,0,0,60723,70104,9381,0,0,0,0,0,60723,70104,18762,0,0,0,0,0,121446,140208,PROJECT DELAYED DUE TO BUDGETARY CONSTRAINTS,"WARDS ISLAND , N.Y., N.Y. 10035",RECONSTRUCTION OF POWER DISTRIBUTION @ THE WARDS ISLAND WWTP,cpd11-20mn.pdf
WI-298-B,CONSULTANT DESIGN FOR CONVERSION OF SHARON DEMO @ WARDS ISL,826,DEPT ENVIRONMENTAL PROTECTION,BIOLOGICAL NUTRIENT REMOVAL,100,MANHATTAN,WP-0285,57276,4739,1000,2000,19364,0,0,0,27103,4739,1000,2000,19364,0,0,0,27103,9478,2000,4000,38728,0,0,0,54206,,"WARDS ISLAND WPCP - WARDS ISLAND, N.Y. 10035",CONSULTANT DESIGN FOR THE CONVERSION OF THE SHARON DEMONSTRATION FACILITY AT THE,cpd11-20mn.pdf
WI-305,RECONSTRUCTION OF FENDER @ WARDS ISLAND WPCP,826,DEPT ENVIRONMENTAL PROTECTION,PLANT UPGRADING AND RECONSTRUCTION,100,MANHATTAN,WP-0112,12000,0,0,0,0,0,0,12000,12000,0,0,0,0,0,0,12000,12000,0,0,0,0,0,0,24000,24000,PROJECT DELAYED DUE TO BUDGETARY CONSTRAINTS,,RECONSTRUCTION OF FENDER @ WARDS ISLAND WPCP,cpd11-20mn.pdf
WI-307-L,RECONSTRUCTION OF SLUDGE FEED LINES @ WARDS ISLAND WWTP,826,DEPT ENVIRONMENTAL PROTECTION,PLANT UPGRADING AND RECONSTRUCTION,100,MANHATTAN,WP-0112,4831,3849,1073,0,0,0,0,0,4922,3849,1073,0,0,0,0,0,4922,7698,2146,0,0,0,0,0,9844,,"WARDS ISLAND, NEW YORK 10035",RECONSTRUCTION OF THE SLUDGE TRANSFER LINES BETWEEN THE SLUDGE STORAGE BUILDING AND,cpd11-20mn.pdf
WI-308-L,INSTALLATION OF CITY WATER LINES @ WARDS ISLAND WWTP,826,DEPT ENVIRONMENTAL PROTECTION,PLANT UPGRADING AND RECONSTRUCTION,100,MANHATTAN,WP-0112,3850,0,0,3200,0,0,0,0,3200,0,0,3200,0,0,0,0,3200,0,0,6400,0,0,0,0,6400,,"WARDS WPCP WARDS ISLAND, NEW YORK, N.Y. 10035",NSTALLATION OF SECONDARY CITY WATER LINES BETWEEN THE PUMP AND BLOWERBUILDING AND,cpd11-20mn.pdf
WI-309-L,RECONSTRUCTION OF NEW ADMINISTRATION BLDG @ WARDS ISLAND,826,DEPT ENVIRONMENTAL PROTECTION,PLANT UPGRADING AND RECONSTRUCTION,100,MANHATTAN,WP-0112,7750,0,0,0,0,0,0,14000,14000,0,0,0,0,0,0,14000,14000,0,0,0,0,0,0,28000,28000,PROJECT DELAYED DUE TO BUDGETARY CONSTRAINTS,,RECONSTRUCTION OF A NEW ADMINISTRATION BUILDING AT THE WARDS ISLAND WWTP. RENOVATION,cpd11-20mn.pdf
WI-311-L,REHAB DIGAS LEAKS AT WARDS ISLAND WPCP,826,DEPT ENVIRONMENTAL PROTECTION,PLANT UPGRADING AND RECONSTRUCTION,100,MANHATTAN,WP-0112,20930,0,12310,0,0,0,0,0,12310,0,12310,0,0,0,0,0,12310,0,24620,0,0,0,0,0,24620,,"WARDS ISLAND, WARDS ISLAND, NEW YORK, N.Y. 10035",RECONSTRUCTION OF DIGESTER DOMES AT THE WARDS ISLAND WWTP. REPAIR STRUCTURAL CRACKS,cpd11-20mn.pdf
WI-312-L,CONSTRUC STORM DRAINS AROUND DIGESTER COMPLEX TO PLANT DRAIN,826,DEPT ENVIRONMENTAL PROTECTION,PLANT UPGRADING AND RECONSTRUCTION,100,MANHATTAN,WP-0112,1740,0,0,0,0,12000,0,0,12000,0,0,0,0,12000,0,0,12000,0,0,0,0,24000,0,0,24000,,,CONSTRUCT STORM DRAINS AROUND DIGESTER/THICKENER COMPLEX TO PLANT DRAIN,cpd11-20mn.pdf
WI-318-L,RECONSTRUCT TWO MAIN SEWAGE PUMP RESISTOR BANKS @ WARDS ISL,826,DEPT ENVIRONMENTAL PROTECTION,PLANT UPGRADING AND RECONSTRUCTION,100,MANHATTAN,WP-0112,2848,0,2448,0,0,0,0,0,2448,0,2448,0,0,0,0,0,2448,0,4896,0,0,0,0,0,4896,,"WARDS ISLAND, NEW YORK, N.Y. 10035",RECONSTRUCT/UPGRADE THE RESISTOR BANKS FOR MSP'S #2 AND #6. DEMOLITION OF THE OLD,cpd11-20mn.pdf
WI-323-L,"UPGRADE MSP CC VALVE,ACTUATORS,DISCHARGE PIP REPL @ WI WRRF",826,DEPT ENVIRONMENTAL PROTECTION,PLANT UPGRADING AND RECONSTRUCTION,100,MANHATTAN,WP-0112,5000,0,0,5000,0,0,0,0,5000,0,0,5000,0,0,0,0,5000,0,0,10000,0,0,0,0,10000,,,"UPGRADE OF MSP CONE CHECK VALVE, ACTUATORS AND DISCHARGE PIPING REPLACEMENT AT WI",cpd11-20mn.pdf
WI-EXP,INTERIM FAC & UPGRADING AT WARDS ISLAND WPCP,826,DEPT ENVIRONMENTAL PROTECTION,PLANT COMPONENT STABILIZATION,111,MANHATTAN,WP-0103,1198376,517698,3170,0,0,0,0,0,520868,517698,3170,0,0,0,0,0,520868,1035396,6340,0,0,0,0,0,1041736,PROJECT DELAYED DUE TO BUDGETARY CONSTRAINTS,MANHATTAN,THE FINAL DESIGN FOR WARDS ISLAND EXPANSION,cpd11-20mn.pdf
P-300HRP2,HUDSON RIVER PARK - Gansevoort MOU,827,DEPARTMENT OF SANITATION,"LARGE, MAJOR AND REGIONAL PARK RECONSTRUCTION",101 102 104,MANHATTAN,P-1246,25000,0,0,0,0,0,0,25000,25000,0,0,0,0,0,0,25000,25000,0,0,0,0,0,0,50000,50000,PROJECT DELAYED PENDING RESOLUTION OF LEGAL ISSUES,,HUDSON RIVER PARK - GANSEVOORT MOU,cpd11-20mn.pdf
S136-264M,Manhattan 26th St Manhattan Borough Shop Roof Replacement,827,DEPARTMENT OF SANITATION,GARAGES AND FACILITIES,100,MANHATTAN,S-0136,2000,2934,3592,0,0,0,0,0,6526,2934,3592,0,0,0,0,0,6526,5868,7184,0,0,0,0,0,13052,,,REPLACE ROOF,cpd11-20mn.pdf
S136-374R,MANHATTAN 12 HV UNITS & BOILER REPLACEMENT,827,DEPARTMENT OF SANITATION,GARAGES AND FACILITIES,101,MANHATTAN,S-0136,8327,0,468,6666,0,0,0,0,7134,0,468,6666,0,0,0,0,7134,0,936,13332,0,0,0,0,14268,,,HV AND BOILER REPLACEMENT,cpd11-20mn.pdf
S136-380C,Bronx 7/8 Garage Boiler Replacement,827,DEPARTMENT OF SANITATION,GARAGES AND FACILITIES,101,MANHATTAN,S-0136,1682,1525,233,0,0,0,0,0,1758,1525,233,0,0,0,0,0,1758,3050,466,0,0,0,0,0,3516,,,REPLACE BOILER,cpd11-20mn.pdf
S136-380E,Manhattan 3 Garage HVAC System Rehabilitation,827,DEPARTMENT OF SANITATION,GARAGES AND FACILITIES,103,MANHATTAN,S-0136,1133,1124,548,0,0,0,0,0,1672,1124,548,0,0,0,0,0,1672,2248,1096,0,0,0,0,0,3344,,,HVAC SYSTEM REHAB,cpd11-20mn.pdf
S136-385E,MANHATTAN 4/4A/7 GARAGE GLASS FACADE REHABILITATION,827,DEPARTMENT OF SANITATION,GARAGES AND FACILITIES,104 107,MANHATTAN,S-0136,1365,786,1072,0,0,0,0,0,1858,786,1072,0,0,0,0,0,1858,1572,2144,0,0,0,0,0,3716,,,REPLACEMENT OF MAJOR SECTIONS OF GLASS FACADE AND PERMANENT INSTALLATION OF SAFETY,cpd11-20mn.pdf
S136-430,Manhattan 4039 9th Ave/W 215th St garage Rehab,827,DEPARTMENT OF SANITATION,GARAGES AND FACILITIES,108,MANHATTAN,S-0136,1800,1240,470,0,0,0,0,0,1710,1240,470,0,0,0,0,0,1710,2480,940,0,0,0,0,0,3420,,,REHAB,cpd11-20mn.pdf
S136-430A,Manhattan 8 Smokestacks Demolition 4039 9th Ave/W 215th St,827,DEPARTMENT OF SANITATION,GARAGES AND FACILITIES,108,MANHATTAN,S-0136,10321,0,9571,0,0,0,0,0,9571,0,9571,0,0,0,0,0,9571,0,19142,0,0,0,0,0,19142,,,REMOVAL OF DETERIORATED AND DANGEROUS SMOKE STACKS,cpd11-20mn.pdf
S136-432,MANHATTAN 44 BEAVER ST REHABILITATION,827,DEPARTMENT OF SANITATION,GARAGES AND FACILITIES,101,MANHATTAN,S-0136,3075,386,109,732,0,0,0,0,1227,386,109,732,0,0,0,0,1227,772,218,1464,0,0,0,0,2454,,,HCF RECONSTRUCTION AT 44 BEAVER ST,cpd11-20mn.pdf
S136-435,Manhattan 11 2496 Second Ave Rehab & Building Addition,827,DEPARTMENT OF SANITATION,GARAGES AND FACILITIES,100,MANHATTAN,S-0136,20683,0,24414,2686,0,0,0,0,27100,0,24414,2686,0,0,0,0,27100,0,48828,5372,0,0,0,0,54200,PROJECT DELAYED DUE TO CHANGES IN SCOPE/DESIGN,,REHABILITATION OF EXISTING STRUCTURE AND CONSTRUCTION OF ONE STORY ADDITION,cpd11-20mn.pdf
S136-437,MANHATTAN 44 BEAVER ST SPRINKLER SYSTEM REPLACEMENT,827,DEPARTMENT OF SANITATION,GARAGES AND FACILITIES,101,MANHATTAN,S-0136,2500,500,571,11040,0,0,0,0,12111,500,571,11040,0,0,0,0,12111,1000,1142,22080,0,0,0,0,24222,,,INSTALLATION OF SPRINKLERS THROUGHOUT 44 BEAVER STREET,cpd11-20mn.pdf
S136-440B,Bronx 7/8 Garage Slab Replacement,827,DEPARTMENT OF SANITATION,GARAGES AND FACILITIES,112,MANHATTAN,S-0136,24589,1311,1966,21063,0,0,0,0,24340,1311,1966,21063,0,0,0,0,24340,2622,3932,42126,0,0,0,0,48680,,,REMOVE AND REPLACE CEMENT FLOOR SLAB INCLUDING STRENGTHENING STRUCTURE,cpd11-20mn.pdf
S136-441B,Manhattan 4/4A/7 Garage Broom Wash Drainage,827,DEPARTMENT OF SANITATION,GARAGES AND FACILITIES,104 107,MANHATTAN,S-0136,1048,163,639,0,0,0,0,0,802,163,639,0,0,0,0,0,802,326,1278,0,0,0,0,0,1604,,,"ADDITION OF CATCH BASIN, SUMP PUMPS, CURBS AND SLAB REHABILITATION.",cpd11-20mn.pdf
S136-441S,Manhattan 4/4A/7 Garage Sprinkler System Upgrades,827,DEPARTMENT OF SANITATION,GARAGES AND FACILITIES,104 107,MANHATTAN,S-0136,1633,187,1192,0,0,0,0,0,1379,187,1192,0,0,0,0,0,1379,374,2384,0,0,0,0,0,2758,,,EXPANSION AND UPFRADES OF SPRINKLER SYSTEM,cpd11-20mn.pdf
S136-447,Manhattan 44 Beaver St Elevators,827,DEPARTMENT OF SANITATION,GARAGES AND FACILITIES,101,MANHATTAN,S-0136,3903,695,4018,0,0,0,0,0,4713,695,4018,0,0,0,0,0,4713,1390,8036,0,0,0,0,0,9426,,,REPLACE ELEVATORS,cpd11-20mn.pdf
S136-464A,Bronx 7/8 Garage Roof Replacement,827,DEPARTMENT OF SANITATION,GARAGES AND FACILITIES,112,MANHATTAN,S-0136,2400,510,2356,0,0,0,0,0,2866,510,2356,0,0,0,0,0,2866,1020,4712,0,0,0,0,0,5732,,,ROOF REPLACEMENT,cpd11-20mn.pdf
S136-464D,Manhattan Henry St Roof Replacement,827,DEPARTMENT OF SANITATION,GARAGES AND FACILITIES,103,MANHATTAN,S-0136,1325,200,1100,0,0,0,0,0,1300,200,1100,0,0,0,0,0,1300,400,2200,0,0,0,0,0,2600,,,ROOF REPLACEMENT,cpd11-20mn.pdf
S136-464E,Manhattan 8 215th St Garage Roof and Masonry Replacement,827,DEPARTMENT OF SANITATION,GARAGES AND FACILITIES,103,MANHATTAN,S-0136,2300,0,230,430,4300,0,0,0,4960,0,230,430,4300,0,0,0,4960,0,460,860,8600,0,0,0,9920,,,ROOF AND MASONRY REPLACEMENT,cpd11-20mn.pdf
S195-228E,Manhattan West 55th Salt Shed gate and related work,827,DEPARTMENT OF SANITATION,GARAGES AND FACILITIES,104 107,MANHATTAN,S-0195,722,298,0,0,9,493,0,0,800,298,0,0,9,493,0,0,800,596,0,0,18,986,0,0,1600,,,DESIGN OF NEW TRI-FOLD GATE FOR WEST 55TH SALT SHED M 4/4A/7,cpd11-20mn.pdf
S216-415C,West 59th street MTS Dredging,827,DEPARTMENT OF SANITATION,SOLID WASTE MANAGEMENT,100,MANHATTAN,S-0216,12600,2100,6757,3743,0,0,0,0,12600,2100,6757,3743,0,0,0,0,12600,4200,13514,7486,0,0,0,0,25200,,,DREDGING TO MAKE WATERWAY AROUND FACILITY NAVIGABLE,cpd11-20mn.pdf
S236-335A,Manhattan 6/6A/8 Garage Construction,827,DEPARTMENT OF SANITATION,GARAGES AND FACILITIES,106 108,MANHATTAN,S-0236,200000,895,0,0,0,0,0,199714,200609,895,0,0,0,0,0,199714,200609,1790,0,0,0,0,0,399428,401218,PROJECT DELAYED DUE TO UNFORESEEN SITE/FIELD CONDITION,,"CONSTRUCTION OF A NEW DSNY GARAGE COMPLEX SERVING MANHATTAN DISTRICTS6, 8, AND 8A.",cpd11-20mn.pdf
SAND26MBC,Hurricane Sandy 26 St Manh Boro Rpr Shop Conduit Work,827,DEPARTMENT OF SANITATION,GARAGES AND FACILITIES,100,MANHATTAN,S-0136,324,2,1,0,62,0,0,0,65,2,1,0,62,0,0,0,65,4,2,0,124,0,0,0,130,,,CONDUIT WORK DUE TO SANDY,cpd11-20mn.pdf
SAND26MBS,Hurricane Sandy 26 St Manh Boro R/R & Haz Mitigation,827,DEPARTMENT OF SANITATION,GARAGES AND FACILITIES,100,MANHATTAN,S-0136,5988,765,98,0,558,0,0,0,1421,765,98,0,558,0,0,0,1421,1530,196,0,1116,0,0,0,2842,,,CAPITAL-ELIGIBLE REPLACEMENTS DUE TO HURRICANE SANDY AND ELEVATING CRIITICAL EQUIPMENT,cpd11-20mn.pdf
SAND44BVC,Hurricane Sandy 44 Beaver Street Conduit Replacement,827,DEPARTMENT OF SANITATION,GARAGES AND FACILITIES,100,MANHATTAN,S-0136,14,0,0,6,0,0,0,0,6,0,0,6,0,0,0,0,6,0,0,12,0,0,0,0,12,,,CONDUIT WORK DUE TO HURRICANE SANDY,cpd11-20mn.pdf
SAND44BVR,Hurricane Sandy 44 Beaver St System Replacement,827,DEPARTMENT OF SANITATION,GARAGES AND FACILITIES,101,MANHATTAN,S-0136,621,109,2,115,0,0,0,0,226,109,2,115,0,0,0,0,226,218,4,230,0,0,0,0,452,,,"PUMPS, ELEVATOR CONTROLS AND OTHER REPLACEMENTS DUE TO HURRICANE SANDY",cpd11-20mn.pdf
SANDMAN3C,Hurricane Sandy Manh 3 Garage Conduit Replacement,827,DEPARTMENT OF SANITATION,GARAGES AND FACILITIES,103,MANHATTAN,S-0136,48,0,0,0,5,0,0,0,5,0,0,0,5,0,0,0,5,0,0,0,10,0,0,0,10,,,CONDUIT REPLACEMENT AT DSNY MANHATTAN 3 GARAGE AT PIER 36,cpd11-20mn.pdf
SANDMAN3G,Hurricane Sandy Manh 3 Garage Repl & Haz Mitigation,827,DEPARTMENT OF SANITATION,GARAGES AND FACILITIES,103,MANHATTAN,S-0136,3843,0,0,0,366,0,0,0,366,0,0,0,366,0,0,0,366,0,0,0,732,0,0,0,732,,,DSNY MANHATTAN 3 GARAGE REPLACEMENT WORK DUE TO HURRICANE SANDY AND HAZARD,cpd11-20mn.pdf
ACEDOT504,"Replacement of Park, Highway and Flood Lights with LEDs",841,DEPARTMENT OF TRANSPORTATION,"BUILDING CONSTRUCTION, RECONSTRUCTION OR RETROFIT",,MANHATTAN,TF-0503,16598,15671,0,0,0,0,0,3514,19185,15671,0,0,0,0,0,3514,19185,31342,0,0,0,0,0,7028,38370,PROJECT DELAYED DUE TO BUDGETARY CONSTRAINTS,,"REPLACEMENT OF EXISTING HIGH PRESSURE SODIUM (HPS) IN PARKS, PLAYGROUNDS (FLOOD LIGHTS)",cpd11-20mn.pdf
ACEDOT602,DOT - Various locations- Rooftop Solar,841,DEPARTMENT OF TRANSPORTATION,"BUILDING CONSTRUCTION, RECONSTRUCTION OR RETROFIT",101,MANHATTAN,HW-0003 PU-0025,515,416,57,1,0,0,0,0,474,416,57,1,0,0,0,0,474,832,114,2,0,0,0,0,948,,,DOT - VARIOUS LOCATIONS,cpd11-20mn.pdf
E34CCTV,East 34th St Ferry Landing CCTV upgrade,841,DEPARTMENT OF TRANSPORTATION,RECONSTRUCTION OF FERRY TERMINAL FACILITIES,100,MANHATTAN,FA-0027,4314,0,0,0,185,0,0,0,185,0,0,0,185,0,0,0,185,0,0,0,370,0,0,0,370,PROJECT DELAYED DUE TO BUDGETARY CONSTRAINTS,,CCTV UPGRADE,cpd11-20mn.pdf
EMIDTWNRZ,East Midtown Rezoning,841,DEPARTMENT OF TRANSPORTATION,PRIMARY STREET RECONSTRUCTION,100,MANHATTAN,HW-0001,18730,0,0,11,0,0,0,9598,9609,0,0,11,0,0,0,9598,9609,0,0,22,0,0,0,19196,19218,PROJECT DELAYED DUE TO BUDGETARY CONSTRAINTS,EAST MIDTOWN REZONING,EAST MIDTOWN REZONING,cpd11-20mn.pdf
FAWTCCTV,WHT Terminal CCTV Upgrades,841,DEPARTMENT OF TRANSPORTATION,RECONSTRUCTION OF FERRY TERMINAL FACILITIES,100,MANHATTAN,FA-0021,1500,0,0,0,1500,0,0,0,1500,0,0,0,1500,0,0,0,1500,0,0,0,3000,0,0,0,3000,PROJECT DELAYED DUE TO BUDGETARY CONSTRAINTS,,WHT TERMINAL CCTV UPGRADES,cpd11-20mn.pdf
HBFDR14BP,East 14th St (near ConEd Plant) Bike Path,841,DEPARTMENT OF TRANSPORTATION,FAIR BRIDGES,100,MANHATTAN,P-0508,39122,0,0,3337,0,35785,0,0,39122,0,0,3337,0,35785,0,0,39122,0,0,6674,0,71570,0,0,78244,PROJECT DELAYED DUE TO BUDGETARY CONSTRAINTS,EAST 14TH ST (NEAR CONED PLANT) BIKE PATH,EAST 14TH ST (NEAR CONED PLANT) BIKE PATH,cpd11-20mn.pdf
HBINSPSSC,South Stuy Cove - Captain Brown Walk,841,DEPARTMENT OF TRANSPORTATION,"BUILDING CONSTRUCTION, RECONSTRUCTION OR RETROFIT",100,MANHATTAN,PU-0200,3394,0,0,0,0,3394,0,0,3394,0,0,0,0,3394,0,0,3394,0,0,0,0,6788,0,0,6788,PROJECT DELAYED DUE TO BUDGETARY CONSTRAINTS,SOUTH STUY COVE - CAPTAIN BROWN WALK,SOUTH STUY COVE - CAPTAIN BROWN WALK,cpd11-20mn.pdf
HBM1027,HARLEM RV DRIVE VIADUCT,841,DEPARTMENT OF TRANSPORTATION,FAIR BRIDGES,111,MANHATTAN,HB-1027,94722,40903,826,0,0,0,0,0,41729,40903,826,0,0,0,0,0,41729,81806,1652,0,0,0,0,0,83458,PROJECT DELAYED DUE TO BUDGETARY CONSTRAINTS,HARLEM RIVER DR VIADUCT,RECONSTRUCTION AND REHABILITATION OF THE HARLEM RIVER DRIVE VIADUCTREPLACEMENT OF,cpd11-20mn.pdf
HBM1120B,11TH AVENUE VIADUCT NORTH SECTION - 33 ST to 35 ST #2245010,841,DEPARTMENT OF TRANSPORTATION,FAIR BRIDGES,104,MANHATTAN,HB-1120,85076,340,0,0,0,76437,0,0,76777,340,0,0,0,76437,0,0,76777,680,0,0,0,152874,0,0,153554,PROJECT DELAYED DUE TO BUDGETARY CONSTRAINTS,REPLACEMENT (NORTH SECTION) OF THE 11TH AVENUE VIADUCT BETWEEN WEST 33RD AND WEST,REPLACEMENT (NORTH SECTION) OF THE 11TH AVENUE VIADUCT BETWEEN WEST 33RD AND WEST,cpd11-20mn.pdf
HBM1147,BROADWAY BRIDGE/HARLEM RIVER (BIN 2-24013-7),841,DEPARTMENT OF TRANSPORTATION,BRIDGE LIFE EXTENSION AND MISCELLANEOUS WORK,112,MANHATTAN,HB-1147 TF-0002,36746,33198,2058,2119,0,23543,0,0,60918,33198,2058,2119,0,23543,0,0,60918,66396,4116,4238,0,47086,0,0,121836,PROJECT DELAYED DUE TO BUDGETARY CONSTRAINTS,N/A,,cpd11-20mn.pdf
HBM1165,RIVERSIDE DRIVE BR/WEST 158TH 2-24672-0,841,DEPARTMENT OF TRANSPORTATION,FAIR BRIDGES,112,MANHATTAN,HB-1165,23896,50177,1549,1767,625,0,0,0,54118,50177,1549,1767,625,0,0,0,54118,100354,3098,3534,1250,0,0,0,108236,PROJECT DELAYED DUE TO BUDGETARY CONSTRAINTS,,,cpd11-20mn.pdf
HBM1173,HENRY HUDSON PKWY 94-98TH ST VIADUCT 2-26725-0,841,DEPARTMENT OF TRANSPORTATION,FAIR BRIDGES,100 107,MANHATTAN,HB-0215,29176,25409,3608,0,0,0,0,0,29017,25409,3608,0,0,0,0,0,29017,50818,7216,0,0,0,0,0,58034,PROJECT DELAYED DUE TO BUDGETARY CONSTRAINTS,,RECONSTRUCTION AT HHP 96TH ST VIADUCT,cpd11-20mn.pdf
HBM1189,WEST 79TH STREET/ AMTRAK (7 BIN#'S),841,DEPARTMENT OF TRANSPORTATION,BRIDGE LIFE EXTENSION AND MISCELLANEOUS WORK,107,MANHATTAN,HB-1189 P-1018 P-0508,59995,19178,176432,4427,1223,0,0,0,201260,19178,176432,4427,1223,0,0,0,201260,38356,352864,8854,2446,0,0,0,402520,PROJECT DELAYED DUE TO BUDGETARY CONSTRAINTS,NA,,cpd11-20mn.pdf
HBM1212,"REHAB OF PARK AVE VIADUCT, NORTH SIDE OF EAST 42ND STREET",841,DEPARTMENT OF TRANSPORTATION,BRIDGE LIFE EXTENSION AND MISCELLANEOUS WORK,106,MANHATTAN,HB-1212 TF-0002 HW-0001M HW-0200,16995,25924,2279,0,0,0,0,197,28400,25924,2279,0,0,0,0,197,28400,51848,4558,0,0,0,0,394,56800,PROJECT DELAYED DUE TO BUDGETARY CONSTRAINTS,REHAB OF PARK AVE VIADUCT,REHAB OF PARK AVE VIADUCT,cpd11-20mn.pdf
HBM1221,E25TH STREET PEDESTRIAN BRIDGE OVER FDR,841,DEPARTMENT OF TRANSPORTATION,FAIR BRIDGES,106,MANHATTAN,HB-1221,9785,2473,0,1700,0,8276,0,0,12449,2473,0,1700,0,8276,0,0,12449,4946,0,3400,0,16552,0,0,24898,PROJECT DELAYED DUE TO BUDGETARY CONSTRAINTS,E25TH STREET PEDESTRIAN BRIDGE OVER FDR,E25TH STREET PEDESTRIAN BRIDGE OVER FDR,cpd11-20mn.pdf
HBM191TUN,191st St Pedestrian Tunnel over Broadway & IRT #1 Subway,841,DEPARTMENT OF TRANSPORTATION,BRIDGE LIFE EXTENSION AND MISCELLANEOUS WORK,100,MANHATTAN,HB-1012 HB-0215,47000,2261,2647,0,0,43000,0,0,47908,2261,2647,0,0,43000,0,0,47908,4522,5294,0,0,86000,0,0,95816,PROJECT DELAYED DUE TO BUDGETARY CONSTRAINTS,191ST ST PEDESTRIAN TUNNEL OVER BROADWAY & IRT #1 SUBWAY,191ST ST PEDESTRIAN TUNNEL OVER BROADWAY & IRT #1 SUBWAY,cpd11-20mn.pdf
HBM245070,West 38th St over Amtrak 30 St Branch BIN 2245070,841,DEPARTMENT OF TRANSPORTATION,FAIR BRIDGES,100,MANHATTAN,HB-0215,35323,0,0,4083,0,2599,28641,0,35323,0,0,4083,0,2599,28641,0,35323,0,0,8166,0,5198,57282,0,70646,PROJECT DELAYED DUE TO BUDGETARY CONSTRAINTS,WEST 38TH ST OVER AMTRAK 30 ST BRANCH BIN 2245070,WEST 38TH ST OVER AMTRAK 30 ST BRANCH BIN 2245070,cpd11-20mn.pdf
HBM245080,West 39th St over Amtrak 30 St Branch BIN 2245080,841,DEPARTMENT OF TRANSPORTATION,FAIR BRIDGES,100,MANHATTAN,HB-0215,35719,0,0,4146,0,2640,28933,0,35719,0,0,4146,0,2640,28933,0,35719,0,0,8292,0,5280,57866,0,71438,PROJECT DELAYED DUE TO BUDGETARY CONSTRAINTS,WEST 39TH ST OVER AMTRAK 30 ST BRANCH BIN 2245080,WEST 39TH ST OVER AMTRAK 30 ST BRANCH BIN 2245080,cpd11-20mn.pdf
HBM246350,EAST DR OVER PED PATH OPP EAST 80TH ST BIN 2246350,841,DEPARTMENT OF TRANSPORTATION,FAIR BRIDGES,100,MANHATTAN,P-0508,4598,508,0,203,512,3586,0,0,4809,508,0,203,512,3586,0,0,4809,1016,0,406,1024,7172,0,0,9618,PROJECT DELAYED DUE TO BUDGETARY CONSTRAINTS,,EAST DR OVER PED PATH OPP EAST 80TH ST BIN 2246350,cpd11-20mn.pdf
HBM551,PARK AVE TUNNEL FROM E34TH TO E39TH ST'S #2-24654-0/TN61420,841,DEPARTMENT OF TRANSPORTATION,FAIR BRIDGES,106,MANHATTAN,HB-0551 TF-0502,22424,41094,2478,0,0,2612,0,0,46184,41094,2478,0,0,2612,0,0,46184,82188,4956,0,0,5224,0,0,92368,PROJECT DELAYED DUE TO BUDGETARY CONSTRAINTS,,"RECON AND REHAB OF THE PARK AVE TUNNEL FROM E34TH TO E39TH ST REPLACEMHE DECK,",cpd11-20mn.pdf
HBM702990,Rehabilitation of Fort Washington Pedestrian Bridge over AMT,841,DEPARTMENT OF TRANSPORTATION,FAIR BRIDGES,100,MANHATTAN,P-0245M P-0861,5774,0,0,5941,0,0,0,0,5941,0,0,5941,0,0,0,0,5941,0,0,11882,0,0,0,0,11882,PROJECT DELAYED DUE TO BUDGETARY CONSTRAINTS,REHABILITATION OF FORT WASHINGTON PEDESTRIAN BRIDGE OVER AMTRAK,REHABILITATION OF FORT WASHINGTON PEDESTRIAN BRIDGE OVER AMTRAK,cpd11-20mn.pdf
HBM8650,REHAB FDR NORTHBOUND FROM EAST 42-49TH ST BIN,841,DEPARTMENT OF TRANSPORTATION,BRIDGE LIFE EXTENSION AND MISCELLANEOUS WORK,100 106,MANHATTAN,HB-0215,97300,13205,0,0,0,85825,0,0,99030,13205,0,0,0,85825,0,0,99030,26410,0,0,0,171650,0,0,198060,PROJECT DELAYED DUE TO BUDGETARY CONSTRAINTS,,REHAB FDR NORTHBOUND FROM EAST 42-49TH ST,cpd11-20mn.pdf
HBMA22934,RAMP TO NB HHP OVER AMTRAK WEST SIDE BIN 222934A,841,DEPARTMENT OF TRANSPORTATION,FAIR BRIDGES,100,MANHATTAN,HB-2934,53051,2137,0,1868,0,4604,45443,0,54052,2137,0,1868,0,4604,45443,0,54052,4274,0,3736,0,9208,90886,0,108104,PROJECT DELAYED DUE TO BUDGETARY CONSTRAINTS,RAMP TO NB HHP OVER AMTRAK WEST SIDE BIN 222934A,RAMP TO NB HHP OVER AMTRAK WEST SIDE BIN 222934A,cpd11-20mn.pdf
HBMA23216,Promenade over FDR E81st - 90th St Bin 2232167,841,DEPARTMENT OF TRANSPORTATION,FAIR BRIDGES,100,MANHATTAN,P-1018,312992,36303,0,0,995,138222,138223,0,313743,36303,0,0,995,138222,138223,0,313743,72606,0,0,1990,276444,276446,0,627486,,PROMENADE OVER FDR E81ST - 90TH ST BIN 2232167,PROMENADE OVER FDR E81ST - 90TH ST BIN 2232167,cpd11-20mn.pdf
HBMA24501,WEST 35TH ST/ AMTRAK 30ST BRANCH BIN# 224501E,841,DEPARTMENT OF TRANSPORTATION,FAIR BRIDGES,100,MANHATTAN,HB-1012 HB-0215,2739,1538,1012,2618,28003,0,0,0,33171,1538,1012,2618,28003,0,0,0,33171,3076,2024,5236,56006,0,0,0,66342,PROJECT DELAYED DUE TO BUDGETARY CONSTRAINTS,WEST 35TH ST/ AMTRAK 30ST BRANCH,WEST 35TH ST/ AMTRAK 30ST BRANCH,cpd11-20mn.pdf
HBMA24544,WEST 40TH ST / AMTRAK 30ST BRANCH BIN# 2245440,841,DEPARTMENT OF TRANSPORTATION,FAIR BRIDGES,100,MANHATTAN,HB-1012 HB-0215,4407,2356,2687,3787,42600,0,0,0,51430,2356,2687,3787,42600,0,0,0,51430,4712,5374,7574,85200,0,0,0,102860,PROJECT DELAYED DUE TO BUDGETARY CONSTRAINTS,,WEST 40TH ST / AMTRAK 30ST BRANCH BIN# 2245440,cpd11-20mn.pdf
HBMA24613,East Dr (Willowdell Arch) over Ped Path Opp East 67th st,841,DEPARTMENT OF TRANSPORTATION,FAIR BRIDGES,100,MANHATTAN,P-0508,2543,500,0,300,2043,0,0,0,2843,500,0,300,2043,0,0,0,2843,1000,0,600,4086,0,0,0,5686,PROJECT DELAYED DUE TO BUDGETARY CONSTRAINTS,,EAST DR (WILLOWDELL ARCH) OVER PED PATH OPP EAST 67TH ST,cpd11-20mn.pdf
HBMA26724,Trans-Manhattan Expressway BIN 2267240,841,DEPARTMENT OF TRANSPORTATION,BRIDGE LIFE EXTENSION AND MISCELLANEOUS WORK,100,MANHATTAN,HB-1078,429583,8535,25471,0,49510,301567,0,0,385083,8535,25471,0,49510,301567,0,0,385083,17070,50942,0,99020,603134,0,0,770166,PROJECT DELAYED DUE TO BUDGETARY CONSTRAINTS,REHAB OF TRANS MANHATTAN EXPRESSWAY CONNECTOR,REHAB OF TRANS MANHATTAN EXPRESSWAY CONNECTOR,cpd11-20mn.pdf
HBMFDNY20,FDNY/NFPA CODE UPDATE HHP VARIOUS AND PARK AVE TUNNEL,841,DEPARTMENT OF TRANSPORTATION,BRIDGE LIFE EXTENSION AND MISCELLANEOUS WORK,100,MANHATTAN,HB-0215,61000,2621,2221,57,0,57200,0,0,62099,2621,2221,57,0,57200,0,0,62099,5242,4442,114,0,114400,0,0,124198,PROJECT DELAYED DUE TO BUDGETARY CONSTRAINTS,,FDNY/NFPA CURRENT CODE UPDATE HHP VARIOUS SECTIONS AND PARK AVE TUNNEL,cpd11-20mn.pdf
HWD10216,Walk of Fame -- Walk of Fame installation in CD 8,841,DEPARTMENT OF TRANSPORTATION,PRIMARY STREET RECONSTRUCTION,100,MANHATTAN,HW-D102,500,0,0,0,0,0,500,0,500,0,0,0,0,0,500,0,500,0,0,0,0,0,1000,0,1000,PROJECT DELAYED DUE TO BUDGETARY CONSTRAINTS,WALK OF FAME -- WALK OF FAME INSTALLATION IN CD 8,WALK OF FAME -- WALK OF FAME INSTALLATION IN CD 8,cpd11-20mn.pdf
HWD10217,SAFETY IMPROVEMENTS,841,DEPARTMENT OF TRANSPORTATION,PRIMARY STREET RECONSTRUCTION,100,MANHATTAN,HW-D102,50,0,0,0,0,0,50,0,50,0,0,0,0,0,50,0,50,0,0,0,0,0,100,0,100,PROJECT DELAYED DUE TO BUDGETARY CONSTRAINTS,SAFETY IMPROVEMENTS,SAFETY IMPROVEMENTS,cpd11-20mn.pdf
HWD10220,DOT - 3rd Avenue Sidewalks,841,DEPARTMENT OF TRANSPORTATION,PRIMARY STREET RECONSTRUCTION,100,MANHATTAN,HW-D102 HW-0001M,2200,0,0,0,0,0,2200,0,2200,0,0,0,0,0,2200,0,2200,0,0,0,0,0,4400,0,4400,PROJECT DELAYED DUE TO BUDGETARY CONSTRAINTS,DOT - 3RD AVENUE SIDEWALKS,DOT - 3RD AVENUE SIDEWALKS,cpd11-20mn.pdf
HWD200-05,"Sidewalk Reconstruction, 125th St & Lexington",841,DEPARTMENT OF TRANSPORTATION,PRIMARY STREET RECONSTRUCTION,100,MANHATTAN,HW-D200,1000,0,0,0,0,0,1000,0,1000,0,0,0,0,0,1000,0,1000,0,0,0,0,0,2000,0,2000,PROJECT DELAYED DUE TO BUDGETARY CONSTRAINTS,"SIDEWALK RECONSTRUCTION, 125TH ST & LEXINGTON","SIDEWALK RECONSTRUCTION, 125TH ST & LEXINGTON",cpd11-20mn.pdf
HWM100CTN,23rd St Crosstown SBS,841,DEPARTMENT OF TRANSPORTATION,PRIMARY STREET RECONSTRUCTION,100,MANHATTAN,HW-1684,7750,0,0,0,0,0,0,7750,7750,0,0,0,0,0,0,7750,7750,0,0,0,0,0,0,15500,15500,PROJECT DELAYED DUE TO BUDGETARY CONSTRAINTS,14TH ST OR 23RD ST CROSSTOWN SBS,14TH ST OR 23RD ST CROSSTOWN SBS,cpd11-20mn.pdf
HWM1684,Allen & Pike Street Malls Phase 2,841,DEPARTMENT OF TRANSPORTATION,PRIMARY STREET RECONSTRUCTION,100,MANHATTAN,HW-0001M,4000,0,0,0,0,0,0,4000,4000,0,0,0,0,0,0,4000,4000,0,0,0,0,0,0,8000,8000,PROJECT DELAYED DUE TO BUDGETARY CONSTRAINTS,ALLEN & PIKE STREET MALLS PHASE 2,ALLEN & PIKE STREET MALLS PHASE 2,cpd11-20mn.pdf
HWM1687,Holland Tunnel Area Pedestrian Safety Improvements & Public,841,DEPARTMENT OF TRANSPORTATION,PRIMARY STREET RECONSTRUCTION,100,MANHATTAN,HW-0001M,12180,0,0,0,0,0,12180,0,12180,0,0,0,0,0,12180,0,12180,0,0,0,0,0,24360,0,24360,PROJECT DELAYED DUE TO BUDGETARY CONSTRAINTS,HOLLAND TUNNEL AREA PEDESTRIAN SAFETY IMPROVEMENTS & PUBLIC,HOLLAND TUNNEL AREA PEDESTRIAN SAFETY IMPROVEMENTS & PUBLIC,cpd11-20mn.pdf
HWM1688,Harlem Multi-Site,841,DEPARTMENT OF TRANSPORTATION,PRIMARY STREET RECONSTRUCTION,100,MANHATTAN,HW-0001M,15300,0,0,0,0,0,15300,0,15300,0,0,0,0,0,15300,0,15300,0,0,0,0,0,30600,0,30600,PROJECT DELAYED DUE TO BUDGETARY CONSTRAINTS,HARLEM MULTI-SITE,HARLEM MULTI-SITE,cpd11-20mn.pdf
HWM2026,YESHIVA UNIVERSITY AMSTERDAM AVENUE PUBLIC PLAZA,841,DEPARTMENT OF TRANSPORTATION,PRIMARY STREET RECONSTRUCTION,100,MANHATTAN,HW-M002,100,0,0,0,0,100,0,0,100,0,0,0,0,100,0,0,100,0,0,0,0,200,0,0,200,,YESHIVA UNIVERSITY AMSTERDAM AVENUE PUBLIC PLAZA,YESHIVA UNIVERSITY AMSTERDAM AVENUE PUBLIC PLAZA,cpd11-20mn.pdf
HWM300,BLEECKER ST.,841,DEPARTMENT OF TRANSPORTATION,PRIMARY STREET RECONSTRUCTION,100 102,MANHATTAN,HW-0001M,1200,0,0,0,0,0,0,0,0,0,0,0,0,0,0,0,0,0,0,0,0,0,0,0,0,PROJECT DELAYED DUE TO BUDGETARY CONSTRAINTS,BLEECKER ST.,BLEECKER ST.,cpd11-20mn.pdf
HWMBRT5,34th STREET,841,DEPARTMENT OF TRANSPORTATION,TRAFFIC WORK IN CONJUNCTION WITH HIGHWAY RECONSTRUCTION,100 104 105 106,MANHATTAN,TF-0777,25000,270,0,0,0,0,0,1861,2131,270,0,0,0,0,0,1861,2131,540,0,0,0,0,0,3722,4262,PROJECT DELAYED DUE TO BUDGETARY CONSTRAINTS,34TH STREET,34TH STREET,cpd11-20mn.pdf
HWMBRT6,1st & 2nd Avenue,841,DEPARTMENT OF TRANSPORTATION,TRAFFIC WORK IN CONJUNCTION WITH HIGHWAY RECONSTRUCTION,100,MANHATTAN,TF-0777,33608,2238,0,0,0,0,0,3171,5409,2238,0,0,0,0,0,3171,5409,4476,0,0,0,0,0,6342,10818,PROJECT DELAYED DUE TO BUDGETARY CONSTRAINTS,1ST & 2ND AVENUE,1ST & 2ND AVENUE,cpd11-20mn.pdf
HWMM009,GATEWAYS TO CHINATOWN,841,DEPARTMENT OF TRANSPORTATION,PRIMARY STREET RECONSTRUCTION,100 101 102 103,MANHATTAN,HW-0001M HW-D102,314,198,0,75,0,0,0,0,273,198,0,75,0,0,0,0,273,396,0,150,0,0,0,0,546,PROJECT DELAYED DUE TO BUDGETARY CONSTRAINTS,CHINA TOWN PARTNERSHIP LOCAL DEVELOPMENT CORP. I NC.,CHINA TOWN PARTNERSHIP LOCAL DEVELOPMENT CORP. I NC.,cpd11-20mn.pdf
HWMMLEXAV,Lexington Avenue Pedestrian Safety Improvements,841,DEPARTMENT OF TRANSPORTATION,PRIMARY STREET RECONSTRUCTION,100,MANHATTAN,HW-0001,13715,0,921,0,0,12794,0,0,13715,0,921,0,0,12794,0,0,13715,0,1842,0,0,25588,0,0,27430,,LEXINGTON AVENUE PEDESTRIAN SAFETY IMPROVEMENTS,LEXINGTON AVENUE PEDESTRIAN SAFETY IMPROVEMENTS,cpd11-20mn.pdf
HWMWTC A8,WORLD TRADE CENTER AREA 8,841,DEPARTMENT OF TRANSPORTATION,PRIMARY STREET RECONSTRUCTION,100 101,MANHATTAN,HW-1670 HW-0200 TF-0002 TF-0502,12504,0,0,0,0,0,0,0,0,0,0,0,0,0,0,0,0,0,0,0,0,0,0,0,0,PROJECT DELAYED DUE TO BUDGETARY CONSTRAINTS,RECONSTRUCTION OF WORLD TRADE CENTER,RECONSTRUCTION OF WORLD TRADE CENTER AREA 8.,cpd11-20mn.pdf
HWMWTC A9,WORLD TRADE CENTER AREA 9.,841,DEPARTMENT OF TRANSPORTATION,PRIMARY STREET RECONSTRUCTION,100 101,MANHATTAN,HW-1670 HW-0200 TF-0502,36299,0,0,0,0,0,0,1072,1072,0,0,0,0,0,0,1072,1072,0,0,0,0,0,0,2144,2144,PROJECT DELAYED DUE TO BUDGETARY CONSTRAINTS,RESURFACING WTC AREA 9,RESURFACING WORLD TRADE CENTER AREA 9.,cpd11-20mn.pdf
HWMWTC11,WORLD TRADE CENTER AREA 11,841,DEPARTMENT OF TRANSPORTATION,PRIMARY STREET RECONSTRUCTION,101,MANHATTAN,HW-1670 HW-0200 TF-0002 TF-0502,306,0,0,0,0,0,0,0,0,0,0,0,0,0,0,0,0,0,0,0,0,0,0,0,0,PROJECT DELAYED DUE TO BUDGETARY CONSTRAINTS,RECONSTRUCTION OF WORLD TRADE CENTER AREA 11,RECONSTRUCTION OF WORLD TRADE CENTER AREA 11,cpd11-20mn.pdf
HWMWTCA10,WORLD TRADE CENTER AREA 10,841,DEPARTMENT OF TRANSPORTATION,PRIMARY STREET RECONSTRUCTION,101,MANHATTAN,HW-1670 HW-0200 TF-0002 TF-0502,770,0,0,0,0,0,0,0,0,0,0,0,0,0,0,0,0,0,0,0,0,0,0,0,0,PROJECT DELAYED DUE TO BUDGETARY CONSTRAINTS,RECONSTRUCTION OF WORLD TRADE CENTER AREA 10,RECONSTRUCTION OF WORLD TRADE CENTER AREA 10,cpd11-20mn.pdf
HWMWTCB3,Reconstruction of Broadway,841,DEPARTMENT OF TRANSPORTATION,PRIMARY STREET RECONSTRUCTION,100,MANHATTAN,HW-0001M,10640,0,0,0,0,0,0,2128,2128,0,0,0,0,0,0,2128,2128,0,0,0,0,0,0,4256,4256,PROJECT DELAYED DUE TO BUDGETARY CONSTRAINTS,RECONSTRUCTION OF BROADWAY,RECONSTRUCTION OF BROADWAY,cpd11-20mn.pdf
HWMWTCB4,Reconstruction of Varick St,841,DEPARTMENT OF TRANSPORTATION,PRIMARY STREET RECONSTRUCTION,100,MANHATTAN,HW-0001M,397,0,0,0,0,0,0,80,80,0,0,0,0,0,0,80,80,0,0,0,0,0,0,160,160,PROJECT DELAYED DUE TO BUDGETARY CONSTRAINTS,RECONSTRUCTION OF VARICK ST,RECONSTRUCTION OF VARICK ST,cpd11-20mn.pdf
HWPLZ010M,Flatiron Plaza Reconstruction,841,DEPARTMENT OF TRANSPORTATION,LOCAL STREET RECONSTRUCTION,100 105,MANHATTAN,HW-D102 HW-0001M HW-1684,200,40,0,0,0,1000,0,8725,9765,40,0,0,0,1000,0,8725,9765,80,0,0,0,2000,0,17450,19530,PROJECT DELAYED DUE TO BUDGETARY CONSTRAINTS,FLATIRON PLAZA RECONSTRUCTION,FLATIRON PLAZA RECONSTRUCTION,cpd11-20mn.pdf
HWPLZ014M,Broadway Boulevard,841,DEPARTMENT OF TRANSPORTATION,PRIMARY STREET RECONSTRUCTION,100,MANHATTAN,HW-1684,18700,0,0,0,0,0,18700,0,18700,0,0,0,0,0,18700,0,18700,0,0,0,0,0,37400,0,37400,PROJECT DELAYED DUE TO BUDGETARY CONSTRAINTS,BROADWAY BOULEVARD,BROADWAY BOULEVARD,cpd11-20mn.pdf
HWPSMGANS,Gansevoort/Astor Planters,841,DEPARTMENT OF TRANSPORTATION,PRIMARY STREET RECONSTRUCTION,100,MANHATTAN,HW-0001,1046,0,0,1046,0,0,0,0,1046,0,0,1046,0,0,0,0,1046,0,0,2092,0,0,0,0,2092,PROJECT DELAYED DUE TO BUDGETARY CONSTRAINTS,GANSEVOORT/ASTOR PLANTERS,GANSEVOORT/ASTOR PLANTERS,cpd11-20mn.pdf
HWTFLMAD,Street Lamp Posts on Madison Avenue,841,DEPARTMENT OF TRANSPORTATION,PRIMARY STREET RECONSTRUCTION,100,MANHATTAN,TF-0502,236,0,0,0,0,236,0,0,236,0,0,0,0,236,0,0,236,0,0,0,0,472,0,0,472,PROJECT DELAYED DUE TO BUDGETARY CONSTRAINTS,STREET LAMP POSTS ON MADISON AVENUE,STREET LAMP POSTS ON MADISON AVENUE,cpd11-20mn.pdf
HWWTCLUMP,World Trade Center - Lump Sum,841,DEPARTMENT OF TRANSPORTATION,PRIMARY STREET RECONSTRUCTION,100,MANHATTAN,HW-0001M,23630,0,0,0,0,0,0,10676,10676,0,0,0,0,0,0,10676,10676,0,0,0,0,0,0,21352,21352,PROJECT DELAYED DUE TO BUDGETARY CONSTRAINTS,WORLD TRADE CENTER - LUMP SUM,WORLD TRADE CENTER - LUMP SUM,cpd11-20mn.pdf
REALTIMEM,Real Time Traffic Monitoring in Lower Manhattan,841,DEPARTMENT OF TRANSPORTATION,SIGNAL INSTALLATION AND COMPUTERIZATION,100,MANHATTAN,TF-0001,2800,3115,0,0,0,892,0,0,4007,3115,0,0,0,892,0,0,4007,6230,0,0,0,1784,0,0,8014,PROJECT DELAYED DUE TO BUDGETARY CONSTRAINTS,,REAL TIME SYSTEM FOR LOWER MANHATTAN,cpd11-20mn.pdf
REALTMIDM,Expand Real Time Traffic Monitoring in Midtown Manhattan,841,DEPARTMENT OF TRANSPORTATION,SIGNAL INSTALLATION AND COMPUTERIZATION,100,MANHATTAN,TF-0001,9480,4704,250,0,0,0,3369,2250,10573,4704,250,0,0,0,3369,2250,10573,9408,500,0,0,0,6738,4500,21146,,,TRAFFIC MONITORING IN MANHATTAN,cpd11-20mn.pdf
SANDHB001,Battery Park 2-23200 & West St 2-26738 Underpasses- Sandy,841,DEPARTMENT OF TRANSPORTATION,BRIDGE LIFE EXTENSION AND MISCELLANEOUS WORK,100 101,MANHATTAN,HB-0215,23000,17049,3295,137,0,0,0,0,20481,17049,3295,137,0,0,0,0,20481,34098,6590,274,0,0,0,0,40962,PROJECT DELAYED DUE TO BUDGETARY CONSTRAINTS,,REHABILITATION OF BATTERY PARK UNDERPASS (BIN 2-23200-0) AND WEST STREET UNDERPASS (BIN,cpd11-20mn.pdf
SANDHB2U,SANDY ER BETTERMENTS FOR BATTERY PARK & WEST ST UNDERPASSES,841,DEPARTMENT OF TRANSPORTATION,BRIDGE LIFE EXTENSION AND MISCELLANEOUS WORK,100,MANHATTAN,HB-0215,18850,826,0,3072,0,0,0,0,3898,826,0,3072,0,0,0,0,3898,1652,0,6144,0,0,0,0,7796,,,SANDY ER BETTERMENTS FOR BATTERY PARK & WEST ST UNDERPASSES,cpd11-20mn.pdf
SANDHBFDR,SANDY ER FOR FDR 18TH TO 25TH STREET,841,DEPARTMENT OF TRANSPORTATION,BRIDGE LIFE EXTENSION AND MISCELLANEOUS WORK,100,MANHATTAN,HB-0215,8414,503,1941,12,0,0,0,0,2456,503,1941,12,0,0,0,0,2456,1006,3882,24,0,0,0,0,4912,,,SANDY ER BETTERMENTS FOR FDR 18TH TO 25TH STREET,cpd11-20mn.pdf
SANDHW27,Montgomery to 15th Street - Hurricane Sandy,841,DEPARTMENT OF TRANSPORTATION,PRIMARY STREET RECONSTRUCTION,100,MANHATTAN,HW-0001M,16130,0,0,0,0,0,0,3226,3226,0,0,0,0,0,0,3226,3226,0,0,0,0,0,0,6452,6452,PROJECT DELAYED DUE TO BUDGETARY CONSTRAINTS,MONTGOMERY TO 15TH STREET - HURRICANE SANDY,MONTGOMERY TO 15TH STREET - HURRICANE SANDY,cpd11-20mn.pdf
TF50316,"Decor Historic lg on W13th St, from 7th Ave to XMA418.30A",841,DEPARTMENT OF TRANSPORTATION,INSTALLATION OF LAMPPOSTS AND LUMINAIRES,100,MANHATTAN,TF-0503,200,0,0,0,0,0,0,0,0,0,0,0,0,0,0,0,0,0,0,0,0,0,0,0,0,PROJECT DELAYED DUE TO BUDGETARY CONSTRAINTS,,FURNISH AND INSTALL DEC LIGHT ON WEST 13RH ST FROM 7TH AVENUE TO GREENWICH AVENUE,cpd11-20mn.pdf
TFCPARKLG,Central Park Light Infrastructure,841,DEPARTMENT OF TRANSPORTATION,REPLACEMENT OF ELECTRICAL DISTRIBUTION SYSTEMS,100,MANHATTAN,TF-0503,28000,23636,0,0,0,0,3272,1990,28898,23636,0,0,0,0,3272,1990,28898,47272,0,0,0,0,6544,3980,57796,PROJECT DELAYED DUE TO BUDGETARY CONSTRAINTS,CENTRA PARK LIGHT INFRASTRUCTURE,CENTRAL PARK LIGHT INFRASTRUCTURE,cpd11-20mn.pdf
TFD503-20,DOWNTOWN ALLIANCE-HISTORIC LIGHTPOLES,841,DEPARTMENT OF TRANSPORTATION,INSTALLATION OF LAMPPOSTS AND LUMINAIRES,100 101,MANHATTAN,TF-M503,383,527,0,0,0,38,0,0,565,527,0,0,0,38,0,0,565,1054,0,0,0,76,0,0,1130,PROJECT DELAYED DUE TO BUDGETARY CONSTRAINTS,DOWNTOWN ALLIANCE-HISTORIC LIGHTPOLES,DOWNTOWN ALLIANCE-HISTORIC LIGHTPOLES,cpd11-20mn.pdf
TFD503M29,Second Avenue Street lights,841,DEPARTMENT OF TRANSPORTATION,INSTALLATION OF LAMPPOSTS AND LUMINAIRES,100,MANHATTAN,TF-D503,434,258,0,0,0,176,0,0,434,258,0,0,0,176,0,0,434,516,0,0,0,352,0,0,868,,,2ND AVENUD LIGHT,cpd11-20mn.pdf
TFD503M30,Garment District street light,841,DEPARTMENT OF TRANSPORTATION,INSTALLATION OF LAMPPOSTS AND LUMINAIRES,100,MANHATTAN,TF-D503,150,0,0,0,0,150,0,0,150,0,0,0,0,150,0,0,150,0,0,0,0,300,0,0,300,,,DECORATIVE LIGHTING IN GARMENT DISTRICT,cpd11-20mn.pdf
TFD503M31,"Historic St lg on 11th St and on 12th St, Manhattan",841,DEPARTMENT OF TRANSPORTATION,INSTALLATION OF LAMPPOSTS AND LUMINAIRES,100,MANHATTAN,TF-D503,70,54,0,0,0,410,0,0,464,54,0,0,0,410,0,0,464,108,0,0,0,820,0,0,928,PROJECT DELAYED DUE TO BUDGETARY CONSTRAINTS,,DECORATIVE LIGHT,cpd11-20mn.pdf
TFD503M33,GREENWICH VILLAGE DECORATIVE LIGHTING,841,DEPARTMENT OF TRANSPORTATION,INSTALLATION OF LAMPPOSTS AND LUMINAIRES,100,MANHATTAN,TF-D503,250,194,0,0,0,56,0,0,250,194,0,0,0,56,0,0,250,388,0,0,0,112,0,0,500,PROJECT DELAYED DUE TO BUDGETARY CONSTRAINTS,,GREEWICH VILLAGE DECRATIVE LIGHTING,cpd11-20mn.pdf
TFD503M34,"Lg Poles on Crosby and Bleecker- NOHO, Manhattan",841,DEPARTMENT OF TRANSPORTATION,INSTALLATION OF LAMPPOSTS AND LUMINAIRES,100,MANHATTAN,TF-D503,80,0,0,80,0,0,0,0,80,0,0,80,0,0,0,0,80,0,0,160,0,0,0,0,160,,,OUTDOOR LIGHT POLES IN NOHO--TO SUPPORT INSTALLATION OF 4 OUTDOOR LIGHT POLES ON,cpd11-20mn.pdf
TFM503-09,COOPER SQUARE(61 EAST 4TH STREET)STREETSCAPE-LIGHTING,841,DEPARTMENT OF TRANSPORTATION,INSTALLATION OF LAMPPOSTS AND LUMINAIRES,100 102 103,MANHATTAN,TF-M503,65,32,0,0,0,42,0,0,74,32,0,0,0,42,0,0,74,64,0,0,0,84,0,0,148,PROJECT DELAYED DUE TO BUDGETARY CONSTRAINTS,,LIGHTING,cpd11-20mn.pdf
TFM50311,INSTALL S-POLE LIGHTING- VARIOUS STREETS WEST OF BROADWAY,841,DEPARTMENT OF TRANSPORTATION,INSTALLATION OF LAMPPOSTS AND LUMINAIRES,100 101 102,MANHATTAN,TF-M503,450,299,0,0,0,151,0,0,450,299,0,0,0,151,0,0,450,598,0,0,0,302,0,0,900,PROJECT DELAYED DUE TO BUDGETARY CONSTRAINTS,HISTORIC LIGHTING,HISTORIC LIGHTING,cpd11-20mn.pdf
TFM50316,Frederick Douglas Blvd Street Lamps,841,DEPARTMENT OF TRANSPORTATION,INSTALLATION OF LAMPPOSTS AND LUMINAIRES,100 110,MANHATTAN,TF-M503,198,305,0,0,0,41,0,0,346,305,0,0,0,41,0,0,346,610,0,0,0,82,0,0,692,PROJECT DELAYED DUE TO BUDGETARY CONSTRAINTS,,STREET LAMPS LAMPS FOR FREDERICK DOUGLAS BLVD,cpd11-20mn.pdf
W125STLG,"W 125TH ST LG & SIGNAL-5TH AVE TO MORNINGSIDE AVE, MA2288.3",841,DEPARTMENT OF TRANSPORTATION,INSTALLATION OF LAMPPOSTS AND LUMINAIRES,100 109 110,MANHATTAN,TF-0001,2056,1166,0,0,0,503,0,0,1669,1166,0,0,0,503,0,0,1669,2332,0,0,0,1006,0,0,3338,PROJECT DELAYED DUE TO BUDGETARY CONSTRAINTS,,INSTALLATION OF NEW DECORATIVE ST LIGHT AND STANDARD SIGNALS,cpd11-20mn.pdf
W147LIGH,West 147th Street Sugar Hill Historical Street Lights,841,DEPARTMENT OF TRANSPORTATION,INSTALLATION OF LAMPPOSTS AND LUMINAIRES,110,MANHATTAN,TF-M503,35,0,0,0,35,0,0,0,35,0,0,0,35,0,0,0,35,0,0,0,70,0,0,0,70,PROJECT DELAYED DUE TO BUDGETARY CONSTRAINTS,,,cpd11-20mn.pdf
WHTGIRDS2,Whitehall Ferry Terminal-Slip2 Girder Reconstruction,841,DEPARTMENT OF TRANSPORTATION,RECONSTRUCTION OF FERRY TERMINAL FACILITIES,100,MANHATTAN,FA-0021,2750,0,0,250,0,2500,0,0,2750,0,0,250,0,2500,0,0,2750,0,0,500,0,5000,0,0,5500,,,WHITEHALL FERRY TERMINAL - SLIP 2 GIRDER RECONSTRUCTION,cpd11-20mn.pdf
WHTGIRDS3,Whitehall Ferry Terminal-Slip3 Girder Reconstruction,841,DEPARTMENT OF TRANSPORTATION,RECONSTRUCTION OF FERRY TERMINAL FACILITIES,100,MANHATTAN,FA-0021,3000,0,0,500,0,2500,0,0,3000,0,0,500,0,2500,0,0,3000,0,0,1000,0,5000,0,0,6000,,,WHITEHALL FERRY TERMINAL - SLIP 3 GIRDER RECONSTRUCTION,cpd11-20mn.pdf
WHTLBRIDG,"Whitehall Slips 1,2,3 Bridge Reconstruction",841,DEPARTMENT OF TRANSPORTATION,RECONSTRUCTION OF FERRY TERMINAL FACILITIES,100,MANHATTAN,FA-0021,5300,1097,0,4203,0,0,0,0,5300,1097,0,4203,0,0,0,0,5300,2194,0,8406,0,0,0,0,10600,PROJECT DELAYED DUE TO BUDGETARY CONSTRAINTS,,"WHITEHALL SLIPS 1,2,3 LOWER BRIDGE RECONSTRUCTION",cpd11-20mn.pdf
ACEDPR408,Centralized HVAC Controls,846,DEPT OF PARKS AND RECREATION,"BUILDING CONSTRUCTION, RECONSTRUCTION OR RETROFIT",,MANHATTAN,P-1018 P-0505 PU-0025,1412,25,688,0,1412,0,0,0,2125,25,688,0,1412,0,0,0,2125,50,1376,0,2824,0,0,0,4250,,,INSTALLATION OF BUILDING CONTROLS TO OPTIMIZE HVAC SYSTEMS IN MULTIPLE FACILITES,cpd11-20mn.pdf
ACEDPR704,DPR - BMS (Building Management System) INSTALLATION,846,DEPT OF PARKS AND RECREATION,"BUILDING CONSTRUCTION, RECONSTRUCTION OR RETROFIT",101,MANHATTAN,PU-0025,234,0,0,234,0,0,0,0,234,0,0,234,0,0,0,0,234,0,0,468,0,0,0,0,468,,,DPR - BMS INSTALLATION,cpd11-20mn.pdf
NDF-DYMAN,NDF - Dyckman Sitting Area in Highbridge Park R/C,846,DEPT OF PARKS AND RECREATION,NEIGHBORHOOD PARKS AND PLAYGROUNDS,100,MANHATTAN,ED-0384,5000,75,437,0,4563,0,0,0,5075,75,437,0,4563,0,0,0,5075,150,874,0,9126,0,0,0,10150,,,"RENOVATE DYCKMAN REST IN HIGHBRIDGE PARK, BOROUGH OF MANHATTAN",cpd11-20mn.pdf
NDF-HRPCS,NDF Harlem River Park (M208D) - New Comfort Station,846,DEPT OF PARKS AND RECREATION,NEIGHBORHOOD PARKS AND PLAYGROUNDS,100,MANHATTAN,ED-0384,4716,273,4716,0,0,0,0,0,4989,273,4716,0,0,0,0,0,4989,546,9432,0,0,0,0,0,9978,,,NDF HARLEM RIVER PARK (M208D) - NEW COMFORT STATION,cpd11-20mn.pdf
NDF-IWOOD,NDF - Inwood Hill Park Soccer Field #1 R/C,846,DEPT OF PARKS AND RECREATION,"LARGE, MAJOR AND REGIONAL PARK RECONSTRUCTION",100 112,MANHATTAN,ED-0384 P-D018,6000,145,601,222,5399,0,0,0,6367,145,601,222,5399,0,0,0,6367,290,1202,444,10798,0,0,0,12734,,,"RENOVATE INWOOD HILL PARK SOCCER FIELD #1 (DYCKMAN FIELDS), BOROUGH OF MANHATTAN",cpd11-20mn.pdf
NDF-MKECS,NDF-Monsignor Kett Playground Comfort Station RC M199-119M,846,DEPT OF PARKS AND RECREATION,NEIGHBORHOOD PARKS AND PLAYGROUNDS,100,MANHATTAN,ED-0384,2690,123,4500,0,0,0,0,0,4623,123,4500,0,0,0,0,0,4623,246,9000,0,0,0,0,0,9246,,,MONSIGNOR KETT PLAYGROUND COMFORT STATION RECONSTRUCTION,cpd11-20mn.pdf
NDF-MKETT,"NDF - Monsignor Kett Playground R/C, M199-219M",846,DEPT OF PARKS AND RECREATION,NEIGHBORHOOD PARKS AND PLAYGROUNDS,100 112,MANHATTAN,ED-0384,15186,519,9346,0,0,0,0,0,9865,519,9346,0,0,0,0,0,9865,1038,18692,0,0,0,0,0,19730,,,"REBUILD MONSIGNOR KETT PLAYGROUND, BOROUGH OF MANHATTAN",cpd11-20mn.pdf
P-300EAST,East River Esplanade Projects - M108-119M,846,DEPT OF PARKS AND RECREATION,NEIGHBORHOOD PARKS AND PLAYGROUNDS,100,MANHATTAN,PU-0026 PU-0200 P-0501,23522,4278,2169,0,1634,0,0,0,8081,4278,2169,0,1634,0,0,0,8081,8556,4338,0,3268,0,0,0,16162,PROJECT DELAYED DUE TO CHANGES IN SCOPE/DESIGN,BOROUGH OF MANHATTAN,EAST RIVER ESPLANADE,cpd11-20mn.pdf
P-300ERES,East River Esplanade GLICK PK RC,846,DEPT OF PARKS AND RECREATION,NEIGHBORHOOD PARKS AND PLAYGROUNDS,100,MANHATTAN,P-1018,54,19,0,35,0,0,0,0,54,19,0,35,0,0,0,0,54,38,0,70,0,0,0,0,108,,,EAST RIVER ESPLANADE RECONSTRUCTION (M289-116M),cpd11-20mn.pdf
P-300LMDC,LMDC-(BUNDLED) PROJECTS MG-703M,846,DEPT OF PARKS AND RECREATION,"LARGE, MAJOR AND REGIONAL PARK RECONSTRUCTION",101 102 104,MANHATTAN,P-0245M,16499,2757,0,0,0,0,0,0,2757,2757,0,0,0,0,0,0,2757,5514,0,0,0,0,0,0,5514,PROJECT DELAYED PENDING RESOLUTION OF LEGAL ISSUES,MANHATTAN,LOWER MANHATTAN PROJECTS,cpd11-20mn.pdf
P-300ZO18,Central Park Zoo - Sea Lion Exhibit Renovation,846,DEPT OF PARKS AND RECREATION,ZOOS,100,MANHATTAN,P-0887,1800,0,250,1550,0,0,0,0,1800,0,250,1550,0,0,0,0,1800,0,500,3100,0,0,0,0,3600,,CENTRAL PARK ZOO - SEA LION EXHIBIT RENOVATION,CENTRAL PARK ZOO - SEA LION EXHIBIT RENOVATION,cpd11-20mn.pdf
P-300ZO19,Central Park Zoo - Roofs,846,DEPT OF PARKS AND RECREATION,ZOOS,100,MANHATTAN,P-0887,2300,0,200,2100,0,0,0,0,2300,0,200,2100,0,0,0,0,2300,0,400,4200,0,0,0,0,4600,,CENTRAL PARK ZOO - ROOFS,CENTRAL PARK ZOO - ROOFS,cpd11-20mn.pdf
P-300ZO20,Central Park Zoo - Tractor and attachments,846,DEPT OF PARKS AND RECREATION,ZOOS,100,MANHATTAN,P-D018,103,0,43,0,0,0,0,0,43,0,43,0,0,0,0,0,43,0,86,0,0,0,0,0,86,,CENTRAL PARK ZOO - TRACTOR AND ATTACHMENTS,CENTRAL PARK ZOO - TRACTOR AND ATTACHMENTS,cpd11-20mn.pdf
P-301BPBP,BATTERY PARK BIKEWAY PERIMETER M005-111M (SUPERCEDES 308M),846,DEPT OF PARKS AND RECREATION,"LARGE, MAJOR AND REGIONAL PARK RECONSTRUCTION",101,MANHATTAN,P-0828 P-0245M,350,1893,0,0,0,0,0,0,1893,1893,0,0,0,0,0,0,1893,3786,0,0,0,0,0,0,3786,PROJECT DELAYED PENDING APPROVAL OF NECESSARY PERMITS,BATTERY PARK BIKEWAY PERIMETER,BATTERY PARK BIKEWAY PERIMETER,cpd11-20mn.pdf
P-301BPCG,Battery Park Coast Guard Memorial Relocation (M005-217M),846,DEPT OF PARKS AND RECREATION,"LARGE, MAJOR AND REGIONAL PARK RECONSTRUCTION",100,MANHATTAN,P-0828,662,55,0,0,0,0,0,0,55,55,0,0,0,0,0,0,55,110,0,0,0,0,0,0,110,,BATTERY PARK COAST GUARD MEMORIAL RELOCATION,BATTERY PARK COAST GUARD MEMORIAL RELOCATION,cpd11-20mn.pdf
P-301BPOC,Battery Park Office convert to Comfort station M005,846,DEPT OF PARKS AND RECREATION,"LARGE, MAJOR AND REGIONAL PARK RECONSTRUCTION",101,MANHATTAN,P-M245 P-0828,500,100,0,565,0,0,0,0,665,100,0,565,0,0,0,0,665,200,0,1130,0,0,0,0,1330,PROJECT DELAYED DUE TO CHANGES IN SCOPE/DESIGN,BATTERY PK OFFICE CONVERT TO COMFORT STATION,BATTERY PK OFFICE CONVERT TO COMFORT STATION,cpd11-20mn.pdf
P-301BURL,LMDC-BURLING SLIP - IMAGINATION PLGD MG-41100-107M,846,DEPT OF PARKS AND RECREATION,NEIGHBORHOOD PARKS AND PLAYGROUNDS,100 101,MANHATTAN,SE-0002M,4125,4367,288,0,0,0,0,0,4655,4367,288,0,0,0,0,0,4655,8734,576,0,0,0,0,0,9310,PROJECT DELAYED DUE TO UNFORESEEN SITE/FIELD CONDITION,BURLING SLIP,BURLING SLIP,cpd11-20mn.pdf
P-301EPPK,"Elizabeth H. Berger Plaza, Manhattan",846,DEPT OF PARKS AND RECREATION,NEIGHBORHOOD PARKS AND PLAYGROUNDS,100 101,MANHATTAN,P-M245 HW-0001M P-1018,1000,6348,1358,0,0,0,0,0,7706,6348,1358,0,0,0,0,0,7706,12696,2716,0,0,0,0,0,15412,PROJECT DELAYED DUE TO BUDGETARY CONSTRAINTS,EDGAR PLAZA PARK - GREEN STREET,EDGAR PLAZA PARK - GREEN STREET,cpd11-20mn.pdf
P-301PEAR,LMDC-PEARL ST PLGD MG-41000-107M,846,DEPT OF PARKS AND RECREATION,NEIGHBORHOOD PARKS AND PLAYGROUNDS,100 101,MANHATTAN,P-0245M,852,873,0,0,0,0,0,0,873,873,0,0,0,0,0,0,873,1746,0,0,0,0,0,0,1746,PROJECT DELAYED DUE TO BUDGETARY CONSTRAINTS,PEARL ST PLGD,PEARL STREET PLAYGROUND,cpd11-20mn.pdf
P-301PECK,LMDC-PECK SLIP RECONSTRUCTION M167-106M,846,DEPT OF PARKS AND RECREATION,NEIGHBORHOOD PARKS AND PLAYGROUNDS,100 101,MANHATTAN,P-1018 P-0245M,4030,387,771,0,0,0,0,0,1158,387,771,0,0,0,0,0,1158,774,1542,0,0,0,0,0,2316,PROJECT DELAYED DUE TO SCHEDULING OF UTILITY WORK,"PECK SLIP RECONSTRUCTION, MANHATTAN","PECK SLIP RECONSTRUCTION, MANHATTAN",cpd11-20mn.pdf
P-302AIDM,NYC AIDS Memorial -- Capital Refurbishment to Memorial,846,DEPT OF PARKS AND RECREATION,"LARGE, MAJOR AND REGIONAL PARK RECONSTRUCTION",100,MANHATTAN,P-D018,150,0,0,0,0,150,0,0,150,0,0,0,0,150,0,0,150,0,0,0,0,300,0,0,300,PROJECT DELAYED DUE TO BUDGETARY CONSTRAINTS,,NYC AIDS MEMORIAL -- CAPITAL REFURBISHMENT TO MEMORIAL,cpd11-20mn.pdf
P-302BLEE,"Bleecker Street Playground,Manhattan",846,DEPT OF PARKS AND RECREATION,NEIGHBORHOOD PARKS AND PLAYGROUNDS,100,MANHATTAN,P-D018,0,0,0,0,1550,0,0,0,1550,0,0,0,1550,0,0,0,1550,0,0,0,3100,0,0,0,3100,,,"BLEECKER STREET PLAYGROUND,MANHATTAN",cpd11-20mn.pdf
P-302CJSC,CORPORAL JOHN A SERAVALLI PLGD CS RC M237-116M,846,DEPT OF PARKS AND RECREATION,NEIGHBORHOOD PARKS AND PLAYGROUNDS,102,MANHATTAN,P-D018,1700,1327,25,616,0,0,0,0,1968,1327,25,616,0,0,0,0,1968,2654,50,1232,0,0,0,0,3936,PROJECT DELAYED DUE TO CHANGES IN SCOPE/DESIGN,CORPORAL JOHN A SERAVALLI PLGD COMF STAT RECON,CORPORAL JOHN A SERAVALLI PLGD COMF STAT RECON,cpd11-20mn.pdf
P-302DPCA,DESALVIO PLGD RECON - ADULT USE & KID PLAY AREAS M218,846,DEPT OF PARKS AND RECREATION,NEIGHBORHOOD PARKS AND PLAYGROUNDS,102,MANHATTAN,P-D018,550,2330,0,160,0,0,0,0,2490,2330,0,160,0,0,0,0,2490,4660,0,320,0,0,0,0,4980,PROJECT DELAYED DUE TO BUDGETARY CONSTRAINTS,DESALVIO PLGD RECON - ADULT USE & KID PLAY AREAS,DESALVIO PLGD RECON - ADULT USE & KID PLAY AREAS,cpd11-20mn.pdf
P-302DRYD,DRY DOCK PLAYGROUND RECON M270-110M,846,DEPT OF PARKS AND RECREATION,NEIGHBORHOOD PARKS AND PLAYGROUNDS,102,MANHATTAN,P-D018 P-1018,800,2025,36,0,0,0,0,0,2061,2025,36,0,0,0,0,0,2061,4050,72,0,0,0,0,0,4122,PROJECT DELAYED DUE TO BUDGETARY CONSTRAINTS,DRY DOCK PLAYGROUND RECON,DRY DOCK PLAYGROUND RECON,cpd11-20mn.pdf
P-302GLAF,DEP Shaft Site -- Grand & Lafayette Streets,846,DEPT OF PARKS AND RECREATION,NEIGHBORHOOD PARKS AND PLAYGROUNDS,100 102,MANHATTAN,W-0013 P-D018 P-M245,300,240,1000,0,1352,0,0,0,2592,240,1000,0,1352,0,0,0,2592,480,2000,0,2704,0,0,0,5184,PROJECT DELAYED PENDING APPROVAL OF NECESSARY PERMITS,,DPR - GRAND & LAFAYETTE -- CREATE A NEW PARK AT THE GRAND AND LAFAYETTE STREET DEP,cpd11-20mn.pdf
P-302HUHO,DEP shaft site 28B - Hudson and West Houston,846,DEPT OF PARKS AND RECREATION,NEIGHBORHOOD PARKS AND PLAYGROUNDS,100,MANHATTAN,W-0013,0,68,1000,0,0,0,0,0,1068,68,1000,0,0,0,0,0,1068,136,2000,0,0,0,0,0,2136,PROJECT DELAYED PENDING RESOLUTION OF LEGAL ISSUES,,DEP SHAFT SITE 28B - HUDSON AND WEST HOUSTON,cpd11-20mn.pdf
P-302MHSA,DEP Shaft Site 31B at Bowery and East 4th Street,846,DEPT OF PARKS AND RECREATION,"LARGE, MAJOR AND REGIONAL PARK RECONSTRUCTION",100,MANHATTAN,W-0013 P-D018 P-M245,0,191,1000,169,101,0,0,0,1461,191,1000,169,101,0,0,0,1461,382,2000,338,202,0,0,0,2922,,,DEP SHAFT SITE 31B AT BOWERY AND EAST 4TH STREET,cpd11-20mn.pdf
P-303ASRC,Al Smith Rec Cntr-replace a/c & new windows,846,DEPT OF PARKS AND RECREATION,NEIGHBORHOOD PARKS AND PLAYGROUNDS,100,MANHATTAN,P-M245 P-D018,380,0,0,0,0,450,0,0,450,0,0,0,0,450,0,0,450,0,0,0,0,900,0,0,900,,AL SMITH REC CENTER,REPLACE A/C & NEW WINDOWS AT AL SMITH REC CENTER,cpd11-20mn.pdf
P-303BPCS,Baruch Playground C/S Renovations M165A-116M,846,DEPT OF PARKS AND RECREATION,NEIGHBORHOOD PARKS AND PLAYGROUNDS,100 103,MANHATTAN,P-1018,340,2071,132,0,0,0,0,0,2203,2071,132,0,0,0,0,0,2203,4142,264,0,0,0,0,0,4406,PROJECT DELAYED DUE TO CHANGES IN SCOPE/DESIGN,,"BARUCH PLAYGROUND BATHROOM RENOVATIONS -- RECONSTRUCT THE COMFORT STATION,",cpd11-20mn.pdf
P-303CRH2,"Corlears Hook Playground, Manhattan",846,DEPT OF PARKS AND RECREATION,NEIGHBORHOOD PARKS AND PLAYGROUNDS,100,MANHATTAN,P-D018,450,0,450,0,0,0,0,0,450,0,450,0,0,0,0,0,450,0,900,0,0,0,0,0,900,,,CORLEARS HOOK - CORLEARS HOOK PLAYGROUND -- FUNDING FOR PLAYGROUND UPGRADES,cpd11-20mn.pdf
P-303CRHP,"Corlear's Hook Park- Dod Run, M017-118M",846,DEPT OF PARKS AND RECREATION,NEIGHBORHOOD PARKS AND PLAYGROUNDS,100,MANHATTAN,P-1018,250,1173,130,0,0,0,0,0,1303,1173,130,0,0,0,0,0,1303,2346,260,0,0,0,0,0,2606,PROJECT DELAYED DUE TO BUDGETARY CONSTRAINTS,"CORLEAR'S HOOK PARK, MANHATTAN",CORLEAR'S HOOK PARK,cpd11-20mn.pdf
P-303ERSF,ERP - E 6TH ST SOCCER FLD NEW TURF M144-214m,846,DEPT OF PARKS AND RECREATION,NEIGHBORHOOD PARKS AND PLAYGROUNDS,100 103,MANHATTAN,P-D018 P-0510,600,3359,0,136,0,0,0,0,3495,3359,0,136,0,0,0,0,3495,6718,0,272,0,0,0,0,6990,PROJECT DELAYED DUE TO BUDGETARY CONSTRAINTS,ERP - E 6TH ST SOCCER FLD NEW TURF & LIGHTS,ERP - E 6TH ST SOCCER FLD NEW TURF & LIGHTS,cpd11-20mn.pdf
P-303ERWE,ERP-Composting Facility & Wetland R/C M144-116M,846,DEPT OF PARKS AND RECREATION,NEIGHBORHOOD PARKS AND PLAYGROUNDS,100,MANHATTAN,P-1245,1140,395,0,106,0,0,0,0,501,395,0,106,0,0,0,0,501,790,0,212,0,0,0,0,1002,PROJECT DELAYED PENDING RESOLUTION OF LEGAL ISSUES,EAST RIVER PK,CONSTRUCT WETLAND,cpd11-20mn.pdf
P-303HFFA,Hamilton Fish Rec. Center,846,DEPT OF PARKS AND RECREATION,NEIGHBORHOOD PARKS AND PLAYGROUNDS,100,MANHATTAN,P-0506,416,0,480,0,0,0,0,0,480,0,480,0,0,0,0,0,480,0,960,0,0,0,0,0,960,,"128 PITT STREET, MANHATTAN",FIRE ALARM RECONSTRUCTION AT HAMILITON FISH REC CENTER.,cpd11-20mn.pdf
P-303HFRC,Hamilton Fish Rec.Ctr-replace roof & alarm system,846,DEPT OF PARKS AND RECREATION,MAJOR RECREATIONAL FACILITIES AND FACILITY RECONSTRUCTION,100,MANHATTAN,P-0506 P-D018,300,0,0,699,0,300,19959,0,20958,0,0,699,0,300,19959,0,20958,0,0,1398,0,600,39918,0,41916,,HAMILTON FISH REC.CTR-,HAMILTON FISH REC.CTR-REPLACE ROOF & ALARM SYSTEM,cpd11-20mn.pdf
P-303HMFS,"Hamilton Fish Park-Full renovation , Manhattan",846,DEPT OF PARKS AND RECREATION,NEIGHBORHOOD PARKS AND PLAYGROUNDS,100,MANHATTAN,P-D018,0,0,100,0,3598,0,0,0,3698,0,100,0,3598,0,0,0,3698,0,200,0,7196,0,0,0,7396,,,HAMILTON FISH PARK-FULL RENOVATION,cpd11-20mn.pdf
P-303JACK,Jackie Robinson Rec Center Facades M014-114M,846,DEPT OF PARKS AND RECREATION,"LARGE, MAJOR AND REGIONAL PARK RECONSTRUCTION",100 110,MANHATTAN,P-1018,1400,2977,165,71,0,0,0,0,3213,2977,165,71,0,0,0,0,3213,5954,330,142,0,0,0,0,6426,,JACKIE ROBINSON REC CENTER,MASONRY WORK ON EXTERIOR FACADES,cpd11-20mn.pdf
P-303KIML,"Kimlau Square Improvements , Manhattan",846,DEPT OF PARKS AND RECREATION,NEIGHBORHOOD PARKS AND PLAYGROUNDS,100,MANHATTAN,P-D018,0,0,50,0,0,0,0,0,50,0,50,0,0,0,0,0,50,0,100,0,0,0,0,0,100,,,KIMLAU SQUARE IMPROVEMENTS -- TO UPGRADE KIMLAU SQUARE ARCH,cpd11-20mn.pdf
P-303KLSQ,Kim Lau Square,846,DEPT OF PARKS AND RECREATION,NEIGHBORHOOD PARKS AND PLAYGROUNDS,100,MANHATTAN,TF-D004,600,85,581,0,0,0,0,0,666,85,581,0,0,0,0,0,666,170,1162,0,0,0,0,0,1332,PROJECT DELAYED DUE TO UNFORESEEN SITE/FIELD CONDITION,"KIM LAU SQUARE RECONSTRUCTION, MANHATTAN",KIM LAU SQUARE,cpd11-20mn.pdf
P-303LFPG,"Reconstruction of Little Flower Playground, Manhattan",846,DEPT OF PARKS AND RECREATION,MAJOR RECREATIONAL FACILITIES AND FACILITY RECONSTRUCTION,100,MANHATTAN,P-1018,0,0,0,336,0,6415,0,0,6751,0,0,336,0,6415,0,0,6751,0,0,672,0,12830,0,0,13502,,,RECONSTRUCTION OF LITTLE FLOWER PLAYGROUND,cpd11-20mn.pdf
P-303LGPK,CPI PH1 - LUTHER GULICK PARK - RECON WEST PORTION,846,DEPT OF PARKS AND RECREATION,NEIGHBORHOOD PARKS AND PLAYGROUNDS,103,MANHATTAN,P-D018 P-1018 P-M245,360,4462,1169,1055,0,0,0,0,6686,4462,1169,1055,0,0,0,0,6686,8924,2338,2110,0,0,0,0,13372,PROJECT DELAYED PENDING NON-CITY GRANT APPROVAL,LUTHER GULICK PARK - RECON WEST PORTION,LUTHER GULICK PARK - RECON WEST PORTION,cpd11-20mn.pdf
P-303MCKY,"McKinley Playground renovation, M259-118M",846,DEPT OF PARKS AND RECREATION,NEIGHBORHOOD PARKS AND PLAYGROUNDS,100,MANHATTAN,P-M245,2505,2994,233,0,0,0,0,0,3227,2994,233,0,0,0,0,0,3227,5988,466,0,0,0,0,0,6454,,MCKINLEY PLAYGROUND RE4OVATION.,MCKINLEY PLAYGROUND RENOVATION.,cpd11-20mn.pdf
P-303SARD,"S.D. Roosevelt Pk-plgd&restrooms(Bldg D) M105-107M,108M/208M",846,DEPT OF PARKS AND RECREATION,"LARGE, MAJOR AND REGIONAL PARK RECONSTRUCTION",103,MANHATTAN,P-0245M,5077,1189,0,0,0,0,0,0,1189,1189,0,0,0,0,0,0,1189,2378,0,0,0,0,0,0,2378,PROJECT DELAYED PENDING APPROVAL OF NECESSARY PERMITS,"SARA DELANO ROOSEVELT PARK, MANHATTAN","SARA DELANO ROOSEVELT PARK, MANHATTAN",cpd11-20mn.pdf
P-303SDRB,Sara D. Roosevelt PK Store room convert to bathroom M105,846,DEPT OF PARKS AND RECREATION,"LARGE, MAJOR AND REGIONAL PARK RECONSTRUCTION",103,MANHATTAN,P-1018,500,1847,0,140,0,0,0,0,1987,1847,0,140,0,0,0,0,1987,3694,0,280,0,0,0,0,3974,PROJECT DELAYED DUE TO BUDGETARY CONSTRAINTS,SDR PK STOREROOM CONVERT TO BATHROOM,SDR PK STOREROOM CONVERT TO BATHROOM,cpd11-20mn.pdf
P-303SDRP,"Sara D. Roosevelt Park - Pathways, sidewalks, exterior walls",846,DEPT OF PARKS AND RECREATION,NEIGHBORHOOD PARKS AND PLAYGROUNDS,100,MANHATTAN,P-D018 P-M245,300,170,900,0,2340,0,0,0,3410,170,900,0,2340,0,0,0,3410,340,1800,0,4680,0,0,0,6820,PROJECT DELAYED DUE TO BUDGETARY CONSTRAINTS,"ROOSEVELT PARK, MANHATTAN","SARA. D ROOSEVELT PARK- PATHWAYS, SIDEWALKS, EXTERIOR WALLS",cpd11-20mn.pdf
P-303TPSQ,Tompkin's Square Park - Manhattan M088-119M,846,DEPT OF PARKS AND RECREATION,NEIGHBORHOOD PARKS AND PLAYGROUNDS,100,MANHATTAN,P-0926,4600,380,660,0,3940,1000,0,0,5980,380,660,0,3940,1000,0,0,5980,760,1320,0,7880,2000,0,0,11960,,,TOMPKIN'S SQUARE PARK - MANHATTAN,cpd11-20mn.pdf
P-303TSPL,PWOB-Tompkins Square Plgr-R/c at Ave B/E7,846,DEPT OF PARKS AND RECREATION,"LARGE, MAJOR AND REGIONAL PARK RECONSTRUCTION",100,MANHATTAN,P-1018,611,2770,231,0,0,0,0,0,3001,2770,231,0,0,0,0,0,3001,5540,462,0,0,0,0,0,6002,PROJECT DELAYED DUE TO BUDGETARY CONSTRAINTS,,TOMPKINS SQ PK,cpd11-20mn.pdf
P-30420S2,"West 20th St. Park Construction, M402-116M, Manhattan",846,DEPT OF PARKS AND RECREATION,NEIGHBORHOOD PARKS AND PLAYGROUNDS,100,MANHATTAN,ED-0075 P-D018,3043,2739,0,683,0,0,0,0,3422,2739,0,683,0,0,0,0,3422,5478,0,1366,0,0,0,0,6844,,,WEST 20TH ST. PARK CONSTRUCTION,cpd11-20mn.pdf
P-304CBBC,"Chelsea Basketball Court Renovation, Manhattan",846,DEPT OF PARKS AND RECREATION,NEIGHBORHOOD PARKS AND PLAYGROUNDS,100,MANHATTAN,P-D018,943,71,0,475,0,140,0,0,686,71,0,475,0,140,0,0,686,142,0,950,0,280,0,0,1372,,,CHELSEA BASKETBALL COURT RENOVATION -- THIS PROJECT WOULD REPAVE AND REPAINT THE,cpd11-20mn.pdf
P-304CCMP,Clement Clarke Moore Pk R/c of sitting area,846,DEPT OF PARKS AND RECREATION,NEIGHBORHOOD PARKS AND PLAYGROUNDS,100,MANHATTAN,P-1018,400,1741,0,137,0,0,0,0,1878,1741,0,137,0,0,0,0,1878,3482,0,274,0,0,0,0,3756,PROJECT DELAYED DUE TO BUDGETARY CONSTRAINTS,CLEMENT CLARKE MOORE PK,CLEMENT CLARKE MOORE PK R/C OF SITTING AREA,cpd11-20mn.pdf
P-304CRLB,"CHELSEA REC CTR ROOF DECK, LOCKER RM & BTHRM M260-114M",846,DEPT OF PARKS AND RECREATION,MAJOR RECREATIONAL FACILITIES AND FACILITY RECONSTRUCTION,104,MANHATTAN,P-1018,600,3341,190,0,0,0,0,0,3531,3341,190,0,0,0,0,0,3531,6682,380,0,0,0,0,0,7062,PROJECT DELAYED DUE TO CHANGES IN SCOPE/DESIGN,WEST 25TH STREET BETWEEN 9TH & 10TH AVENUES,"CHELSEA RECREATION CENTER ROOF DECK, LOCKER ROOM AND BATHROOM RECONSTRUCTION",cpd11-20mn.pdf
P-304DWIT,"De Witt Clinton Park- Staircase Recons, M022-118M",846,DEPT OF PARKS AND RECREATION,NEIGHBORHOOD PARKS AND PLAYGROUNDS,100,MANHATTAN,P-M245 P-0245M,500,1484,127,0,0,0,0,0,1611,1484,127,0,0,0,0,0,1611,2968,254,0,0,0,0,0,3222,PROJECT DELAYED DUE TO CHANGES IN SCOPE/DESIGN,DE WITT CLINTON PARK,DE WITT CLINTON PARK,cpd11-20mn.pdf
P-304HELK,"Hell's Kitchen Park -Surface Renovation, Manhattan",846,DEPT OF PARKS AND RECREATION,NEIGHBORHOOD PARKS AND PLAYGROUNDS,100,MANHATTAN,P-D018,450,0,450,0,0,0,0,0,450,0,450,0,0,0,0,0,450,0,900,0,0,0,0,0,900,,,PB,cpd11-20mn.pdf
P-304LRSQ,"Little Red Square, Manhattan, MG-41350-115M",846,DEPT OF PARKS AND RECREATION,NEIGHBORHOOD PARKS AND PLAYGROUNDS,100 102,MANHATTAN,P-1018,1140,2331,76,0,0,0,0,0,2407,2331,76,0,0,0,0,0,2407,4662,152,0,0,0,0,0,4814,PROJECT DELAYED DUE TO CHANGES IN SCOPE/DESIGN,,NYC PARKS DEPARTMENT -- LITTLE RED TRIANGLE -- RENOVATE EXISTING SITTING AREA AND EXPAND,cpd11-20mn.pdf
P-304MPPR,Mathews-Palmer Plgr-R/C North Side of Pk (M154-114M),846,DEPT OF PARKS AND RECREATION,NEIGHBORHOOD PARKS AND PLAYGROUNDS,104,MANHATTAN,P-D018,1800,3136,0,92,0,0,0,0,3228,3136,0,92,0,0,0,0,3228,6272,0,184,0,0,0,0,6456,PROJECT DELAYED DUE TO CHANGES IN SCOPE/DESIGN,MATTHEWS - PALMER PLGD RECON,MATTHEWS - PALMER PLGD RECON,cpd11-20mn.pdf
P-304PENN,"Penn South Playground, Manhattan",846,DEPT OF PARKS AND RECREATION,NEIGHBORHOOD PARKS AND PLAYGROUNDS,100,MANHATTAN,P-D018,400,0,400,0,0,0,0,0,400,0,400,0,0,0,0,0,400,0,800,0,0,0,0,0,800,,,PENN SOUTH PLAYGROUND,cpd11-20mn.pdf
P-305MSEL,Madison Square Park Pavement Reconstruction Manhattan,846,DEPT OF PARKS AND RECREATION,NEIGHBORHOOD PARKS AND PLAYGROUNDS,100,MANHATTAN,P-D018 P-1011 P-M245,3460,235,135,0,1365,0,0,0,1735,235,135,0,1365,0,0,0,1735,470,270,0,2730,0,0,0,3470,PROJECT DELAYED DUE TO CHANGES IN SCOPE/DESIGN,MADISON SQUARE PARK,MADISON SQUARE PARK CONSERVANCY,cpd11-20mn.pdf
P-305MSPK,"Madison Square Park Improvements,Manhattan",846,DEPT OF PARKS AND RECREATION,NEIGHBORHOOD PARKS AND PLAYGROUNDS,100,MANHATTAN,P-D018,200,0,200,0,0,0,0,0,200,0,200,0,0,0,0,0,200,0,400,0,0,0,0,0,400,,,MADISON SQUARE PARK IMPROVEMENTS,cpd11-20mn.pdf
P-305UNIO,UNION SQUARE RECONSTRUCTION M089-198,846,DEPT OF PARKS AND RECREATION,"LARGE, MAJOR AND REGIONAL PARK RECONSTRUCTION",105,MANHATTAN,WM-0001 WM-0006,7961,6352,369,0,0,0,0,0,6721,6352,369,0,0,0,0,0,6721,12704,738,0,0,0,0,0,13442,PROJECT DELAYED DUE TO CHANGES IN SCOPE/DESIGN,"BROADWAY TO 4 AVE, E. 14 TO E 17 STS","EXPAND THE CENTER OVAL INTO UNUSED STREET BEDS, RECONSTRUCTION OF PAVERBS, STONE",cpd11-20mn.pdf
P-306ALFA,Asser Levy Rec. Center,846,DEPT OF PARKS AND RECREATION,NEIGHBORHOOD PARKS AND PLAYGROUNDS,106,MANHATTAN,P-0506,721,0,1201,0,0,0,0,0,1201,0,1201,0,0,0,0,0,1201,0,2402,0,0,0,0,0,2402,,"392 ASSER LEVY PLACE, NEW YORK, NY 10010",FIRE ALARM RECONSTRUCTION AT ASSER LEVY REC. CENTER,cpd11-20mn.pdf
P-306APMU,Albano Playground Handball Court Multi-use Conve M265-117M,846,DEPT OF PARKS AND RECREATION,NEIGHBORHOOD PARKS AND PLAYGROUNDS,100 106,MANHATTAN,P-D018,354,150,564,0,236,0,0,0,950,150,564,0,236,0,0,0,950,300,1128,0,472,0,0,0,1900,PROJECT DELAYED PENDING RESOLUTION OF LEGAL ISSUES,,ALBANO PLAYGROUND HANDBALL COURT MULTI USE -- CONVERT HANDBALL COURT INTO MULTI USE,cpd11-20mn.pdf
P-306ASEQ,"Asser Levy Fitness Equipment, Manhattan",846,DEPT OF PARKS AND RECREATION,NEIGHBORHOOD PARKS AND PLAYGROUNDS,100,MANHATTAN,P-D018,250,0,100,150,0,0,0,0,250,0,100,150,0,0,0,0,250,0,200,300,0,0,0,0,500,,,ASSER LEVY FITNESS EQUIPMENT -- FUNDING FOR NEW FITNESS EQUIPMENT,cpd11-20mn.pdf
P-306ASLV,Asser Levy Recreation Center,846,DEPT OF PARKS AND RECREATION,NEIGHBORHOOD PARKS AND PLAYGROUNDS,100,MANHATTAN,P-D018 P-M245 P-1250,300,318,82,400,2900,0,0,0,3700,318,82,400,2900,0,0,0,3700,636,164,800,5800,0,0,0,7400,,"HVAC AT ASSER LEVY PLAYGROUND, MANHATTAN",HVAC AT ASSER LEVY PLAYGROUND,cpd11-20mn.pdf
P-306GLIC,Glick Park,846,DEPT OF PARKS AND RECREATION,NEIGHBORHOOD PARKS AND PLAYGROUNDS,100,MANHATTAN,PU-0200 P-0501,17276,158,0,0,15761,0,0,0,15919,158,0,0,15761,0,0,0,15919,316,0,0,31522,0,0,0,31838,,GLICK PARK,GLICK PARK,cpd11-20mn.pdf
P-306PETD,"Peter Detmold Park, Manhattan",846,DEPT OF PARKS AND RECREATION,NEIGHBORHOOD PARKS AND PLAYGROUNDS,100,MANHATTAN,P-D018 P-D822,560,0,100,380,0,0,0,0,480,0,100,380,0,0,0,0,480,0,200,760,0,0,0,0,960,,,RECONSTRUCTION OF WATER LINE AT PETER DETMOLD PARK. -- RENOVATIONS TOPARK,cpd11-20mn.pdf
P-306STVA,St. Vartan Park - Manhattan,846,DEPT OF PARKS AND RECREATION,NEIGHBORHOOD PARKS AND PLAYGROUNDS,100,MANHATTAN,P-0245M P-D018,5613,280,0,0,2051,2439,0,0,4770,280,0,0,2051,2439,0,0,4770,560,0,0,4102,4878,0,0,9540,,,ST. VARTAN PARK - MANHATTAN,cpd11-20mn.pdf
P-306TRPL,Tramway Plaza Irrigation,846,DEPT OF PARKS AND RECREATION,NEIGHBORHOOD PARKS AND PLAYGROUNDS,100 106 108,MANHATTAN,P-D018,60,10,0,0,0,50,0,0,60,10,0,0,0,50,0,0,60,20,0,0,0,100,0,0,120,PROJECT DELAYED DUE TO BUDGETARY CONSTRAINTS,,DEPARTMENT OF PARKS & RECREATION -- FUNDING WILL SUPPORT IMPROVEDMENTS AT TRAMWAY,cpd11-20mn.pdf
P-306TUDO,Tudor Grove Playground - Manhattan,846,DEPT OF PARKS AND RECREATION,NEIGHBORHOOD PARKS AND PLAYGROUNDS,100,MANHATTAN,P-D018 P-0245M,500,210,0,0,1395,0,0,0,1605,210,0,0,1395,0,0,0,1605,420,0,0,2790,0,0,0,3210,,,TUDOR GROVE PLAYGROUND - MANHATTAN,cpd11-20mn.pdf
P-307BLOC,CPI PH2 - Bloomingdale Comfort Station (CONS),846,DEPT OF PARKS AND RECREATION,NEIGHBORHOOD PARKS AND PLAYGROUNDS,100,MANHATTAN,P-1018 P-M245,1776,1420,1,292,0,0,0,0,1713,1420,1,292,0,0,0,0,1713,2840,2,584,0,0,0,0,3426,,CPI PH2 - BLOOMINGDALE PLGR COMFORT STATION RECO,CPI PH2 - BLOOMINGDALE PLGR COMFORT STATION RECO,cpd11-20mn.pdf
P-307BLOP,CPI PH2 - Bloomingdale Playground (construction)- M238-217M,846,DEPT OF PARKS AND RECREATION,NEIGHBORHOOD PARKS AND PLAYGROUNDS,100,MANHATTAN,P-1018 WP-0169,6138,4850,357,506,0,0,0,0,5713,4850,357,506,0,0,0,0,5713,9700,714,1012,0,0,0,0,11426,PROJECT DELAYED DUE TO CHANGES IN SCOPE/DESIGN,CPI PH2 - BLOOMINGDALE PLAYGROUND,FUNDS TO BE TRANSFERRED FROM P-307BLOO,cpd11-20mn.pdf
P-307BMAP,BROADWAY MALLS - RECON & UPGRADE BROADWAY MALLS,846,DEPT OF PARKS AND RECREATION,NEIGHBORHOOD PARKS AND PLAYGROUNDS,100 107 109 112,MANHATTAN,P-1018,400,1674,208,0,0,0,0,0,1882,1674,208,0,0,0,0,0,1882,3348,416,0,0,0,0,0,3764,PROJECT DELAYED DUE TO CHANGES IN SCOPE/DESIGN,BROADWAY MALLS - RECON & UPGRADE 14 MALLS,BROADWAY MALLS - RECON & UPGRADE 14 MALLS,cpd11-20mn.pdf
P-307RPKS,RIVERSIDE PARK SOUTH - PHASE 5 M353-112M,846,DEPT OF PARKS AND RECREATION,"LARGE, MAJOR AND REGIONAL PARK RECONSTRUCTION",100 107,MANHATTAN,P-0245M P-0380,10496,3549,513,0,0,0,0,0,4062,3549,513,0,0,0,0,0,4062,7098,1026,0,0,0,0,0,8124,PROJECT DELAYED DUE TO UNFORESEEN SITE/FIELD CONDITION,,RIVERSIDE PARK SOUTH - MILLER HGWY RELOC,cpd11-20mn.pdf
P-307RPPI,"RVSD PK SOUTH-SHADE STRUCTURES, SOCCER FIELD, REC AREA M071",846,DEPT OF PARKS AND RECREATION,NEIGHBORHOOD PARKS AND PLAYGROUNDS,100 107,MANHATTAN,P-D018 P-0380 P-1018,6485,6793,623,0,0,0,0,0,7416,6793,623,0,0,0,0,0,7416,13586,1246,0,0,0,0,0,14832,PROJECT DELAYED DUE TO CHANGES IN SCOPE/DESIGN,,"RIVERSIDE PARK RECONSTRUCT TURF BALL FIELD, ADJACENT ACTIVE RECREATION AND SHADE",cpd11-20mn.pdf
P-307RPSB,Riverside Park South Ph. 5 Building,846,DEPT OF PARKS AND RECREATION,"LARGE, MAJOR AND REGIONAL PARK RECONSTRUCTION",100 107,MANHATTAN,P-0380,2280,109,0,0,0,0,0,0,109,109,0,0,0,0,0,0,109,218,0,0,0,0,0,0,218,PROJECT DELAYED DUE TO CHANGES IN SCOPE/DESIGN,,RIVERSIDE PARK SOUTH PH. 5 BUILDING,cpd11-20mn.pdf
P-307RPTH,Riverside Park RC Pathways 91st-95th Streets,846,DEPT OF PARKS AND RECREATION,NEIGHBORHOOD PARKS AND PLAYGROUNDS,100,MANHATTAN,P-D018 P-0380,500,2144,170,266,0,0,0,0,2580,2144,170,266,0,0,0,0,2580,4288,340,532,0,0,0,0,5160,PROJECT DELAYED DUE TO BUDGETARY CONSTRAINTS,"RIVERSIDE PARK RC PATHWAYS 91ST-95TH STREETS, MANHATTAN",RIVERSIDE PARK RC PATHWAYS 91ST-95TH STREETS,cpd11-20mn.pdf
P-307RVSD,RIVERSIDE PK- CANTILEVER 83RD-91ST M071-297A,846,DEPT OF PARKS AND RECREATION,"LARGE, MAJOR AND REGIONAL PARK RECONSTRUCTION",107,MANHATTAN,P-0380,10058,14796,0,0,43,0,0,0,14839,14796,0,0,43,0,0,0,14839,29592,0,0,86,0,0,0,29678,PROJECT DELAYED DUE TO UNFORESEEN SITE/FIELD CONDITION,RIVERSIDE 133RD - 155TH STREET,RECON -FY'19E $1K ( P 0245M) B/L SWITCH TO P 0380...,cpd11-20mn.pdf
P-307SAPO,MATTHEW P. SAPOLIN PARK PLAYGROUND,846,DEPT OF PARKS AND RECREATION,NEIGHBORHOOD PARKS AND PLAYGROUNDS,100,MANHATTAN,P-D018 P-M245,870,135,755,50,0,750,0,0,1690,135,755,50,0,750,0,0,1690,270,1510,100,0,1500,0,0,3380,,W. 70 BETWEEN W. END AVE AND AMSTERDAM,MATTHEW P. SAPOLIN PARK PLAYGROUND,cpd11-20mn.pdf
P-307SOLB,"Sol Bloom Playground Improvements, Manhattan",846,DEPT OF PARKS AND RECREATION,"LARGE, MAJOR AND REGIONAL PARK RECONSTRUCTION",100,MANHATTAN,P-D018,600,0,100,500,0,0,0,0,600,0,100,500,0,0,0,0,600,0,200,1000,0,0,0,0,1200,,,SOL BLOOM PLAYGROUND IMPROVEMENTS -- FUNDING FOR PLAYGROUND UPGRADES,cpd11-20mn.pdf
P-307STGR,PWOB-St. Gregory's Park Reconstruction (M301-114M),846,DEPT OF PARKS AND RECREATION,NEIGHBORHOOD PARKS AND PLAYGROUNDS,100 107,MANHATTAN,P-D018 P-1018,1200,1525,111,0,0,0,0,0,1636,1525,111,0,0,0,0,0,1636,3050,222,0,0,0,0,0,3272,PROJECT DELAYED DUE TO CHANGES IN SCOPE/DESIGN,,NYC DPR - ST. GREGORY'S PARK -- PARK RECONSTRUCTION,cpd11-20mn.pdf
P-307TRDR,Theodore Roosevelt Park Dog Run Renovation,846,DEPT OF PARKS AND RECREATION,NEIGHBORHOOD PARKS AND PLAYGROUNDS,100 107,MANHATTAN,P-M245,300,916,63,0,0,0,0,0,979,916,63,0,0,0,0,0,979,1832,126,0,0,0,0,0,1958,PROJECT DELAYED DUE TO BUDGETARY CONSTRAINTS,,NYC DPR - THEODORE ROOSEVELT PARK -- DOG RUN RENOVATION,cpd11-20mn.pdf
P-308AG02,Asphalt Green- Pool Filter Upgrades,846,DEPT OF PARKS AND RECREATION,NEIGHBORHOOD PARKS AND PLAYGROUNDS,100,MANHATTAN,P-D018,713,0,713,0,0,0,0,0,713,0,713,0,0,0,0,0,713,0,1426,0,0,0,0,0,1426,PROJECT DELAYED DUE TO CHANGES IN SCOPE/DESIGN,ASPHALT GREEN POOL FILTER UPGRADES,ASPHALT GREEN - POOL FILTER UPGRADES,cpd11-20mn.pdf
P-308AG03,ASPHALT GREEN LOBBY EXPANSION & LOCKER UPGRADES,846,DEPT OF PARKS AND RECREATION,NEIGHBORHOOD PARKS AND PLAYGROUNDS,100,MANHATTAN,P-D018,1665,0,1665,0,0,0,0,0,1665,0,1665,0,0,0,0,0,1665,0,3330,0,0,0,0,0,3330,,,EXPANSION OF THE AQUACENTER LOBBY,cpd11-20mn.pdf
P-308AGDO,Ashphalt Green,846,DEPT OF PARKS AND RECREATION,NEIGHBORHOOD PARKS AND PLAYGROUNDS,100,MANHATTAN,P-M245,272,0,200,0,0,0,0,0,200,0,200,0,0,0,0,0,200,0,400,0,0,0,0,0,400,,,ASHPHALT GREEN,cpd11-20mn.pdf
P-308AGEE,"Asphalt Green- Energy Efficiency, Manhattan",846,DEPT OF PARKS AND RECREATION,NEIGHBORHOOD PARKS AND PLAYGROUNDS,100,MANHATTAN,P-D018,738,0,738,0,0,0,0,0,738,0,738,0,0,0,0,0,738,0,1476,0,0,0,0,0,1476,,,FY19 SECT 254 CC ADD $738K (PD018)....,cpd11-20mn.pdf
P-308AGFB,ASPHALT GREEN BOILER M286-114M,846,DEPT OF PARKS AND RECREATION,NEIGHBORHOOD PARKS AND PLAYGROUNDS,100 108,MANHATTAN,P-D018,1130,538,80,0,0,0,0,0,618,538,80,0,0,0,0,0,618,1076,160,0,0,0,0,0,1236,PROJECT DELAYED DUE TO CHANGES IN SCOPE/DESIGN,ASPHALT GREEN BOILER & BULKHEAD,ASPHALT GREEN BOILER & BULKHEAD,cpd11-20mn.pdf
P-308AGPF,Asphalt Green Pool Filtration,846,DEPT OF PARKS AND RECREATION,MAJOR RECREATIONAL FACILITIES AND FACILITY RECONSTRUCTION,100,MANHATTAN,P-D018,108,0,108,0,0,0,0,0,108,0,108,0,0,0,0,0,108,0,216,0,0,0,0,0,216,PROJECT DELAYED PENDING RESOLUTION OF LEGAL ISSUES,ASPHALT GREEN,ASPHALT GREEN-POOL FILTRATION,cpd11-20mn.pdf
P-308AGPO,Asphalt Green Pool Filtration,846,DEPT OF PARKS AND RECREATION,MAJOR RECREATIONAL FACILITIES AND FACILITY RECONSTRUCTION,100,MANHATTAN,P-D018,0,0,140,0,0,0,0,0,140,0,140,0,0,0,0,0,140,0,280,0,0,0,0,0,280,,,FY 21 ADPT SECT 254 ADD PD018 (CC) $140K...(ASPHALT GREEN INC. - OLYMPIC POOL RAISED-BOTTOM,cpd11-20mn.pdf
P-308CSPG,Carl Schurz Playground Reconstruction,846,DEPT OF PARKS AND RECREATION,"LARGE, MAJOR AND REGIONAL PARK RECONSTRUCTION",108,MANHATTAN,P-D018 P-1018,2848,3749,305,0,0,0,0,0,4054,3749,305,0,0,0,0,0,4054,7498,610,0,0,0,0,0,8108,,,RECONSTRUCTION OF CARL SCHURZ PLAYGROUND,cpd11-20mn.pdf
P-308EPOA,"POA East River Esplanade Improvements, Manhattan",846,DEPT OF PARKS AND RECREATION,NEIGHBORHOOD PARKS AND PLAYGROUNDS,100,MANHATTAN,P-0501,15000,200,0,0,0,0,15000,0,15200,200,0,0,0,0,15000,0,15200,400,0,0,0,0,30000,0,30400,,,"POA EAST RIVER ESPLANADE IMPROVEMENTS, MANHATTAN",cpd11-20mn.pdf
P-308EREI,ERP- East River Esplanade Improvements,846,DEPT OF PARKS AND RECREATION,NEIGHBORHOOD PARKS AND PLAYGROUNDS,100,MANHATTAN,P-D018 PU-0200,1450,264,2046,0,0,0,0,0,2310,264,2046,0,0,0,0,0,2310,528,4092,0,0,0,0,0,4620,PROJECT DELAYED DUE TO BUDGETARY CONSTRAINTS,EAST RIVER ESPLANADE IMPROVEMENTS,EAST RIVER ESPLANADE IMPROVEMENTS,cpd11-20mn.pdf
P-308ERP2,East River Esplanade Stabilization And Reconstruction PHASE,846,DEPT OF PARKS AND RECREATION,MAJOR RECREATIONAL FACILITIES AND FACILITY RECONSTRUCTION,100,MANHATTAN,P-0501 P-D018,8366,200,0,0,0,8366,0,0,8566,200,0,0,0,8366,0,0,8566,400,0,0,0,16732,0,0,17132,,,EAST RIVER ESPLANADE STABILIZATION AND RECONSTRUCTION PHASE,cpd11-20mn.pdf
P-308ERP3,EAST RIVER ESPLANADE PHASE 3+,846,DEPT OF PARKS AND RECREATION,MAJOR RECREATIONAL FACILITIES AND FACILITY RECONSTRUCTION,100,MANHATTAN,PU-0200 P-D018 P-0501 P-1018 P-1245,74350,230,0,40682,0,1000,29409,0,71321,230,0,40682,0,1000,29409,0,71321,460,0,81364,0,2000,58818,0,142642,,EAST RIVER ESPLANADE,EAST RIVER ESPLANADE,cpd11-20mn.pdf
P-308GRA1,GRACIE MANSION CHILLER RC M081,846,DEPT OF PARKS AND RECREATION,MAJOR RECREATIONAL FACILITIES AND FACILITY RECONSTRUCTION,100,MANHATTAN,P-0245M,926,878,0,65,0,0,0,0,943,878,0,65,0,0,0,0,943,1756,0,130,0,0,0,0,1886,,,GRACIE MANSION CHILLER RC M081,cpd11-20mn.pdf
P-308HNYL,"14 HONEY LOCUSTS PARK, Manhattan, M177-119M",846,DEPT OF PARKS AND RECREATION,NEIGHBORHOOD PARKS AND PLAYGROUNDS,100,MANHATTAN,P-0245M W-0013,1920,200,1531,139,0,0,0,0,1870,200,1531,139,0,0,0,0,1870,400,3062,278,0,0,0,0,3740,,,"14 HONEY LOCUSTS PARK, MANHATTAN",cpd11-20mn.pdf
P-308JJPK,"John Jay Park Reconstruction, M045-118M",846,DEPT OF PARKS AND RECREATION,NEIGHBORHOOD PARKS AND PLAYGROUNDS,100,MANHATTAN,P-D018,50,98,650,0,0,0,0,0,748,98,650,0,0,0,0,0,748,196,1300,0,0,0,0,0,1496,PROJECT DELAYED DUE TO CHANGES IN SCOPE/DESIGN,JOHN JAY PARK GREEN SPACE IMPROVEMENTS,JOHN JAY PARK GREEN SPACE IMPROVEMENTS,cpd11-20mn.pdf
P-308MHM2,MERCHANT HOUSE MUSEUM- EAST FACADE & SHUTTER RESTO M318,846,DEPT OF PARKS AND RECREATION,MAJOR RECREATIONAL FACILITIES AND FACILITY RECONSTRUCTION,100 102,MANHATTAN,P-D018 P-M245 P-C018,300,28,1260,0,0,0,0,0,1288,28,1260,0,0,0,0,0,1288,56,2520,0,0,0,0,0,2576,,"MERCHANT HOUSE MUSEUM- EAST FACADE & SHUTTER RESTORATION, MANHATTAN","MERCHANT HOUSE MUSEUM- EAST FACADE & SHUTTER RESTORATION, MANHATTAN",cpd11-20mn.pdf
P-308SPCS,24 Sycamores Park C/S Renovation M108-116M,846,DEPT OF PARKS AND RECREATION,NEIGHBORHOOD PARKS AND PLAYGROUNDS,100 108,MANHATTAN,P-D018,2040,1705,174,0,0,0,0,0,1879,1705,174,0,0,0,0,0,1879,3410,348,0,0,0,0,0,3758,,,24 SYCAMORES PARK -- RENOVATE BATHROOMS IN THE PARK,cpd11-20mn.pdf
P-308STCP,St. Catherine's Park -- sportscoating iin the children's p,846,DEPT OF PARKS AND RECREATION,NEIGHBORHOOD PARKS AND PLAYGROUNDS,100,MANHATTAN,P-D018,460,88,130,0,0,460,0,0,678,88,130,0,0,460,0,0,678,176,260,0,0,920,0,0,1356,PROJECT DELAYED DUE TO BUDGETARY CONSTRAINTS,,ÝDPRÛ ST. CATHERINE'S PARK -- IMPROVEMENTS TO THE SPORTSCOATING IN THE CHILDREN'S PLAY,cpd11-20mn.pdf
P-309AHAM,"Alexander Hamilton Plg Basketball Renovation ,Manhattan",846,DEPT OF PARKS AND RECREATION,NEIGHBORHOOD PARKS AND PLAYGROUNDS,100,MANHATTAN,P-M245,0,0,415,0,0,0,0,0,415,0,415,0,0,0,0,0,415,0,830,0,0,0,0,0,830,,,"ALEXANDER HAMILTON PLG BASKETBALL RENOVATION ,MANHATTAN",cpd11-20mn.pdf
P-309JRFA,Jackie Robinson Rec. Center,846,DEPT OF PARKS AND RECREATION,NEIGHBORHOOD PARKS AND PLAYGROUNDS,109,MANHATTAN,P-0506,390,0,518,0,0,0,0,0,518,0,518,0,0,0,0,0,518,0,1036,0,0,0,0,0,1036,,"85 BRADHURST AVENUE, NEW YORK, NY","FIRE ALARM RECONSTRUCTION AT JACKIE ROBINSON REC CENTER, MANHATTAN.",cpd11-20mn.pdf
P-309JRRC,Jackie Robinson Recreation Center HVAC System Reconstruction,846,DEPT OF PARKS AND RECREATION,MAJOR RECREATIONAL FACILITIES AND FACILITY RECONSTRUCTION,100 109 110,MANHATTAN,P-1250,4000,170,0,300,4000,0,0,0,4470,170,0,300,4000,0,0,0,4470,340,0,600,8000,0,0,0,8940,,"85 BRADHURST AVENUE NEW YORK, NY 10039, MANHATTAN",JACKIE ROBINSON RECREATION CENTER HVAC SYSTEM RECONSTRUCTION,cpd11-20mn.pdf
P-309JSPL,Jacob Schiff Playground Reconstruction,846,DEPT OF PARKS AND RECREATION,NEIGHBORHOOD PARKS AND PLAYGROUNDS,100,MANHATTAN,P-0245M,300,1229,93,0,0,0,0,0,1322,1229,93,0,0,0,0,0,1322,2458,186,0,0,0,0,0,2644,PROJECT DELAYED DUE TO BUDGETARY CONSTRAINTS,"JACOB SCHIFF PLAYGROUND, MANHATTAN",JACOB SCHIFF PLAYGROUND RECONSTRUCTION,cpd11-20mn.pdf
P-309JSST,"Jacob Schiff Park- Recons of Seating area, Manhattan",846,DEPT OF PARKS AND RECREATION,NEIGHBORHOOD PARKS AND PLAYGROUNDS,100 109,MANHATTAN,P-D018 P-1018,760,75,0,0,1520,0,0,0,1595,75,0,0,1520,0,0,0,1595,150,0,0,3040,0,0,0,3190,,,"JACOB SCHIFF PARK- RECONS OF SEATING AREA, MANHATTAN",cpd11-20mn.pdf
P-309MOR2,Morninside Pk- R/C of Plgr Phase 2 M056-116m,846,DEPT OF PARKS AND RECREATION,NEIGHBORHOOD PARKS AND PLAYGROUNDS,109,MANHATTAN,P-D018,1000,3141,0,536,0,0,0,0,3677,3141,0,536,0,0,0,0,3677,6282,0,1072,0,0,0,0,7354,PROJECT DELAYED DUE TO CHANGES IN SCOPE/DESIGN,MORNINGSIDE PARK 123RD ST PLGD PHASE 2,MORNINGSIDE PARK 123RD ST PLGD PHASE 2,cpd11-20mn.pdf
P-309MPMP,Morningside Park,846,DEPT OF PARKS AND RECREATION,NEIGHBORHOOD PARKS AND PLAYGROUNDS,100,MANHATTAN,P-M245,1450,3502,460,650,0,0,0,0,4612,3502,460,650,0,0,0,0,4612,7004,920,1300,0,0,0,0,9224,PROJECT DELAYED DUE TO CHANGES IN SCOPE/DESIGN,MORNINGSIDE PARK,RENOVATION OF MIDDLE PLAYGROUND,cpd11-20mn.pdf
P-309RBUS,RVSD DR -TIEMANN PL TO 97TH ST,846,DEPT OF PARKS AND RECREATION,NEIGHBORHOOD PARKS AND PLAYGROUNDS,100 107 109,MANHATTAN,P-0380,2000,1789,310,0,0,0,0,0,2099,1789,310,0,0,0,0,0,2099,3578,620,0,0,0,0,0,4198,PROJECT DELAYED DUE TO BUDGETARY CONSTRAINTS,,"UPGRADE RIVERSIDE DRIVE BETWEEN 97TH ST. AND TIEMANN, NEW YORK CITY",cpd11-20mn.pdf
P-309RPK1,"Riverside Park Improvements, Manhattan",846,DEPT OF PARKS AND RECREATION,"LARGE, MAJOR AND REGIONAL PARK RECONSTRUCTION",100,MANHATTAN,P-D018 P-0380,0,0,1300,1000,0,0,0,0,2300,0,1300,1000,0,0,0,0,2300,0,2600,2000,0,0,0,0,4600,,,RIVERSIDE PARK RENOVATIONS,cpd11-20mn.pdf
P-309RSLG,"Lighthouse Park Roosevelt Island, Manhattan",846,DEPT OF PARKS AND RECREATION,NEIGHBORHOOD PARKS AND PLAYGROUNDS,100,MANHATTAN,P-D018,0,0,70,0,0,0,0,0,70,0,70,0,0,0,0,0,70,0,140,0,0,0,0,0,140,,,FY 21 ADPT SECT 254 ADD PD018 (CC) $70K... (LIGHTHOUSE PARK - ACCESSIBILITY IMPROVEMENTS --,cpd11-20mn.pdf
P-309SKRP,Sakura Park - Reconstruction of the Staircase,846,DEPT OF PARKS AND RECREATION,NEIGHBORHOOD PARKS AND PLAYGROUNDS,100,MANHATTAN,P-0245M P-1329,425,1971,313,79,0,0,0,0,2363,1971,313,79,0,0,0,0,2363,3942,626,158,0,0,0,0,4726,PROJECT DELAYED DUE TO CHANGES IN SCOPE/DESIGN,SAKURA PARK,RECONSTRUCTION OF THE STAIRCASE,cpd11-20mn.pdf
P-309SSTF,"Jacob Schiff Playground Synthetic Turf Field Recon,Manhattan",846,DEPT OF PARKS AND RECREATION,NEIGHBORHOOD PARKS AND PLAYGROUNDS,100,MANHATTAN,P-0510,2919,135,525,0,2394,0,0,0,3054,135,525,0,2394,0,0,0,3054,270,1050,0,4788,0,0,0,6108,,,"JACOB SCHIFF PLAYGROUND SYNTHETIC TURF FIELD RECON,MANHATTAN",cpd11-20mn.pdf
P-309STNC,ST NICHOLAS NORTH COMFORT STATION M211-110MA2,846,DEPT OF PARKS AND RECREATION,NEIGHBORHOOD PARKS AND PLAYGROUNDS,109,MANHATTAN,P-D018,1300,1659,25,93,0,0,0,0,1777,1659,25,93,0,0,0,0,1777,3318,50,186,0,0,0,0,3554,PROJECT DELAYED DUE TO CHANGES IN SCOPE/DESIGN,ST NICHOLAS PARK NORTH COMFORT STATION,ST NICHOLAS PARK NORTH COMFORT STATION,cpd11-20mn.pdf
P-3107STP,107TH Street Pier Renovation M108-216M,846,DEPT OF PARKS AND RECREATION,MAJOR RECREATIONAL FACILITIES AND FACILITY RECONSTRUCTION,111,MANHATTAN,P-M245,250,130,0,0,0,237,0,0,367,130,0,0,0,237,0,0,367,260,0,0,0,474,0,0,734,,,107TH STREET PIER RENOVATION,cpd11-20mn.pdf
P-310ARFA,The Arsenal,846,DEPT OF PARKS AND RECREATION,NEIGHBORHOOD PARKS AND PLAYGROUNDS,100,MANHATTAN,P-0506,315,0,407,0,0,0,0,0,407,0,407,0,0,0,0,0,407,0,814,0,0,0,0,0,814,,"830 5TH AVENUE, THE ARSENAL NY, NY 10065","FIRE ALARM RECONSTRUCTION AT THE ARSENAL, MANHATTAN.",cpd11-20mn.pdf
P-310CCPG,Courtney Callendar Playground-handball court,846,DEPT OF PARKS AND RECREATION,NEIGHBORHOOD PARKS AND PLAYGROUNDS,100,MANHATTAN,P-D018,100,399,35,0,0,0,0,0,434,399,35,0,0,0,0,0,434,798,70,0,0,0,0,0,868,PROJECT DELAYED DUE TO CHANGES IN SCOPE/DESIGN,COURTNEY CALLENDAR PLAYGROUND,R/C OF SITTING AREA AT COURTNEY CALLENDAR PLAYGROUND,cpd11-20mn.pdf
P-310CCYB,COLONEL CHARLES YOUNG PK - BASEBALL FLDS RENOVATION M186,846,DEPT OF PARKS AND RECREATION,NEIGHBORHOOD PARKS AND PLAYGROUNDS,,MANHATTAN,P-D018,1000,75,0,0,0,751,0,0,826,75,0,0,0,751,0,0,826,150,0,0,0,1502,0,0,1652,PROJECT DELAYED DUE TO BUDGETARY CONSTRAINTS,,COLONEL YOUNG PARK - RENOVATION OF BASEBALL FIELDS,cpd11-20mn.pdf
P-310HCOM,HANSBOROUGH REC CTR COMPUTER PURCHASE M131,846,DEPT OF PARKS AND RECREATION,VEHICLES AND EQUIPMENT,110,MANHATTAN,P-M245,45,0,45,0,0,0,0,0,45,0,45,0,0,0,0,0,45,0,90,0,0,0,0,0,90,PROJECT DELAYED DUE TO CHANGES IN SCOPE/DESIGN,"HANSBOROUGH REC CTR COMPUTER PURCHASE, 35 WEST 134TH STREET",HANSBOROUGH REC CTR COMPUTER PURCHASE,cpd11-20mn.pdf
P-310HRFT,HANSBORO RC CTR REFURB GYM FL & TRACK SURFACE M131-114M,846,DEPT OF PARKS AND RECREATION,MAJOR RECREATIONAL FACILITIES AND FACILITY RECONSTRUCTION,100 110,MANHATTAN,P-D018,500,680,0,64,0,0,0,0,744,680,0,64,0,0,0,0,744,1360,0,128,0,0,0,0,1488,,HANSBORO RC CTR REFURB GYM FL & TRACK SURFACE,HANSBORO RC CTR REFURB GYM FL & TRACK SURFACE,cpd11-20mn.pdf
P-310JROB,JACKIE ROBINSON REC CTR - PH II M014-102M/103M,846,DEPT OF PARKS AND RECREATION,MAJOR RECREATIONAL FACILITIES AND FACILITY RECONSTRUCTION,110,MANHATTAN,P-C050,864,801,46,0,0,0,0,0,847,801,46,0,0,0,0,0,847,1602,92,0,0,0,0,0,1694,,MANHATTAN,PH II,cpd11-20mn.pdf
P-310MCCY,"McCray Playground , Manhattan",846,DEPT OF PARKS AND RECREATION,"LARGE, MAJOR AND REGIONAL PARK RECONSTRUCTION",100,MANHATTAN,P-D018,150,0,150,0,0,0,0,0,150,0,150,0,0,0,0,0,150,0,300,0,0,0,0,0,300,,,MCCRAY PALYGROUND,cpd11-20mn.pdf
P-311HCTR,HIGHBRIDGE RECREATION CTR -RC BOILERS AND HVAC - M037-217M,846,DEPT OF PARKS AND RECREATION,NEIGHBORHOOD PARKS AND PLAYGROUNDS,100,MANHATTAN,P-1250,3272,350,0,3774,0,0,0,0,4124,350,0,3774,0,0,0,0,4124,700,0,7548,0,0,0,0,8248,,MANHATTAN,HIGHBRIDGE RECREATION CTR RC,cpd11-20mn.pdf
P-311HEL3,"Phase 3 of Hell Gate Pathway, below Viaduct Randalls Island",846,DEPT OF PARKS AND RECREATION,NEIGHBORHOOD PARKS AND PLAYGROUNDS,100,MANHATTAN,WP-0112 P-X245,3140,602,517,140,0,0,0,0,1259,602,517,140,0,0,0,0,1259,1204,1034,280,0,0,0,0,2518,PROJECT DELAYED PENDING NON-CITY GRANT APPROVAL,PH 3 OF HELL GATE PATHWAY,PH 3 OF HELL GATE PATHWAY,cpd11-20mn.pdf
P-311HWTR,HIGHBRIDGE AQUEDUCT WATER TOWER RESTORATION M037-113M,846,DEPT OF PARKS AND RECREATION,NEIGHBORHOOD PARKS AND PLAYGROUNDS,100 112,MANHATTAN,P-0245M P-1018,742,4588,727,0,0,0,0,0,5315,4588,727,0,0,0,0,0,5315,9176,1454,0,0,0,0,0,10630,PROJECT DELAYED DUE TO BUDGETARY CONSTRAINTS,"HIGHBRIDGE AQUEDUCT WATER TOWER RESTORATION, MANHATTAN",HIGHBRIDGE AQUEDUCT WATER TOWER RESTORATION INCLUDING ROOF AND WINDOWS,cpd11-20mn.pdf
P-311MGFI,MARCUS GARVEY PK FIRE WATCHTOWER RESTORATION M058-115M,846,DEPT OF PARKS AND RECREATION,NEIGHBORHOOD PARKS AND PLAYGROUNDS,100,MANHATTAN,P-1018,280,7926,399,0,0,0,0,0,8325,7926,399,0,0,0,0,0,8325,15852,798,0,0,0,0,0,16650,,MARCUS GARVEY PK,FIRE WATCH TOWER RESTORATION,cpd11-20mn.pdf
P-311MGLL,MARCUS GARVEY CS LITTLE LEAGUE FACILTY M058-116M,846,DEPT OF PARKS AND RECREATION,NEIGHBORHOOD PARKS AND PLAYGROUNDS,111,MANHATTAN,P-1018 P-0245M,400,2323,768,0,0,0,0,0,3091,2323,768,0,0,0,0,0,3091,4646,1536,0,0,0,0,0,6182,PROJECT DELAYED DUE TO CHANGES IN SCOPE/DESIGN,MARCUS GARVEY LITTLE LEAGUE BLDG,MARCUS GARVEY LITTLE LEAGUE BLDG,cpd11-20mn.pdf
P-311PFFA,Pelham Fritz Rec. Center,846,DEPT OF PARKS AND RECREATION,NEIGHBORHOOD PARKS AND PLAYGROUNDS,111,MANHATTAN,P-0506,284,0,284,0,0,0,0,0,284,0,284,0,0,0,0,0,284,0,568,0,0,0,0,0,568,,"18 MOUNT MORRIS PARK WEST, MANHATTAN.",FIRE ALARM RECONSTRUCTION AT PELHAM FRITZ REC. CENTER.,cpd11-20mn.pdf
P-311PFRI,MARCUS GARVEY PK -PELHAM FRITZ RECREATION CTR CONS M058-118M,846,DEPT OF PARKS AND RECREATION,MAJOR RECREATIONAL FACILITIES AND FACILITY RECONSTRUCTION,100,MANHATTAN,P-0506,750,1069,109,0,0,0,0,0,1178,1069,109,0,0,0,0,0,1178,2138,218,0,0,0,0,0,2356,,,MARCUS GARVEY PK - PELHAM FRITZ RECREATION CTR CONS M058,cpd11-20mn.pdf
P-311PRPL,Poor Richard's Playground Renovations,846,DEPT OF PARKS AND RECREATION,NEIGHBORHOOD PARKS AND PLAYGROUNDS,100,MANHATTAN,P-D018 P-0245M,950,1410,0,99,0,0,0,0,1509,1410,0,99,0,0,0,0,1509,2820,0,198,0,0,0,0,3018,PROJECT DELAYED DUE TO CHANGES IN SCOPE/DESIGN,"POOR RICHARD'S PLAYGROUND RENOVATIONS, MANHATTAN",POOR RICHARDS PLAYGROUND RENOVATIONS,cpd11-20mn.pdf
P-311RIFW,RANDALL'S ISLAND FRESHWATER WETLANDS PATHWAY M104 M107 111M,846,DEPT OF PARKS AND RECREATION,"LARGE, MAJOR AND REGIONAL PARK RECONSTRUCTION",100 111,MANHATTAN,P-0245M,2208,498,0,0,0,0,0,0,498,498,0,0,0,0,0,0,498,996,0,0,0,0,0,0,996,PROJECT DELAYED PENDING RESOLUTION OF LEGAL ISSUES,RANDALL'S ISLAND FRESHWATER WETLANDS PATHWAY,"RANDALL'S ISLAND FRESHWATER WETLANDS PATHWAY, MANHATTAN",cpd11-20mn.pdf
P-311RILS,RANDALLS ISLAND LIVING SHORELINE M104-116M,846,DEPT OF PARKS AND RECREATION,"LARGE, MAJOR AND REGIONAL PARK RECONSTRUCTION",100,MANHATTAN,P-1018,1798,1415,0,186,0,0,0,0,1601,1415,0,186,0,0,0,0,1601,2830,0,372,0,0,0,0,3202,PROJECT DELAYED DUE TO CHANGES IN SCOPE/DESIGN,RANDALLS ISLAND,PORTION OF RANDALLS ISLAND LIVING SHORELINE,cpd11-20mn.pdf
P-311TJFA,Thomas Jefferson Rec. Center,846,DEPT OF PARKS AND RECREATION,NEIGHBORHOOD PARKS AND PLAYGROUNDS,111,MANHATTAN,P-0506,349,0,379,0,0,0,0,0,379,0,379,0,0,0,0,0,379,0,758,0,0,0,0,0,758,,"2180 1ST AVENUE, MANHATTAN.",FIRE ALARM RECONSTRUCTION AT THOMAS JEFFESON REC. CENTER.,cpd11-20mn.pdf
P-311TJHV,THOMAS JEFFERSON PARK REC CTR HVAC M047-109M,846,DEPT OF PARKS AND RECREATION,NEIGHBORHOOD PARKS AND PLAYGROUNDS,100 111,MANHATTAN,P-0245M,1000,320,0,0,0,0,0,0,320,320,0,0,0,0,0,0,320,640,0,0,0,0,0,0,640,PROJECT DELAYED DUE TO CHANGES IN SCOPE/DESIGN,THOMAS JEFFERSON PARK REC CTR HVAC,THOMAS JEFFERSON PARK REC CTR HVAC,cpd11-20mn.pdf
P-311TJPK,Thomas Jefferson Park Renovations,846,DEPT OF PARKS AND RECREATION,NEIGHBORHOOD PARKS AND PLAYGROUNDS,100,MANHATTAN,P-1018,350,691,59,0,0,0,0,0,750,691,59,0,0,0,0,0,750,1382,118,0,0,0,0,0,1500,PROJECT DELAYED DUE TO BUDGETARY CONSTRAINTS,"THOMAS JEFFERSON PARK RENOVATIONS, MANHATTAN",THOMAS JEFFERSON PARK RENOVATIONS,cpd11-20mn.pdf
P-311TURF,"Harlem River Park Synthetic Turf, Manhattan M208D-219M",846,DEPT OF PARKS AND RECREATION,NEIGHBORHOOD PARKS AND PLAYGROUNDS,100,MANHATTAN,P-0510,6650,285,0,1044,5171,0,0,0,6500,285,0,1044,5171,0,0,0,6500,570,0,2088,10342,0,0,0,13000,,,"HARLEM RIVER PARK FIELD ( AT 128TH ST)- SYNTHETIC TURF, MANHATTAN",cpd11-20mn.pdf
P-312DFAR,DYCKMAN FARMHOUSE,846,DEPT OF PARKS AND RECREATION,NEIGHBORHOOD PARKS AND PLAYGROUNDS,100,MANHATTAN,P-D018 P-1018 P-M245 P-0245M,750,17,1510,5091,0,0,0,0,6618,17,1510,5091,0,0,0,0,6618,34,3020,10182,0,0,0,0,13236,,DYCKMAN FARMHOUSE,DYCKMAN FARMHOUSE,cpd11-20mn.pdf
P-312IHB6,INWOOD HILL PARK BALLFIELD # 6 REGRADE & RESOD M042-110MA,846,DEPT OF PARKS AND RECREATION,"LARGE, MAJOR AND REGIONAL PARK RECONSTRUCTION",100 112,MANHATTAN,P-D018,500,688,36,0,0,0,0,0,724,688,36,0,0,0,0,0,724,1376,72,0,0,0,0,0,1448,PROJECT DELAYED DUE TO BUDGETARY CONSTRAINTS,INWOOD HILL PARK BALLFIELD # 6 REGRADE & RESOD,INWOOD HILL PARK BALLFIELD # 6 REGRADE & RESOD,cpd11-20mn.pdf
P-312IHPB,INWOOD HILL PK SANITARY SEWER FOR NATURE CTR M042-115M,846,DEPT OF PARKS AND RECREATION,"LARGE, MAJOR AND REGIONAL PARK RECONSTRUCTION",100 112,MANHATTAN,P-D018 P-1018,250,1169,0,102,0,0,0,0,1271,1169,0,102,0,0,0,0,1271,2338,0,204,0,0,0,0,2542,PROJECT DELAYED DUE TO CHANGES IN SCOPE/DESIGN,INWOOD HILL PARK BATHROOM RECON,INWOOD HILL PARK BATHROOM RECON,cpd11-20mn.pdf
P-312INNC,Inwood Hill Nature Center M042 -116M,846,DEPT OF PARKS AND RECREATION,NEIGHBORHOOD PARKS AND PLAYGROUNDS,100,MANHATTAN,P-D018 P-1018 P-0506,100,18,11,2947,0,0,0,0,2976,18,11,2947,0,0,0,0,2976,36,22,5894,0,0,0,0,5952,,"INWOOD NATURE CENTER, MANHATTAN",INWOOD NATURE CENTER,cpd11-20mn.pdf
P-312INNG,"RIVERSIDE-INWOOD NEIGHBORHOOD GARDENS, INC.",846,DEPT OF PARKS AND RECREATION,NEIGHBORHOOD PARKS AND PLAYGROUNDS,100,MANHATTAN,P-M245,50,0,0,0,0,50,0,0,50,0,0,0,0,50,0,0,50,0,0,0,0,100,0,0,100,PROJECT DELAYED DUE TO BUDGETARY CONSTRAINTS,"RIVERSIDE-INWOOD NEIGHBORHOOD GARDENS, INC","RIVERSIDE-INWOOD NEIGHBORHOOD GARDENS, INC.",cpd11-20mn.pdf
P-312INWD,Inwood Hill Nature Center- Exhibit Display Reconstruction,846,DEPT OF PARKS AND RECREATION,MAJOR RECREATIONAL FACILITIES AND FACILITY RECONSTRUCTION,100,MANHATTAN,P-1018,268,0,268,0,0,0,0,0,268,0,268,0,0,0,0,0,268,0,536,0,0,0,0,0,536,,"INWOOD HILL NATURE CENTER, MANHATTAN",RECONSTRUCTION OF THE EXHIBIT DISPLAY AT INWOOD HILL NATURE CENTER,cpd11-20mn.pdf
P-312ISA2,ISHAM PARK IRRIGATION & DRINK FOUNTAINS M043 M43112,846,DEPT OF PARKS AND RECREATION,NEIGHBORHOOD PARKS AND PLAYGROUNDS,112,MANHATTAN,P-D018,750,1064,60,0,0,0,0,0,1124,1064,60,0,0,0,0,0,1124,2128,120,0,0,0,0,0,2248,,ISHAM PARK IRRIGATION & DRINK FOUNTAINS,ISHAM PARK IRRIGATION & DRINK FOUNTAINS,cpd11-20mn.pdf
P-312JHFA,J. Hood Wright Rec. Center,846,DEPT OF PARKS AND RECREATION,NEIGHBORHOOD PARKS AND PLAYGROUNDS,112,MANHATTAN,P-0506,233,0,250,0,0,0,0,0,250,0,250,0,0,0,0,0,250,0,500,0,0,0,0,0,500,,"351 FT. WASHINGTON AVE, MANHATTAN.",FIRE ALARM RECONSTRUCTION AT J. HOOD WRIGHT REC. CENTER.,cpd11-20mn.pdf
P-312JHRW,J HOOD WRIGHT PARK REC CTR WINDOWS M099,846,DEPT OF PARKS AND RECREATION,NEIGHBORHOOD PARKS AND PLAYGROUNDS,100 112,MANHATTAN,P-D018,75,16,0,0,0,175,0,0,191,16,0,0,0,175,0,0,191,32,0,0,0,350,0,0,382,,J HOOD WRIGHT PARK REC CTR WINDOWS,J HOOD WRIGHT PARK REC CTR WINDOWS,cpd11-20mn.pdf
P-312JJPG,Jacob Javits Plgr-renovation,846,DEPT OF PARKS AND RECREATION,NEIGHBORHOOD PARKS AND PLAYGROUNDS,100,MANHATTAN,P-D018,1640,3164,0,277,0,0,0,0,3441,3164,0,277,0,0,0,0,3441,6328,0,554,0,0,0,0,6882,PROJECT DELAYED DUE TO BUDGETARY CONSTRAINTS,JACOB JAVITS PLGR,PLGR RENOVATION,cpd11-20mn.pdf
P-312MJM2,Morris Jumel mansion - exterior renovation- ph II M073,846,DEPT OF PARKS AND RECREATION,MAJOR RECREATIONAL FACILITIES AND FACILITY RECONSTRUCTION,100 112,MANHATTAN,P-1018,1500,457,0,0,0,0,0,0,457,457,0,0,0,0,0,0,457,914,0,0,0,0,0,0,914,PROJECT DELAYED DUE TO UNFORESEEN SITE/FIELD CONDITION,MORRIS JUMEL MANSION EXTERIOR (PERIMETER STREETSCAPE AND STONE WALLS)PHASE 2,MORRIS JUMEL MANSION EXTERIOR (PERIMETER STREETSCAPE AND STONE WALLS)RECONSTRUCTION,cpd11-20mn.pdf
P-313CPA2,CENTRAL PARK - ARSENAL ELEVATOR RC M010-616M,846,DEPT OF PARKS AND RECREATION,"LARGE, MAJOR AND REGIONAL PARK RECONSTRUCTION",100,MANHATTAN,P-1018,1546,1050,147,258,0,0,0,0,1455,1050,147,258,0,0,0,0,1455,2100,294,516,0,0,0,0,2910,,,CENTRAL PARK - ARSENAL ELEVATOR RC M010,cpd11-20mn.pdf
P-313CPAB,CENTRAL PARK - ARSENAL BRICK FACADE M010-214M,846,DEPT OF PARKS AND RECREATION,"LARGE, MAJOR AND REGIONAL PARK RECONSTRUCTION",100,MANHATTAN,P-1018,1133,2973,216,1213,0,0,0,0,4402,2973,216,1213,0,0,0,0,4402,5946,432,2426,0,0,0,0,8804,,,RC OF ARSENAL BRICK FACADE ALONG THE 4TH FLOOR SE TURRET 5TH FLOOR ELEVATOR TURRET,cpd11-20mn.pdf
P-313CPSW,Central Park - Swedish Cottage M010-116M,846,DEPT OF PARKS AND RECREATION,"LARGE, MAJOR AND REGIONAL PARK RECONSTRUCTION",100 104 105 107 108 110 111,MANHATTAN,P-D018,120,5,120,0,0,0,0,0,125,5,120,0,0,0,0,0,125,10,240,0,0,0,0,0,250,PROJECT DELAYED PENDING RESOLUTION OF LEGAL ISSUES,"CENTRAL PARK - SWEDISH COTTAGE, MANHATTAN","CENTRAL PARK - SWEDISH COTTAGE, MANHATTAN",cpd11-20mn.pdf
P-314RPDR,RIVERSIDE PARK DOG RUN M071,846,DEPT OF PARKS AND RECREATION,"LARGE, MAJOR AND REGIONAL PARK RECONSTRUCTION",109 112,MANHATTAN,P-0380 P-D018,76,68,350,100,0,0,0,0,518,68,350,100,0,0,0,0,518,136,700,200,0,0,0,0,1036,PROJECT DELAYED DUE TO CHANGES IN SCOPE/DESIGN,"RIVERSIDE DRIVE, HUDSON RIVER, WEST 72ND STREET, WEST 95TH STREET",RIVERSIDE PARK DOG RUN IN MANHATTAN,cpd11-20mn.pdf
P-3ANCH02,Highbridge Anchor Park Phase II- Manhattan M037-118M,846,DEPT OF PARKS AND RECREATION,NEIGHBORHOOD PARKS AND PLAYGROUNDS,100,MANHATTAN,P-1018 P-0415A,13740,11131,2021,0,0,0,0,0,13152,11131,2021,0,0,0,0,0,13152,22262,4042,0,0,0,0,0,26304,,,HIGHBRIDGE ANCHOR PARK PHASE II- MANHATTAN,cpd11-20mn.pdf
P-3ANCH03,"Highbridge Anchor Park Phase III- COMFORT STATION, M037-218M",846,DEPT OF PARKS AND RECREATION,NEIGHBORHOOD PARKS AND PLAYGROUNDS,100,MANHATTAN,P-0415A,4364,115,0,4202,0,0,0,0,4317,115,0,4202,0,0,0,0,4317,230,0,8404,0,0,0,0,8634,,,"HIGHBRIDGE ANCHOR PARK PHASE III- COMFORT STATION, MANHATTAN",cpd11-20mn.pdf
P-3ANCH04,"Highbridge Anchor Park Reconstruction Phase I, Manhattan",846,DEPT OF PARKS AND RECREATION,NEIGHBORHOOD PARKS AND PLAYGROUNDS,100,MANHATTAN,P-0415A P-1018 P-D018,10260,9772,1,1411,0,0,0,0,11184,9772,1,1411,0,0,0,0,11184,19544,2,2822,0,0,0,0,22368,,,"HIGHBRIDGE ANCHOR PARK RECONSTRUCTION PHASE I, MANHATTAN",cpd11-20mn.pdf
P-3ANNEPG,"ANNE LOFTUS PLAYGROUND//WATER PARK, M029-118M, Mahattan",846,DEPT OF PARKS AND RECREATION,NEIGHBORHOOD PARKS AND PLAYGROUNDS,100,MANHATTAN,P-D018,5701,380,0,4181,0,0,0,0,4561,380,0,4181,0,0,0,0,4561,760,0,8362,0,0,0,0,9122,,,"ANNE LOFTUS PLAYGROUND//WATER PARK, MAHATTAN",cpd11-20mn.pdf
P-3ASGRGN,ASPHALT GREEN,846,DEPT OF PARKS AND RECREATION,NEIGHBORHOOD PARKS AND PLAYGROUNDS,100,MANHATTAN,P-M245 P-D018,660,0,660,0,0,0,0,0,660,0,660,0,0,0,0,0,660,0,1320,0,0,0,0,0,1320,,,"ASPHALT GREEN, INC.",cpd11-20mn.pdf
P-3ASRRMP,Asser Levy Recreation Center Ramp Reconstruction,846,DEPT OF PARKS AND RECREATION,NEIGHBORHOOD PARKS AND PLAYGROUNDS,100,MANHATTAN,P-0506,192,93,57,0,0,0,0,0,150,93,57,0,0,0,0,0,150,186,114,0,0,0,0,0,300,,MANHATTAN,ASSER LEVY RECREATION CENTER RAMP RECONSTRUCTION,cpd11-20mn.pdf
P-3BBASIN,Riverside Park- Moving Costs Associated With The 79th Street,846,DEPT OF PARKS AND RECREATION,VEHICLES AND EQUIPMENT,100,MANHATTAN,P-0245M,493,156,231,0,0,0,0,0,387,156,231,0,0,0,0,0,387,312,462,0,0,0,0,0,774,,"698 WEST 135TH STREET, NEW YORK, NEW YORK 10031","THE RELOCATION OF THE RIVERSIDE PARK DISTRICT M&O OPERATIONS OUT OF THE W79TH ROTUNDA,",cpd11-20mn.pdf
P-3BBGARD,BATTERY PARK SEAGLASS CAROUSEL M005-208M,846,DEPT OF PARKS AND RECREATION,NEIGHBORHOOD PARKS AND PLAYGROUNDS,100 101,MANHATTAN,P-D018 P-0828,8230,5553,0,101,0,0,0,0,5654,5553,0,101,0,0,0,0,5654,11106,0,202,0,0,0,0,11308,PROJECT DELAYED DUE TO CHANGES IN SCOPE/DESIGN,BATTERY PARK CAROUSEL,BATTERY PARK CAROUSEL,cpd11-20mn.pdf
P-3BELLVU,"BELLEVUE PARK SOUTH, RECONS Mahattan",846,DEPT OF PARKS AND RECREATION,NEIGHBORHOOD PARKS AND PLAYGROUNDS,100,MANHATTAN,P-M245 P-D018 P-0245M,1500,430,150,0,4900,0,0,0,5480,430,150,0,4900,0,0,0,5480,860,300,0,9800,0,0,0,10960,PROJECT DELAYED DUE TO CHANGES IN SCOPE/DESIGN,,"BELLEVUE PARK SOUTH, MAHATTAN",cpd11-20mn.pdf
P-3BENNSF,BENNETT PARK SYNTHETIC FIELD,846,DEPT OF PARKS AND RECREATION,NEIGHBORHOOD PARKS AND PLAYGROUNDS,100,MANHATTAN,P-M245 P-D018,1100,50,100,1000,0,0,0,0,1150,50,100,1000,0,0,0,0,1150,100,200,2000,0,0,0,0,2300,,,BENNETT PARK SYNTHETIC FIELD,cpd11-20mn.pdf
P-3BOOKTW,"BOOKER T WASHINGTON Plg Synthetic Turf Rpl, Mahattan",846,DEPT OF PARKS AND RECREATION,NEIGHBORHOOD PARKS AND PLAYGROUNDS,100,MANHATTAN,P-0510,136,1715,370,0,0,0,0,0,2085,1715,370,0,0,0,0,0,2085,3430,740,0,0,0,0,0,4170,PROJECT DELAYED DUE TO CHANGES IN SCOPE/DESIGN,,BOOKER T WASHINGTON PLAYGROUND--SYNTHETIC TURF REPLACEMENT,cpd11-20mn.pdf
P-3BOTWAT,6BC Botanical Garden,846,DEPT OF PARKS AND RECREATION,NEIGHBORHOOD PARKS AND PLAYGROUNDS,100,MANHATTAN,P-D018,125,0,125,0,0,0,0,0,125,0,125,0,0,0,0,0,125,0,250,0,0,0,0,0,250,,,GARDEN WATER SOURCE AT 6BC BOTANICAL GARDEN.,cpd11-20mn.pdf
P-3BPPLGD,BATTERY PARK Plg (SOUTH FERRY-MTA) M005-117M,846,DEPT OF PARKS AND RECREATION,NEIGHBORHOOD PARKS AND PLAYGROUNDS,100 101,MANHATTAN,P-M245 P-1018 P-0828 P-D018,5100,3113,2076,0,0,0,0,0,5189,3113,2076,0,0,0,0,0,5189,6226,4152,0,0,0,0,0,10378,PROJECT DELAYED DUE TO BUDGETARY CONSTRAINTS,BATTERY PARK PLAYGROUND (SOUTH FERRY-MTA),BATTERY PARK PLAYGROUND (SOUTH FERRY-MTA),cpd11-20mn.pdf
P-3BWWATE,RPZ - WATER SERVICE INSTALLATION MG-518M,846,DEPT OF PARKS AND RECREATION,MAJOR RECREATIONAL FACILITIES AND FACILITY RECONSTRUCTION,100,MANHATTAN,P-0245M P-M245 P-C020 P-D018,340,135,691,0,0,0,0,0,826,135,691,0,0,0,0,0,826,270,1382,0,0,0,0,0,1652,,,RPZ - WATER SERVICE INSTALLATION,cpd11-20mn.pdf
P-3CENBOL,Central Park - Construction Security Measures,846,DEPT OF PARKS AND RECREATION,"LARGE, MAJOR AND REGIONAL PARK RECONSTRUCTION",100,MANHATTAN,P-1095,0,0,0,2050,0,19250,0,0,21300,0,0,2050,0,19250,0,0,21300,0,0,4100,0,38500,0,0,42600,,,CENTRAL PARK - CONSTRUCTION SECURITY MEASURES,cpd11-20mn.pdf
P-3CENT04,Central Park - Recon West Side Landscape M010-614M WO# 4,846,DEPT OF PARKS AND RECREATION,"LARGE, MAJOR AND REGIONAL PARK RECONSTRUCTION",100,MANHATTAN,P-1300,2462,2238,0,224,0,0,0,0,2462,2238,0,224,0,0,0,0,2462,4476,0,448,0,0,0,0,4924,PROJECT DELAYED DUE TO CHANGES IN SCOPE/DESIGN,,CENTRAL PARK - RECON WEST SIDE LANDSCAPE M010-614M WO# 4,cpd11-20mn.pdf
P-3CENT05,Central Park - Recon of CPW Perimeter M010-614M WO# 5,846,DEPT OF PARKS AND RECREATION,"LARGE, MAJOR AND REGIONAL PARK RECONSTRUCTION",100,MANHATTAN,P-1300,2420,2200,0,220,0,0,0,0,2420,2200,0,220,0,0,0,0,2420,4400,0,440,0,0,0,0,4840,PROJECT DELAYED DUE TO BUDGETARY CONSTRAINTS,,CENTRAL PARK - RECON OF CPW PERIMETER M010-614M WO# 5,cpd11-20mn.pdf
P-3CENT08,Central Park - Recons of Perimeter E84-E108ST WO# 8,846,DEPT OF PARKS AND RECREATION,"LARGE, MAJOR AND REGIONAL PARK RECONSTRUCTION",100,MANHATTAN,P-1300,0,4395,0,425,0,0,0,0,4820,4395,0,425,0,0,0,0,4820,8790,0,850,0,0,0,0,9640,,,"RECONSTRUCTION OF THE PARK PERIMETER LOCATED BETWEEN E84-E109 ST., CENTRAL PARK",cpd11-20mn.pdf
P-3CENT13,"Recon. of Naumburg Bandshell in Central Park, WO#13,",846,DEPT OF PARKS AND RECREATION,"LARGE, MAJOR AND REGIONAL PARK RECONSTRUCTION",100,MANHATTAN,P-1300,6927,6297,0,630,0,0,0,0,6927,6297,0,630,0,0,0,0,6927,12594,0,1260,0,0,0,0,13854,,,"RECON. OF NAUMBURG BANDSHELL IN CENTRAL PARK, WO#13,",cpd11-20mn.pdf
P-3CENTA,Central Park - Construction for Maintanence & Operation,846,DEPT OF PARKS AND RECREATION,"LARGE, MAJOR AND REGIONAL PARK RECONSTRUCTION",100,MANHATTAN,P-1300,57378,0,4245,3836,10394,4608,10608,30728,64419,0,4245,3836,10394,4608,10608,30728,64419,0,8490,7672,20788,9216,21216,61456,128838,PROJECT DELAYED DUE TO CHANGES IN SCOPE/DESIGN,CENTRAL PARK,CENTRAL PARK - CONSTRUCTION SERVICES FOR MAINTANENCE & OPERATION,cpd11-20mn.pdf
P-3CENTRL,"Central Park - Roller Skating Park Repaving, Manhattan",846,DEPT OF PARKS AND RECREATION,"LARGE, MAJOR AND REGIONAL PARK RECONSTRUCTION",100,MANHATTAN,P-M245,0,0,80,0,0,0,0,0,80,0,80,0,0,0,0,0,80,0,160,0,0,0,0,0,160,,,DPR- CENTRAL PARK ROLLER SKATING PARK REPAVING--FUNDING TO REPAVE THEROLLER SKATING,cpd11-20mn.pdf
P-3CHELPK,CHELSEA WATERSIDE PARK,846,DEPT OF PARKS AND RECREATION,NEIGHBORHOOD PARKS AND PLAYGROUNDS,100,MANHATTAN,P-M245,200,0,100,0,0,0,0,0,100,0,100,0,0,0,0,0,100,0,200,0,0,0,0,0,200,,,"CHELSEA WATERSIDE PARK IMPROVEMENTS TO THE FIELD AND RELATED ELEMENTS, MANHATTAN",cpd11-20mn.pdf
P-3CHLENT,Chelsea Recreation Center Entrance Lobby Recon,846,DEPT OF PARKS AND RECREATION,NEIGHBORHOOD PARKS AND PLAYGROUNDS,100,MANHATTAN,P-1018,260,0,158,102,0,0,0,0,260,0,158,102,0,0,0,0,260,0,316,204,0,0,0,0,520,,CHELSEA RECREATION CENTER,CHELSEA RECREATION CENTER ENTRANCE LOBBY RECON,cpd11-20mn.pdf
P-3CMGWAT,Childrens Magical Garden,846,DEPT OF PARKS AND RECREATION,NEIGHBORHOOD PARKS AND PLAYGROUNDS,100,MANHATTAN,P-D018,200,27,200,0,0,0,0,0,227,27,200,0,0,0,0,0,227,54,400,0,0,0,0,0,454,,,CHILDRENS MAGICAL GARDEN,cpd11-20mn.pdf
P-3COLPCS,COLUMBUS PARK -RENOVATE COMFORT STATION ON WORTH STREET,846,DEPT OF PARKS AND RECREATION,NEIGHBORHOOD PARKS AND PLAYGROUNDS,100,MANHATTAN,P-D018,1000,0,0,0,1000,0,0,0,1000,0,0,0,1000,0,0,0,1000,0,0,0,2000,0,0,0,2000,,,COLUMBUS PARK -- RENOVATE COMFORT STATION ON WORTH STREET,cpd11-20mn.pdf
P-3COLUBT,"COLUMBUS PARK - COLUMBUS PARK NEW TURF, Manhattan",846,DEPT OF PARKS AND RECREATION,NEIGHBORHOOD PARKS AND PLAYGROUNDS,100,MANHATTAN,P-D018,552,0,552,0,0,0,0,0,552,0,552,0,0,0,0,0,552,0,1104,0,0,0,0,0,1104,,,COLUMBUS PARK NEW TURF -- TO PROVIDE NEW TURF FOR COLUMBUS PARK,cpd11-20mn.pdf
P-3COLUMB,"COLUMBUS PARK - Entrance Renovation, Manhattan",846,DEPT OF PARKS AND RECREATION,NEIGHBORHOOD PARKS AND PLAYGROUNDS,100,MANHATTAN,P-D018 P-1018,219,489,42,0,0,0,0,0,531,489,42,0,0,0,0,0,531,978,84,0,0,0,0,0,1062,,COLUMBUS PARK - ENTRANCE RENOVATION -- TURN THE MULBERRY ST. ENTRANCESTEPS AT,COLUMBUS PARK - ENTRANCE RENOVATION -- TURN THE MULBERRY ST. ENTRANCESTEPS AT,cpd11-20mn.pdf
P-3CPI3A2,CPI PH2 - ABRAHAM LINCOLN CS RC,846,DEPT OF PARKS AND RECREATION,NEIGHBORHOOD PARKS AND PLAYGROUNDS,100,MANHATTAN,P-1018,1940,1265,766,0,0,0,0,0,2031,1265,766,0,0,0,0,0,2031,2530,1532,0,0,0,0,0,4062,,,CPI PH3 - ABRAHAM LINCOLN CS RC,cpd11-20mn.pdf
P-3CPI3AB,CPI PH2 - Audubon Plg & Comf Reconstruction (DESIGN),846,DEPT OF PARKS AND RECREATION,NEIGHBORHOOD PARKS AND PLAYGROUNDS,100,MANHATTAN,P-1018,5909,1039,275,0,0,0,0,0,1314,1039,275,0,0,0,0,0,1314,2078,550,0,0,0,0,0,2628,,,CPI PH3 - AUDUBON PLAYGROUND RECONSTRUCTION,cpd11-20mn.pdf
P-3CPI3AC,CPI PH2 - Audubon Comfort Station Recons M240-218M,846,DEPT OF PARKS AND RECREATION,NEIGHBORHOOD PARKS AND PLAYGROUNDS,100,MANHATTAN,P-1018,2100,1117,501,0,0,0,0,0,1618,1117,501,0,0,0,0,0,1618,2234,1002,0,0,0,0,0,3236,,,CPI PH2 - AUDUBON COMFORT STATION RECONSTRUCTION,cpd11-20mn.pdf
P-3CPI3AL,CPI PH2 - Abraham Lincoln plg ....,846,DEPT OF PARKS AND RECREATION,NEIGHBORHOOD PARKS AND PLAYGROUNDS,100,MANHATTAN,P-1018,8932,9045,29,1086,0,0,0,0,10160,9045,29,1086,0,0,0,0,10160,18090,58,2172,0,0,0,0,20320,,,CPI PH3 - ABRAHAM LINCOLN PLG & COMFORT STATION RECONS..,cpd11-20mn.pdf
P-3CPI3AP,CPI PH2 - Audubon Playground Reconst M240-118M,846,DEPT OF PARKS AND RECREATION,NEIGHBORHOOD PARKS AND PLAYGROUNDS,100,MANHATTAN,P-1018,3320,5993,52,1167,0,0,0,0,7212,5993,52,1167,0,0,0,0,7212,11986,104,2334,0,0,0,0,14424,,,CPI PH2 - AUDUBON PLAYGROUND RECONSTRUCTION,cpd11-20mn.pdf
P-3CPIBBJ,CPI PH2 - Bill Bojangles Playground,846,DEPT OF PARKS AND RECREATION,NEIGHBORHOOD PARKS AND PLAYGROUNDS,100,MANHATTAN,P-1018,1590,1907,419,0,0,0,0,0,2326,1907,419,0,0,0,0,0,2326,3814,838,0,0,0,0,0,4652,,,CPI PH2 - BILL BOJANLES PLAYGROUND,cpd11-20mn.pdf
P-3CPIBN9,CPI PH1 Plg 103 and St Nicholas North Plg Recons (MG-216M),846,DEPT OF PARKS AND RECREATION,"LARGE, MAJOR AND REGIONAL PARK RECONSTRUCTION",100,MANHATTAN,P-1018,10861,8810,0,0,177,0,0,0,8987,8810,0,0,177,0,0,0,8987,17620,0,0,354,0,0,0,17974,PROJECT DELAYED DUE TO SCHEDULING OF UTILITY WORK,,,cpd11-20mn.pdf
P-3CPIFGC,"CPI PH2 - Frederick Johnson Comfort Station, M141-418M",846,DEPT OF PARKS AND RECREATION,NEIGHBORHOOD PARKS AND PLAYGROUNDS,100,MANHATTAN,P-1018,5200,128,574,371,3701,0,0,0,4774,128,574,371,3701,0,0,0,4774,256,1148,742,7402,0,0,0,9548,,,FY19 PENDING TRANSFER....,cpd11-20mn.pdf
P-3CPIFJP,CPI PH2 -Frederick Johnson Playground M159-219M,846,DEPT OF PARKS AND RECREATION,NEIGHBORHOOD PARKS AND PLAYGROUNDS,100,MANHATTAN,P-1018,5300,5270,740,0,0,0,0,0,6010,5270,740,0,0,0,0,0,6010,10540,1480,0,0,0,0,0,12020,,,CPI PH2 -FREDERICK JOHNSON PLAYGROUND M141-218M,cpd11-20mn.pdf
P-3CPIHLP,"CPI PH2 - Harlem Lane Playground, MG-119M",846,DEPT OF PARKS AND RECREATION,NEIGHBORHOOD PARKS AND PLAYGROUNDS,100,MANHATTAN,P-0245M P-1018,7930,200,0,7975,0,0,0,0,8175,200,0,7975,0,0,0,0,8175,400,0,15950,0,0,0,0,16350,,,"CPI PH2 - HARLEM LANE PLAYGROUND, M141-318M",cpd11-20mn.pdf
P-3CPIJWJ,CPI - James Weldon Johnson Play (M111-115M),846,DEPT OF PARKS AND RECREATION,NEIGHBORHOOD PARKS AND PLAYGROUNDS,100 111,MANHATTAN,P-1018,3738,5129,441,0,0,0,0,0,5570,5129,441,0,0,0,0,0,5570,10258,882,0,0,0,0,0,11140,PROJECT DELAYED DUE TO CHANGES IN SCOPE/DESIGN,BOROUGH OF MANHATTAN - EAST 115 STREET BETWEEN 3 & LEXINGTON AVENUES.,RECONSTRUCTION OF JAMES WELDON JOHNSON PLAYGROUND,cpd11-20mn.pdf
P-3CPIMLK,"CPI - Phase 1-Martin L.King Plgr, Manhattan",846,DEPT OF PARKS AND RECREATION,NEIGHBORHOOD PARKS AND PLAYGROUNDS,100,MANHATTAN,P-1018,5588,4210,0,163,0,0,0,0,4373,4210,0,163,0,0,0,0,4373,8420,0,326,0,0,0,0,8746,,"CPI - PHASE 1-MARTIN L.KING PLGR, MANHATTAN",CPI - PHASE 1-MARTIN L.KING PLGR,cpd11-20mn.pdf
P-3CPIPGI,"CPI PH2 -Playground One, M196-118M",846,DEPT OF PARKS AND RECREATION,NEIGHBORHOOD PARKS AND PLAYGROUNDS,100,MANHATTAN,P-1018,2801,3377,494,0,0,0,0,0,3871,3377,494,0,0,0,0,0,3871,6754,988,0,0,0,0,0,7742,,,CPI PH2 -PLAYGROUND ONE,cpd11-20mn.pdf
P-3CPISUR,CPI PH2 - Sauer Playground,846,DEPT OF PARKS AND RECREATION,NEIGHBORHOOD PARKS AND PLAYGROUNDS,100,MANHATTAN,P-1018,4067,3894,547,0,0,0,0,0,4441,3894,547,0,0,0,0,0,4441,7788,1094,0,0,0,0,0,8882,,,CPI PH2 - SAUER PLAYGROUND,cpd11-20mn.pdf
P-3CSPBOL,Carl Schulz Pk- Construction Security Measures M081-120M,846,DEPT OF PARKS AND RECREATION,"LARGE, MAJOR AND REGIONAL PARK RECONSTRUCTION",100,MANHATTAN,P-1095,1400,0,170,1400,0,0,0,0,1570,0,170,1400,0,0,0,0,1570,0,340,2800,0,0,0,0,3140,,CARL SCHULZ PK- CONSTRUCTION SECURITY MEASURES,CARL SCHULZ PK- CONSTRUCTION SECURITY MEASURES,cpd11-20mn.pdf
P-3DAGHAM,"Dag Hammarskjold Plaza, Manhattan",846,DEPT OF PARKS AND RECREATION,NEIGHBORHOOD PARKS AND PLAYGROUNDS,100,MANHATTAN,P-D018,920,303,0,0,1030,0,0,0,1333,303,0,0,1030,0,0,0,1333,606,0,0,2060,0,0,0,2666,PROJECT DELAYED DUE TO BUDGETARY CONSTRAINTS,PARKS -- IMPROVEMENTS TO DAG HAMMARSKJOLD PLAZA -- FUNDING WILL PROVIDE CAPITAL,PARKS -- IMPROVEMENTS TO DAG HAMMARSKJOLD PLAZA -- FUNDING WILL PROVIDE CAPITAL,cpd11-20mn.pdf
P-3DDOKPL,"Recon pool deck at Dry Dock Pool, Manhattan",846,DEPT OF PARKS AND RECREATION,NEIGHBORHOOD PARKS AND PLAYGROUNDS,100,MANHATTAN,P-1008,1200,25,0,1200,0,0,0,0,1225,25,0,1200,0,0,0,0,1225,50,0,2400,0,0,0,0,2450,,"DRY DOCK POOL, MANHATTAN","RECON POOL DECK AT DRY DOCK POOL, MANHATTAN",cpd11-20mn.pdf
P-3DIRVPK,Riverside Park-Critical Drainage Infrastructure,846,DEPT OF PARKS AND RECREATION,MAJOR RECREATIONAL FACILITIES AND FACILITY RECONSTRUCTION,100,MANHATTAN,P-0245M,11500,35,950,0,2000,8550,0,0,11535,35,950,0,2000,8550,0,0,11535,70,1900,0,4000,17100,0,0,23070,,,RIVERSIDE PARK- DRAINAGE INFRASTRUCTURE,cpd11-20mn.pdf
P-3EAST54,East 54th St Rec Ctr - Natatorium Ceiling/Men' locker FC R,846,DEPT OF PARKS AND RECREATION,MAJOR RECREATIONAL FACILITIES AND FACILITY RECONSTRUCTION,100,MANHATTAN,P-0506,2081,0,100,107,0,1874,0,0,2081,0,100,107,0,1874,0,0,2081,0,200,214,0,3748,0,0,4162,,,EAST 54TH STREET RECREATION CENTER - NATATORIUM CEILING/MEN'S LOCKER FACILITY,cpd11-20mn.pdf
P-3EMRTRN,Emergency replace of Randalls Island transformer M104-118M,846,DEPT OF PARKS AND RECREATION,"LARGE, MAJOR AND REGIONAL PARK RECONSTRUCTION",100,MANHATTAN,P-1018,1062,813,0,249,0,0,0,0,1062,813,0,249,0,0,0,0,1062,1626,0,498,0,0,0,0,2124,,RANDALS ISLAND,EMERGENCY REPLACEMENT OF RANDALLS ISLAND TRANSFORMER,cpd11-20mn.pdf
P-3ESSTAT,ELIZABETH CADY STANTON AND SUSAN B. ANTHONY STATUE FUND INC,846,DEPT OF PARKS AND RECREATION,MAJOR RECREATIONAL FACILITIES AND FACILITY RECONSTRUCTION,100,MANHATTAN,P-M245 P-D018,635,0,135,0,0,0,0,0,135,0,135,0,0,0,0,0,135,0,270,0,0,0,0,0,270,,ELIZABETH CADY STANTON AND SUSAN B. ANTHONY STATUE FUND INC.,ELIZABETH CADY STANTON AND SUSAN B. ANTHONY STATUE FUND INC.,cpd11-20mn.pdf
P-3FFAGAN,"FATHER FAGAN PK LANDSCAPE RECON, MG-512M",846,DEPT OF PARKS AND RECREATION,NEIGHBORHOOD PARKS AND PLAYGROUNDS,100 102,MANHATTAN,P-D018,1500,2049,0,337,0,0,0,0,2386,2049,0,337,0,0,0,0,2386,4098,0,674,0,0,0,0,4772,PROJECT DELAYED DUE TO CHANGES IN SCOPE/DESIGN,FATHER FAGAN PK LANDSCAPE RECON,FATHER FAGAN PK LANDSCAPE RECON,cpd11-20mn.pdf
P-3FTRYON,Fort Tryon Park,846,DEPT OF PARKS AND RECREATION,NEIGHBORHOOD PARKS AND PLAYGROUNDS,100,MANHATTAN,P-1018,1100,0,0,0,1100,0,0,0,1100,0,0,0,1100,0,0,0,1100,0,0,0,2200,0,0,0,2200,,MANHATTAN,FORT TRYON PARK,cpd11-20mn.pdf
P-3GARVRF,Recon of Roofing systems at Marcus Garvey,846,DEPT OF PARKS AND RECREATION,NEIGHBORHOOD PARKS AND PLAYGROUNDS,100,MANHATTAN,P-1249,417,37,363,0,0,0,0,0,400,37,363,0,0,0,0,0,400,74,726,0,0,0,0,0,800,,MANHATTAN,RECON OF ROOFING SYSTEMS AT MARCUS GARVEY,cpd11-20mn.pdf
P-3GERCTE,GERTRUDE EDERLE RECREATION CENTER -- EQUIPMENT REPLACEMENT,846,DEPT OF PARKS AND RECREATION,NEIGHBORHOOD PARKS AND PLAYGROUNDS,100,MANHATTAN,P-D018,140,0,140,0,0,0,0,0,140,0,140,0,0,0,0,0,140,0,280,0,0,0,0,0,280,,,GERTRUDE EDERLE RECREATION CENTER -- EQUIPMENT REPLACEMENT,cpd11-20mn.pdf
P-3GMHVAC,Gracie Mansion Improvements,846,DEPT OF PARKS AND RECREATION,MAJOR RECREATIONAL FACILITIES AND FACILITY RECONSTRUCTION,100,MANHATTAN,P-0245M P-1018,3217,0,600,2899,0,0,0,0,3499,0,600,2899,0,0,0,0,3499,0,1200,5798,0,0,0,0,6998,,,GRACIE MANSION HVAC M081,cpd11-20mn.pdf
P-3GTACQM,Land Acuisition,846,DEPT OF PARKS AND RECREATION,LAND ACQUISITION AND TREE PLANTING,100,MANHATTAN,P-D056 P-M056 P-M245,300,3,947,0,0,0,0,0,950,3,947,0,0,0,0,0,950,6,1894,0,0,0,0,0,1900,,,LAND ACUISITION,cpd11-20mn.pdf
P-3HBCGRD,Highbridge Community Garden,846,DEPT OF PARKS AND RECREATION,NEIGHBORHOOD PARKS AND PLAYGROUNDS,100,MANHATTAN,P-D018,200,0,0,0,0,200,0,0,200,0,0,0,0,200,0,0,200,0,0,0,0,400,0,0,400,PROJECT DELAYED DUE TO BUDGETARY CONSTRAINTS,HIGHBRIDGE COMMUNITY GARDEN,HIGHBRIDGE COMMUNITY GARDEN,cpd11-20mn.pdf
P-3HELIP2,Heliport(Andrew Haswell) Park - phase 2 M108-109M,846,DEPT OF PARKS AND RECREATION,NEIGHBORHOOD PARKS AND PLAYGROUNDS,100 108,MANHATTAN,P-1018 P-D018,2500,3501,225,0,0,0,0,0,3726,3501,225,0,0,0,0,0,3726,7002,450,0,0,0,0,0,7452,PROJECT DELAYED DUE TO UNFORESEEN HAZARDOUS CONDITION,HELIPORT PARK CONSTRUCTION PHASE 2,HELIPORT PARK CONSTRUCTION PHASE 2,cpd11-20mn.pdf
P-3HELLKT,DEP Shaft Site - Hell's Kitchen Park Construction,846,DEPT OF PARKS AND RECREATION,NEIGHBORHOOD PARKS AND PLAYGROUNDS,100,MANHATTAN,P-0245M W-0013 P-D018,200,325,1300,0,2900,0,0,0,4525,325,1300,0,2900,0,0,0,4525,650,2600,0,5800,0,0,0,9050,PROJECT DELAYED DUE TO CHANGES IN SCOPE/DESIGN,,RIVERSIDE PARK--101ST STAIRCASE PROJECT,cpd11-20mn.pdf
P-3HGLNPH,"HIGHLINE-Path replace Rail Track Rehab, Lead Paint, light",846,DEPT OF PARKS AND RECREATION,NEIGHBORHOOD PARKS AND PLAYGROUNDS,100,MANHATTAN,P-D018,3800,0,0,0,3800,0,0,0,3800,0,0,0,3800,0,0,0,3800,0,0,0,7600,0,0,0,7600,,,"THE HIGH LINE -- PATH-PERMANET REPLACEMENT, RAIL TRACK WALK REHAB, LEAD PAINT",cpd11-20mn.pdf
P-3HGLNRC,"HIGHLINE Reconstruction, Misc Park & Playground.,",846,DEPT OF PARKS AND RECREATION,NEIGHBORHOOD PARKS AND PLAYGROUNDS,100,MANHATTAN,P-0245M,6000,0,0,0,6000,0,0,0,6000,0,0,0,6000,0,0,0,6000,0,0,0,12000,0,0,0,12000,,,"HIGHLINE RECONSTRUCTION, MISC PARK & PLAYGROUND.,",cpd11-20mn.pdf
P-3HIGHL3,"FRIENDS OF THE HIGH LINE- Western Rail Yards, Manhattan",846,DEPT OF PARKS AND RECREATION,NEIGHBORHOOD PARKS AND PLAYGROUNDS,100,MANHATTAN,P-D018,2700,0,700,2000,0,0,0,0,2700,0,700,2000,0,0,0,0,2700,0,1400,4000,0,0,0,0,5400,,,THE HIGH LINE,cpd11-20mn.pdf
P-3HLNACC,Friends of Highline,846,DEPT OF PARKS AND RECREATION,NEIGHBORHOOD PARKS AND PLAYGROUNDS,100,MANHATTAN,P-D018 P-M245,0,0,2600,0,0,0,0,0,2600,0,2600,0,0,0,0,0,2600,0,5200,0,0,0,0,0,5200,,,"FRIENDS OF THE HIGH LINE -- FUNDS RELATED TO ACCESSIBILITY, CIRCULATION AND VISITOR",cpd11-20mn.pdf
P-3HLNSTR,FRIENDS OF THE HIGHLINE,846,DEPT OF PARKS AND RECREATION,NEIGHBORHOOD PARKS AND PLAYGROUNDS,100,MANHATTAN,P-M245,100,0,100,0,0,0,0,0,100,0,100,0,0,0,0,0,100,0,200,0,0,0,0,0,200,,,FRIENDS OF THE HIGHLINE,cpd11-20mn.pdf
P-3HMFISH,Hamilton Fish Park Basketball Courts and Adult Fitness,846,DEPT OF PARKS AND RECREATION,"LARGE, MAJOR AND REGIONAL PARK RECONSTRUCTION",100,MANHATTAN,P-D018 P-M245,655,572,118,0,0,0,0,0,690,572,118,0,0,0,0,0,690,1144,236,0,0,0,0,0,1380,,,HAMILTON FISH PARK BASKETBALL COURTS AND ADULT FITNESS,cpd11-20mn.pdf
P-3HR2944,"HRPT - 29th to 44th Sts. Construction, Manhattan",846,DEPT OF PARKS AND RECREATION,"LARGE, MAJOR AND REGIONAL PARK RECONSTRUCTION",100,MANHATTAN,P-1246,23000,0,0,0,0,23000,0,0,23000,0,0,0,0,23000,0,0,23000,0,0,0,0,46000,0,0,46000,,,HRPT - 29TH TO 44TH STS. CONSTRUCTION,cpd11-20mn.pdf
P-3HRP26U,HRPT,846,DEPT OF PARKS AND RECREATION,"LARGE, MAJOR AND REGIONAL PARK RECONSTRUCTION",100,MANHATTAN,P-1246,4609,0,0,4609,0,0,0,0,4609,0,0,4609,0,0,0,0,4609,0,0,9218,0,0,0,0,9218,,,HRPT,cpd11-20mn.pdf
P-3HRP40A,Hudson River Park -- Pier 40 rooftop field,846,DEPT OF PARKS AND RECREATION,NEIGHBORHOOD PARKS AND PLAYGROUNDS,100,MANHATTAN,P-D018,0,0,700,0,0,0,0,0,700,0,700,0,0,0,0,0,700,0,1400,0,0,0,0,0,1400,,,HUDSON RIVER PARK -- PIER 40 ROOFTOP FIELD,cpd11-20mn.pdf
P-3HRP40F,Pier 40 Athletic Fields Reconstruction,846,DEPT OF PARKS AND RECREATION,NEIGHBORHOOD PARKS AND PLAYGROUNDS,100,MANHATTAN,P-D018,325,0,325,0,0,0,0,0,325,0,325,0,0,0,0,0,325,0,650,0,0,0,0,0,650,,,PIER 40 ATHLETIC FIELDS RECONSTRUCTION,cpd11-20mn.pdf
P-3HRP40W,HRPT,846,DEPT OF PARKS AND RECREATION,MAJOR RECREATIONAL FACILITIES AND FACILITY RECONSTRUCTION,100,MANHATTAN,P-1246,763,700,63,0,0,0,0,0,763,700,63,0,0,0,0,0,763,1400,126,0,0,0,0,0,1526,,HRPT,HRPT,cpd11-20mn.pdf
P-3HRP54A,"HRPT - Pier 54 Arch Restoration, Manhattan",846,DEPT OF PARKS AND RECREATION,NEIGHBORHOOD PARKS AND PLAYGROUNDS,100,MANHATTAN,P-D018,550,0,0,550,0,0,0,0,550,0,0,550,0,0,0,0,550,0,0,1100,0,0,0,0,1100,,,HRPT - PIER 54 ARCH RESTORATION,cpd11-20mn.pdf
P-3HRPCCV,HRPT-Clinton Cove Sculpture/Landscaping,846,DEPT OF PARKS AND RECREATION,NEIGHBORHOOD PARKS AND PLAYGROUNDS,100,MANHATTAN,P-D018,65,0,465,0,0,0,0,0,465,0,465,0,0,0,0,0,465,0,930,0,0,0,0,0,930,,HUDSON RIVER PARK TRUST CLINTON COVE LANDSCAPING,HUDSON RIVER PARK TRUST CLINTON COVE LANDSCAPING,cpd11-20mn.pdf
P-3HRPCW1,"HARRIET TUBMAN MEMORIAL BEAUTIFICATION, Manhattan",846,DEPT OF PARKS AND RECREATION,NEIGHBORHOOD PARKS AND PLAYGROUNDS,100,MANHATTAN,P-D018,175,0,175,0,0,0,0,0,175,0,175,0,0,0,0,0,175,0,350,0,0,0,0,0,350,,,"HRP - CHELSEA WATERSIDE PARK & DOG RUN, MANHATTAN",cpd11-20mn.pdf
P-3HRPCWP,HRPT - Chelsea Waterside Park Phase 2,846,DEPT OF PARKS AND RECREATION,NEIGHBORHOOD PARKS AND PLAYGROUNDS,100,MANHATTAN,P-D018,170,0,3675,0,0,0,0,0,3675,0,3675,0,0,0,0,0,3675,0,7350,0,0,0,0,0,7350,,CHELSEA WATERSIDE PARK RESTORE SAFETY SURFACE,CHELSEA WATERSIDE PARK RESTORE SAFETY SURFACE,cpd11-20mn.pdf
P-3HRPDG8,HUDSON RIVER PARK TRUST PIER 84 DOG RUN,846,DEPT OF PARKS AND RECREATION,NEIGHBORHOOD PARKS AND PLAYGROUNDS,100,MANHATTAN,P-M245 P-D018,525,0,782,0,0,0,0,0,782,0,782,0,0,0,0,0,782,0,1564,0,0,0,0,0,1564,,,HUDSON RIVER PARK TRUST RENOVATION TO PIER 84 DOG RUN,cpd11-20mn.pdf
P-3HRPP40,Hudson River Park Trust - Pier 40 Repairs,846,DEPT OF PARKS AND RECREATION,MAJOR RECREATIONAL FACILITIES AND FACILITY RECONSTRUCTION,100,MANHATTAN,P-1246,10645,0,0,9552,0,0,0,0,9552,0,0,9552,0,0,0,0,9552,0,0,19104,0,0,0,0,19104,,,PIER 40 REPAIRS,cpd11-20mn.pdf
P-3HRPT34,HUDSON RIVER PARK,846,DEPT OF PARKS AND RECREATION,NEIGHBORHOOD PARKS AND PLAYGROUNDS,100,MANHATTAN,P-1246,3400,0,9,3400,0,0,0,0,3409,0,9,3400,0,0,0,0,3409,0,18,6800,0,0,0,0,6818,,,HUDSON RIVER PARK,cpd11-20mn.pdf
P-3HRPTEN,Houston St. Tennis Courts RC,846,DEPT OF PARKS AND RECREATION,NEIGHBORHOOD PARKS AND PLAYGROUNDS,100,MANHATTAN,P-D018,0,0,550,0,0,0,0,0,550,0,550,0,0,0,0,0,550,0,1100,0,0,0,0,0,1100,,,HUDSON RIVER PARK -- HOUSTON STREET TENNIS COURT REPAVING,cpd11-20mn.pdf
P-3HRPTPK,"HRPT- Gansevoort Peninsula Park Construction., Manhattan",846,DEPT OF PARKS AND RECREATION,"LARGE, MAJOR AND REGIONAL PARK RECONSTRUCTION",100,MANHATTAN,P-1246,50000,5375,530,44170,0,0,0,0,50075,5375,530,44170,0,0,0,0,50075,10750,1060,88340,0,0,0,0,100150,,HUDSON RIVER PARK,HUDSON RIVER PARK TRUST,cpd11-20mn.pdf
P-3INHILL,"Inwood Hill Park - Baseball fields,Manhattan",846,DEPT OF PARKS AND RECREATION,NEIGHBORHOOD PARKS AND PLAYGROUNDS,100,MANHATTAN,P-D018,682,360,0,0,7075,200,0,0,7635,360,0,0,7075,200,0,0,7635,720,0,0,14150,400,0,0,15270,PROJECT DELAYED DUE TO CHANGES IN SCOPE/DESIGN,,"INWOOD HILL PARK- BASEBALL, SOCCER, & DOG RUN, MANHATTAN",cpd11-20mn.pdf
P-3INWDPK,Inwood Hill Park,846,DEPT OF PARKS AND RECREATION,NEIGHBORHOOD PARKS AND PLAYGROUNDS,100,MANHATTAN,P-1018,700,0,0,0,700,0,0,0,700,0,0,0,700,0,0,0,700,0,0,0,1400,0,0,0,1400,,MANHATTAN,INWOOD HILL PARK,cpd11-20mn.pdf
P-3LASKE2,CPC Reconstruction of the Pool & Rink at Harlem Meer,846,DEPT OF PARKS AND RECREATION,MAJOR RECREATIONAL FACILITIES AND FACILITY RECONSTRUCTION,100,MANHATTAN,P-1018 P-1300,0,0,1825,0,0,48175,0,0,50000,0,1825,0,0,48175,0,0,50000,0,3650,0,0,96350,0,0,100000,,,CPC RECONSTRUCTION OF THE POOL & RINK AT HARLEM MEER IN CENTRAL PARK',cpd11-20mn.pdf
P-3LGGRDN,"LAGUARDIA CORNER GARDEN FENCE, Mahattan",846,DEPT OF PARKS AND RECREATION,NEIGHBORHOOD PARKS AND PLAYGROUNDS,100,MANHATTAN,P-1018,340,516,38,0,0,0,0,0,554,516,38,0,0,0,0,0,554,1032,76,0,0,0,0,0,1108,,,LAGUARDIA CORNER GARDEN FENCE,cpd11-20mn.pdf
P-3LGTURF,"Little Flower Plg Synth. Turf Field Cons, Manhattan MG-316MA",846,DEPT OF PARKS AND RECREATION,MAJOR RECREATIONAL FACILITIES AND FACILITY RECONSTRUCTION,100,MANHATTAN,P-1018,745,531,54,0,0,0,0,0,585,531,54,0,0,0,0,0,585,1062,108,0,0,0,0,0,1170,,,LA GUARDIA - SYNTHETIC TURF FIELD,cpd11-20mn.pdf
P-3LMDCCH,LMDC - Corlear's Hook Comfort Station M017-216M,846,DEPT OF PARKS AND RECREATION,NEIGHBORHOOD PARKS AND PLAYGROUNDS,100,MANHATTAN,P-1018,2800,785,242,0,0,0,0,0,1027,785,242,0,0,0,0,0,1027,1570,484,0,0,0,0,0,2054,PROJECT DELAYED DUE TO CHANGES IN SCOPE/DESIGN,MANHATTAN,COMFORT STATION CONSTRUCTION,cpd11-20mn.pdf
P-3MORJUM,MORRIS-JUMEL MANSION,846,DEPT OF PARKS AND RECREATION,MAJOR RECREATIONAL FACILITIES AND FACILITY RECONSTRUCTION,100,MANHATTAN,P-M094,38,0,38,0,0,0,0,0,38,0,38,0,0,0,0,0,38,0,76,0,0,0,0,0,76,,,MORRIS-JUMEL MANSION,cpd11-20mn.pdf
P-3MORNHR,MORNINGSIDE PARK HANDRAILS,846,DEPT OF PARKS AND RECREATION,NEIGHBORHOOD PARKS AND PLAYGROUNDS,100,MANHATTAN,P-M245 P-D018,250,0,100,450,0,0,0,0,550,0,100,450,0,0,0,0,550,0,200,900,0,0,0,0,1100,,,"MORNINGSIDE PARK INSTALL HANDRAILS IN STAIRS LOCATED AT EAST 113TH STREET, MANHATTAN",cpd11-20mn.pdf
P-3MRNGPK,Morningstar Park,846,DEPT OF PARKS AND RECREATION,NEIGHBORHOOD PARKS AND PLAYGROUNDS,100,MANHATTAN,P-1018,600,0,950,0,0,0,0,0,950,0,950,0,0,0,0,0,950,0,1900,0,0,0,0,0,1900,,MANHATTAN,MORNINGSTAR PARK,cpd11-20mn.pdf
P-3NRGF01,NRG- Manhattan Reforestation FY 20- MG-619MA,846,DEPT OF PARKS AND RECREATION,LAND ACQUISITION AND TREE PLANTING,100,MANHATTAN,P-0822,1035,0,0,1035,0,0,0,0,1035,0,0,1035,0,0,0,0,1035,0,0,2070,0,0,0,0,2070,,BOROUGH OF MANHATTAN,MANHATTAN REFORESTATION,cpd11-20mn.pdf
P-3NYRS01,ERP-Composting Facility & Wetland R/C M144-116M,846,DEPT OF PARKS AND RECREATION,NEIGHBORHOOD PARKS AND PLAYGROUNDS,100,MANHATTAN,P-1245,1052,0,0,0,0,0,0,0,0,0,0,0,0,0,0,0,0,0,0,0,0,0,0,0,0,,,"EAST RIVER NEW YORK RISING GRANT, BOROUGH OF MANHATTAN",cpd11-20mn.pdf
P-3P40SPR,Hudson River Park Pier 40 Fire Sprinkler Recon,846,DEPT OF PARKS AND RECREATION,NEIGHBORHOOD PARKS AND PLAYGROUNDS,100,MANHATTAN,P-1246,3455,3455,330,0,0,0,0,0,3785,3455,330,0,0,0,0,0,3785,6910,660,0,0,0,0,0,7570,,,HUDSON RIVER PARK PIER 40 FIRE SPRINKLER RECON,cpd11-20mn.pdf
P-3PAVTMK,Tompkins Sq Park Paths & Multi-Purpose Play Area Pave Recon,846,DEPT OF PARKS AND RECREATION,NEIGHBORHOOD PARKS AND PLAYGROUNDS,100,MANHATTAN,P-1018,2400,0,0,0,0,1400,0,0,1400,0,0,0,0,1400,0,0,1400,0,0,0,0,2800,0,0,2800,,MANHATTAN,"THIS PROJECT WILL RECONSTRUCT PAVEMENTS AT TOMPKINS SQUARE PARK, INCLUDING PATHS AND",cpd11-20mn.pdf
P-3PDHBRC,Hansborough Rec Ctr M131-115M,846,DEPT OF PARKS AND RECREATION,MAJOR RECREATIONAL FACILITIES AND FACILITY RECONSTRUCTION,100,MANHATTAN,P-D018 P-1018 P-1008 P-1250 P-0506,4000,2289,1,0,0,0,20436,0,22726,2289,1,0,0,0,20436,0,22726,4578,2,0,0,0,40872,0,45452,,MANHATTAN,HANSBOROUGH REC CTR,cpd11-20mn.pdf
P-3PDTDRC,Tony Dapolito Rec Ctr RC M103-115M,846,DEPT OF PARKS AND RECREATION,MAJOR RECREATIONAL FACILITIES AND FACILITY RECONSTRUCTION,100,MANHATTAN,P-0506 P-1018,4000,6261,1008,0,0,0,0,0,7269,6261,1008,0,0,0,0,0,7269,12522,2016,0,0,0,0,0,14538,,MANHATTAN,TONY DAPOLITO REC CTR,cpd11-20mn.pdf
P-3PHILSQ,A. PHILLIP RANDOLPH SQUARE RENOVATION Manhattan,846,DEPT OF PARKS AND RECREATION,NEIGHBORHOOD PARKS AND PLAYGROUNDS,100,MANHATTAN,P-M245,460,0,460,0,0,0,0,0,460,0,460,0,0,0,0,0,460,0,920,0,0,0,0,0,920,,,"A. PHILLIP RANDOLPH SQUARE RENOVATION--PARK RENOVATION 7TH AVENUE, WEST 117TH STREET,",cpd11-20mn.pdf
P-3PIN181,PINEHURST AV/181ST - STAIRCASE/GARDEN UPGRADES,846,DEPT OF PARKS AND RECREATION,NEIGHBORHOOD PARKS AND PLAYGROUNDS,100,MANHATTAN,P-M245 P-D018,625,60,400,0,0,0,0,0,460,60,400,0,0,0,0,0,460,120,800,0,0,0,0,0,920,,PINEHURST AVENUE STEPS @ 181ST STREET,PINEHURST AVENUE STEPS @ 181ST STREET,cpd11-20mn.pdf
P-3PL12A1,"Reconstruction of plgr(Dante & Tucker Sqr), MG-112M",846,DEPT OF PARKS AND RECREATION,NEIGHBORHOOD PARKS AND PLAYGROUNDS,100 107,MANHATTAN,P-D018,908,607,301,0,0,0,0,0,908,607,301,0,0,0,0,0,908,1214,602,0,0,0,0,0,1816,,DANTE & TUCKER SQUARE,RECONSTRUCTION PLGR -DANTE AND TUCKER SQUARE,cpd11-20mn.pdf
P-3PL12A4,Gertrude Kelly Pk RC (MG-112M) WO#7,846,DEPT OF PARKS AND RECREATION,"LARGE, MAJOR AND REGIONAL PARK RECONSTRUCTION",100 104,MANHATTAN,P-D018,75,55,68,0,0,0,0,0,123,55,68,0,0,0,0,0,123,110,136,0,0,0,0,0,246,,GERTRUDE KELLY PLGR,RECONSTRUCTION OF PLGR BOROUGH OF MANHATTAN(MG-112M),cpd11-20mn.pdf
P-3PL12A7,"Theodore Roosevelt Pk R/C, MG-112M",846,DEPT OF PARKS AND RECREATION,NEIGHBORHOOD PARKS AND PLAYGROUNDS,100,MANHATTAN,P-D018,66,12,50,0,0,0,0,0,62,12,50,0,0,0,0,0,62,24,100,0,0,0,0,0,124,,"T. ROOSEVELT PARK, BOROUGH OF MANHATTAN",RECONSTRUCTION OF PLAYGROUND IN T. ROOSEVELT PARK,cpd11-20mn.pdf
P-3PL14A6,Ruppert Park-Install New Irrig.System MG-314M WO6,846,DEPT OF PARKS AND RECREATION,NEIGHBORHOOD PARKS AND PLAYGROUNDS,100,MANHATTAN,P-D018,110,0,100,0,2182,100,0,0,2382,0,100,0,2182,100,0,0,2382,0,200,0,4364,200,0,0,4764,PROJECT DELAYED DUE TO BUDGETARY CONSTRAINTS,RUPPERT PARK-INSTALL NEW IRRIGATION SYSTEM,RUPPERT PARK-INSTALL NEW IRRIGATION SYSTEM,cpd11-20mn.pdf
P-3PL16A2,East River Esplanade Con Edison East 74th Street Reconstruct,846,DEPT OF PARKS AND RECREATION,"LARGE, MAJOR AND REGIONAL PARK RECONSTRUCTION",100,MANHATTAN,P-0245M,196,0,196,0,0,0,0,0,196,0,196,0,0,0,0,0,196,0,392,0,0,0,0,0,392,,,EAST RIVER ESPLANADE CON EDISON EAST 74TH STREET RECONSTRUCT,cpd11-20mn.pdf
P-3PLG13B,"Reconstruction of plgr, Borough of Manhattan MG-213M",846,DEPT OF PARKS AND RECREATION,"LARGE, MAJOR AND REGIONAL PARK RECONSTRUCTION",199,MANHATTAN,PV-D034,1817,1620,117,0,0,0,0,0,1737,1620,117,0,0,0,0,0,1737,3240,234,0,0,0,0,0,3474,PROJECT DELAYED DUE TO CHANGES IN SCOPE/DESIGN,,"THE RECONSTRUCTION OF PAVEMENTS, FENCING, SAFETY SURFACING, PLUMBING,STONE WALLS,",cpd11-20mn.pdf
P-3PLG14B,R/C OF Playgrounds multisites FY14 Manhattan (MG-914MA),846,DEPT OF PARKS AND RECREATION,NEIGHBORHOOD PARKS AND PLAYGROUNDS,100,MANHATTAN,P-0245M P-D018,2135,2762,0,520,0,0,0,0,3282,2762,0,520,0,0,0,0,3282,5524,0,1040,0,0,0,0,6564,PROJECT DELAYED DUE TO BUDGETARY CONSTRAINTS,"BOROUGHWIDE, MANHATTAN","R/C OF PLAYGROUNDS FY14, MANHATTAN",cpd11-20mn.pdf
P-3PLG155,PS 155 PLAYGROUND,846,DEPT OF PARKS AND RECREATION,NEIGHBORHOOD PARKS AND PLAYGROUNDS,100,MANHATTAN,P-M245,288,0,288,0,0,0,0,0,288,0,288,0,0,0,0,0,288,0,576,0,0,0,0,0,576,,,"RENOVATION OF THE BASKETBALL AT PS 155 PLAYGROUND, MANHATTAN",cpd11-20mn.pdf
P-3POORRD,"POOR RICHARD'S PLAYGROUND RENOVATIONS, Mahattan",846,DEPT OF PARKS AND RECREATION,NEIGHBORHOOD PARKS AND PLAYGROUNDS,100,MANHATTAN,P-D018,2489,338,0,0,2247,0,0,0,2585,338,0,0,2247,0,0,0,2585,676,0,0,4494,0,0,0,5170,PROJECT DELAYED DUE TO CHANGES IN SCOPE/DESIGN,,"POOR RICHARD'S PLAYGROUND RENOVATIONS, MAHATTAN",cpd11-20mn.pdf
P-3PS155M,"PS155M Playground , Manhattan",846,DEPT OF PARKS AND RECREATION,NEIGHBORHOOD PARKS AND PLAYGROUNDS,100,MANHATTAN,P-D018 P-M245,1000,125,983,0,0,1845,0,0,2953,125,983,0,0,1845,0,0,2953,250,1966,0,0,3690,0,0,5906,PROJECT DELAYED DUE TO BUDGETARY CONSTRAINTS,PS 155M PLAYGROUND (DPR) -- PLAYGROUND RECONSTRUCTION MANAGED BY PARKS,PS 155M PLAYGROUND (DPR) -- PLAYGROUND RECONSTRUCTION MANAGED BY PARKS,cpd11-20mn.pdf
P-3PWBJRP,"PWOB - Jackie Robinson Pk stairways, fencing, sidewalks, (M",846,DEPT OF PARKS AND RECREATION,NEIGHBORHOOD PARKS AND PLAYGROUNDS,100,MANHATTAN,P-1329 P-1018,6000,5428,99,205,0,0,0,0,5732,5428,99,205,0,0,0,0,5732,10856,198,410,0,0,0,0,11464,,PWB - JACKIE ROBINSON PARK (M,"PWB - JACKIE ROBINSON PARK STAIRWAYS, FENCING, SIDEWALKS, (M",cpd11-20mn.pdf
P-3PWBSEP,"PWB - Seward Park (Manhattan), M082-117M",846,DEPT OF PARKS AND RECREATION,NEIGHBORHOOD PARKS AND PLAYGROUNDS,100,MANHATTAN,P-1018,11026,5896,47,708,0,0,0,0,6651,5896,47,708,0,0,0,0,6651,11792,94,1416,0,0,0,0,13302,PROJECT DELAYED DUE TO UNFORESEEN SITE/FIELD CONDITION,PWB - SEWARD PARK (M,PWB - SEWARD PARK (M,cpd11-20mn.pdf
P-3QUISCS,Quisqueya Playground-Reconstruction of Comfort Station,846,DEPT OF PARKS AND RECREATION,NEIGHBORHOOD PARKS AND PLAYGROUNDS,100,MANHATTAN,P-0505,1710,239,0,1704,0,0,0,0,1943,239,0,1704,0,0,0,0,1943,478,0,3408,0,0,0,0,3886,,,QUISQUEYA PLAYGROUND-RECONSTRUCTION OF COMFORT STATION,cpd11-20mn.pdf
P-3RANDSC,Randall's Island Sunken Garden Connector,846,DEPT OF PARKS AND RECREATION,"LARGE, MAJOR AND REGIONAL PARK RECONSTRUCTION",100,MANHATTAN,P-0245M,794,0,0,0,0,0,0,0,0,0,0,0,0,0,0,0,0,0,0,0,0,0,0,0,0,,,RANDALL'S ISLAND SUNKEN GARDEN CONNECTOR (NEW PROJECT) ¦ NYSDOT PIN# X773.98,cpd11-20mn.pdf
P-3RANDVC,RANDALL'S ISLAND VIISITOR CENTER,846,DEPT OF PARKS AND RECREATION,MAJOR RECREATIONAL FACILITIES AND FACILITY RECONSTRUCTION,100,MANHATTAN,P-M245,239,0,239,0,0,0,0,0,239,0,239,0,0,0,0,0,239,0,478,0,0,0,0,0,478,,,"CONSTRUCT A NATURE CENTER AT RANDALL'S ISLAND PARK, MANHATTAN",cpd11-20mn.pdf
P-3REC54E,RECREATION CTR 54 FITNESS EQUIPMENT-FUNDING FOR NEW FITNESS,846,DEPT OF PARKS AND RECREATION,NEIGHBORHOOD PARKS AND PLAYGROUNDS,100,MANHATTAN,P-D018,125,0,125,0,0,0,0,0,125,0,125,0,0,0,0,0,125,0,250,0,0,0,0,0,250,,,RECREATION CENTER 54 FITNESS EQUIPMENT -- FUNDING FOR NEW FITNESS EQUIPMENT,cpd11-20mn.pdf
P-3RIV105,"Riversidw Park, 105Street",846,DEPT OF PARKS AND RECREATION,NEIGHBORHOOD PARKS AND PLAYGROUNDS,100,MANHATTAN,P-1018,840,0,0,840,0,0,0,0,840,0,0,840,0,0,0,0,840,0,0,1680,0,0,0,0,1680,,MANHATTAN,"RIVERSIDE PARK, 105 ST",cpd11-20mn.pdf
P-3RIV110,"Riverside Park, 110 Street",846,DEPT OF PARKS AND RECREATION,NEIGHBORHOOD PARKS AND PLAYGROUNDS,100,MANHATTAN,P-1018,450,0,0,0,450,0,0,0,450,0,0,0,450,0,0,0,450,0,0,0,900,0,0,0,900,,MANHATTAN,"RIVERSIDE PARK, 110STREET",cpd11-20mn.pdf
P-3RIV148,"Riverside Park, 148 Street",846,DEPT OF PARKS AND RECREATION,NEIGHBORHOOD PARKS AND PLAYGROUNDS,100,MANHATTAN,P-1018,110,10,0,110,0,0,0,0,120,10,0,110,0,0,0,0,120,20,0,220,0,0,0,0,240,,MANHATTAN,"RIVERSIDE PARK, 148TH STREET",cpd11-20mn.pdf
P-3RIVJOA,"Riverside Park - Joan of Arc Island, Manhattan ( MG-318M)",846,DEPT OF PARKS AND RECREATION,NEIGHBORHOOD PARKS AND PLAYGROUNDS,100,MANHATTAN,P-D018,475,903,97,0,0,0,0,0,1000,903,97,0,0,0,0,0,1000,1806,194,0,0,0,0,0,2000,,RIVERSIDE PARK -- JOAN OF ARC ISLAND UPGRADE,RIVERSIDE PARK -- JOAN OF ARC ISLAND UPGRADE,cpd11-20mn.pdf
P-3RIVS83,"Riverside Park, 83rd Street",846,DEPT OF PARKS AND RECREATION,NEIGHBORHOOD PARKS AND PLAYGROUNDS,100,MANHATTAN,P-1018,245,38,275,0,0,0,0,0,313,38,275,0,0,0,0,0,313,76,550,0,0,0,0,0,626,,MANHATTAN,"RIVERSIDE PARK, 83 STREET",cpd11-20mn.pdf
P-3RIVS97,"Riverside Park, 97th Street",846,DEPT OF PARKS AND RECREATION,NEIGHBORHOOD PARKS AND PLAYGROUNDS,100,MANHATTAN,P-1018,550,30,520,0,0,0,0,0,550,30,520,0,0,0,0,0,550,60,1040,0,0,0,0,0,1100,,MANHATTAN,"RIVERSIDE PARK, 97TH STREET",cpd11-20mn.pdf
P-3RIVSTR,"RIVERSIDE PARK--102nd ST Staircase, Manhattan",846,DEPT OF PARKS AND RECREATION,NEIGHBORHOOD PARKS AND PLAYGROUNDS,100,MANHATTAN,P-0380 P-D018 P-M245,818,397,700,0,2051,0,0,0,3148,397,700,0,2051,0,0,0,3148,794,1400,0,4102,0,0,0,6296,PROJECT DELAYED DUE TO CHANGES IN SCOPE/DESIGN,,RIVERSIDE PARK--101ST STAIRCASE PROJECT,cpd11-20mn.pdf
P-3RNDLGL,Recon gas line at Randalls Island,846,DEPT OF PARKS AND RECREATION,NEIGHBORHOOD PARKS AND PLAYGROUNDS,100,MANHATTAN,P-0245M,340,0,340,0,0,0,0,0,340,0,340,0,0,0,0,0,340,0,680,0,0,0,0,0,680,,"RANDALLS ISLAND, MANHATTAN",RECON GAS LINE AT RANDALLS ISLAND,cpd11-20mn.pdf
P-3RNDLOT,Randall's Island PEP Office Trailer Parking Lot M104-118M,846,DEPT OF PARKS AND RECREATION,NEIGHBORHOOD PARKS AND PLAYGROUNDS,100,MANHATTAN,P-0944 P-1018,6954,4934,369,0,0,0,0,0,5303,4934,369,0,0,0,0,0,5303,9868,738,0,0,0,0,0,10606,,RANDALL'S ISLAND,THIS PROJECT IS FOR THE PARKING LOT AT THE RANDALL'S ISLAND PEP OFFICE TRAILER,cpd11-20mn.pdf
P-3RSOVAL,Riverside Oval,846,DEPT OF PARKS AND RECREATION,NEIGHBORHOOD PARKS AND PLAYGROUNDS,100,MANHATTAN,P-D018 P-M822,125,0,223,15,0,0,0,0,238,0,223,15,0,0,0,0,238,0,446,30,0,0,0,0,476,,RIVERSIDE OVAL,WATER LINE HOOKUP,cpd11-20mn.pdf
P-3RVPFWP,Riverside Park and Fort Washington Park Greenway Reconstruct,846,DEPT OF PARKS AND RECREATION,NEIGHBORHOOD PARKS AND PLAYGROUNDS,100,MANHATTAN,P-1018,2300,0,0,0,2300,0,0,0,2300,0,0,0,2300,0,0,0,2300,0,0,0,4600,0,0,0,4600,,MANHATTAN,RIVERSIDE PARK AND FORT WASHINGTON PARK GREENWAY RECONSTRUCTION,cpd11-20mn.pdf
P-3RVSSCA,"Riverside Pk-Skate park at 109 St., M071-115MA",846,DEPT OF PARKS AND RECREATION,NEIGHBORHOOD PARKS AND PLAYGROUNDS,100,MANHATTAN,P-D018 P-M380,1000,2739,504,0,0,0,0,0,3243,2739,504,0,0,0,0,0,3243,5478,1008,0,0,0,0,0,6486,PROJECT DELAYED DUE TO BUDGETARY CONSTRAINTS,EAST RIVER PK-SKATE PARK AT 109 STR,EAST RIVER PK-SKATE PARK AT 109 STR,cpd11-20mn.pdf
P-3SEWARD,SEWARD PARK- RESTORATION OF SCHIFF FOUNTAIN,846,DEPT OF PARKS AND RECREATION,NEIGHBORHOOD PARKS AND PLAYGROUNDS,100,MANHATTAN,P-D018,272,36,0,0,0,200,0,0,236,36,0,0,0,200,0,0,236,72,0,0,0,400,0,0,472,PROJECT DELAYED DUE TO BUDGETARY CONSTRAINTS,,RESTORATION OF SCHIFF FOUNTAIN -SEWARD PARK,cpd11-20mn.pdf
P-3SHARCS,Sheltering Arms Playgound Comfort Station,846,DEPT OF PARKS AND RECREATION,NEIGHBORHOOD PARKS AND PLAYGROUNDS,100,MANHATTAN,P-0505,1493,254,0,1357,0,0,136,0,1747,254,0,1357,0,0,136,0,1747,508,0,2714,0,0,272,0,3494,,,FUNDING TO BE TRANSFERRED FROM 846 P-6CWCMF...,cpd11-20mn.pdf
P-3SHERMC,SHERMAN CREEK PARK,846,DEPT OF PARKS AND RECREATION,NEIGHBORHOOD PARKS AND PLAYGROUNDS,100,MANHATTAN,P-M245 P-D018,250,0,550,0,0,0,0,0,550,0,550,0,0,0,0,0,550,0,1100,0,0,0,0,0,1100,,,"CONSTRUCTION OF A NEW COMMUNITY DOCK AND GANGWAY SYSTEM IN SHERMAN CREEK PARK,",cpd11-20mn.pdf
P-3SOHAGS,Green Street Fencing - Amsterdam Ave and 126th St.,846,DEPT OF PARKS AND RECREATION,NEIGHBORHOOD PARKS AND PLAYGROUNDS,100,MANHATTAN,P-M245,65,0,65,0,0,0,0,0,65,0,65,0,0,0,0,0,65,0,130,0,0,0,0,0,130,,,GREEN STREET FENCING - AMSTERDAM AVE AND 126TH ST.,cpd11-20mn.pdf
P-3SRAWIN,"BRC Senior Center in Sara D., Park (MN) window replace",846,DEPT OF PARKS AND RECREATION,NEIGHBORHOOD PARKS AND PLAYGROUNDS,100,MANHATTAN,P-1018 P-D018,600,0,0,920,0,0,0,0,920,0,0,920,0,0,0,0,920,0,0,1840,0,0,0,0,1840,,"SARA D., PARK (MN)","BRC SENIOR CENTER IN SARA D., PARK (MN) WINDOW REPLACE",cpd11-20mn.pdf
P-3STFWAG,"STF - Wagner Playground Synthetic turf field, Manhattan",846,DEPT OF PARKS AND RECREATION,NEIGHBORHOOD PARKS AND PLAYGROUNDS,100,MANHATTAN,P-0510,2376,1856,326,189,0,0,0,0,2371,1856,326,189,0,0,0,0,2371,3712,652,378,0,0,0,0,4742,PROJECT DELAYED DUE TO CHANGES IN SCOPE/DESIGN,,SYNTHETIC TURF- WAGNER PLAYGROUND,cpd11-20mn.pdf
P-3STNICK,St. Nicholas Park,846,DEPT OF PARKS AND RECREATION,NEIGHBORHOOD PARKS AND PLAYGROUNDS,100,MANHATTAN,P-1018,500,10,0,500,0,0,0,0,510,10,0,500,0,0,0,0,510,20,0,1000,0,0,0,0,1020,,MANHATTAN,PAVEMENT RECONSTRUCTION,cpd11-20mn.pdf
P-3SUTTON,ONE SUTTON PLACE PARK CONSTRUCTION (M108-111M),846,DEPT OF PARKS AND RECREATION,"LARGE, MAJOR AND REGIONAL PARK RECONSTRUCTION",100 106,MANHATTAN,P-D018,600,1441,75,0,0,0,0,0,1516,1441,75,0,0,0,0,0,1516,2882,150,0,0,0,0,0,3032,PROJECT DELAYED PENDING RESOLUTION OF LEGAL ISSUES,"ONE SUTTON PLACE PARK, MANHATTAN","ONE SUTTON PLACE PARK - CONSTRUCT NEW PARK, MANHATTAN",cpd11-20mn.pdf
P-3SUTTPK,"SUTTON PLACE PARK.- Fountain & Spray Shower, Mahattan",846,DEPT OF PARKS AND RECREATION,NEIGHBORHOOD PARKS AND PLAYGROUNDS,100,MANHATTAN,P-D018,850,14,0,0,0,850,0,0,864,14,0,0,0,850,0,0,864,28,0,0,0,1700,0,0,1728,PROJECT DELAYED DUE TO BUDGETARY CONSTRAINTS,,"SUTTON PLACE PARK.- FOUNTAIN & SPRAY SHOWER, MAHATTAN",cpd11-20mn.pdf
P-3TOMJPK,Thomas Jefferson Park Plg Reconst. Mahattan (M047-118M),846,DEPT OF PARKS AND RECREATION,NEIGHBORHOOD PARKS AND PLAYGROUNDS,100,MANHATTAN,P-D018,2920,2536,143,0,0,0,0,0,2679,2536,143,0,0,0,0,0,2679,5072,286,0,0,0,0,0,5358,,,FY18 ADOPTION SECTION 254 ADDS $2.140M (P D018) ...,cpd11-20mn.pdf
P-3TONYDL,Tony Dapolito RC Ctr 7th Ave Sidewalk Vault & Pool Stb rest,846,DEPT OF PARKS AND RECREATION,MAJOR RECREATIONAL FACILITIES AND FACILITY RECONSTRUCTION,100,MANHATTAN,P-0506,5126,0,100,413,0,4613,0,0,5126,0,100,413,0,4613,0,0,5126,0,200,826,0,9226,0,0,10252,,,TONY DAPOLITO RECREATION CENTER - 7TH AVENUE SIDEWALK VAULT RESTORATION AND POOL,cpd11-20mn.pdf
P-3TRE18A,"FY 18 Street Tree Mnht CB 2,4,7,9,10,12",846,DEPT OF PARKS AND RECREATION,LAND ACQUISITION AND TREE PLANTING,100,MANHATTAN,W-0005,1942,284,35,0,0,0,0,0,319,284,35,0,0,0,0,0,319,568,70,0,0,0,0,0,638,,"FY 18 STREET TREE MNHT CB 2,4,7,9,10,12","FY 18 STREET TREE MNHT CB 2,4,7,9,10,12",cpd11-20mn.pdf
P-3TRE18B,"FY 18 Street Tree Mnht CB 1,3,5,6,8,11",846,DEPT OF PARKS AND RECREATION,LAND ACQUISITION AND TREE PLANTING,100,MANHATTAN,S-0195,2968,194,0,35,0,0,0,0,229,194,0,35,0,0,0,0,229,388,0,70,0,0,0,0,458,,"FY 18 STREET TREE MNHT CB 1,3,5,6,8,11","FY 18 STREET TREE MNHT CB 1,3,5,6,8,11",cpd11-20mn.pdf
P-3TRE20A,"FY 20 Street Tree Mnht CB 1,3,5,6,8,11 MG-319M",846,DEPT OF PARKS AND RECREATION,LAND ACQUISITION AND TREE PLANTING,100,MANHATTAN,P-0822,3768,3455,67,0,0,0,0,0,3522,3455,67,0,0,0,0,0,3522,6910,134,0,0,0,0,0,7044,,"FY 20 STREET TREE MNHT CB 1,3,5,6,8,11 MG-319M","FY 20 STREET TREE MNHT CB 1,3,5,6,8,11 MG-319M",cpd11-20mn.pdf
P-3TREL21,"FY21 Street Trees MN CB's 1,2,4,5,,7-12 (3Y)",846,DEPT OF PARKS AND RECREATION,LAND ACQUISITION AND TREE PLANTING,100,MANHATTAN,P-D018 P-0822 HB-1027 P-1018,3371,15,0,6282,0,0,0,0,6297,15,0,6282,0,0,0,0,6297,30,0,12564,0,0,0,0,12594,,MANHATTAN,"FY21 STREET TREES MN CB'S 1,2,4,5,,7-12 (3Y)",cpd11-20mn.pdf
P-3TRESM2,Manhattan-Street trees CB2 MG-919M,846,DEPT OF PARKS AND RECREATION,LAND ACQUISITION AND TREE PLANTING,100,MANHATTAN,P-0822,115,12,99,0,0,0,0,0,111,12,99,0,0,0,0,0,111,24,198,0,0,0,0,0,222,,MANHATTAN CB2,MANHATTAN-STREET TREES CB2,cpd11-20mn.pdf
P-3TRESM3,Manhattan-Street trees CB3 - MG-1019M,846,DEPT OF PARKS AND RECREATION,LAND ACQUISITION AND TREE PLANTING,100,MANHATTAN,P-0822,136,0,108,0,0,0,0,0,108,0,108,0,0,0,0,0,108,0,216,0,0,0,0,0,216,,MNHT CB3,MANHATTAN-STREET TREES CB3,cpd11-20mn.pdf
P-3TRESM4,Manhattan-Street trees CB4 - MG-1119M,846,DEPT OF PARKS AND RECREATION,LAND ACQUISITION AND TREE PLANTING,100,MANHATTAN,P-0822,127,0,93,0,0,0,0,0,93,0,93,0,0,0,0,0,93,0,186,0,0,0,0,0,186,,MNHT CB4,MANHATTAN-STREET TREES CB4,cpd11-20mn.pdf
P-3W185BC,"WEST 186TH ST BASKEBALL COURTS, Manhattan",846,DEPT OF PARKS AND RECREATION,NEIGHBORHOOD PARKS AND PLAYGROUNDS,100,MANHATTAN,P-D018,400,0,400,0,0,0,0,0,400,0,400,0,0,0,0,0,400,0,800,0,0,0,0,0,800,,,ONE HALF COURTS - WEST 186TH ST BASKEBALL COURTS -- TO BUILD ONE HALFCOURT,cpd11-20mn.pdf
P-3W69SB2,West 69th Street transverse bridge - phase 2 M353-212M,846,DEPT OF PARKS AND RECREATION,NEIGHBORHOOD PARKS AND PLAYGROUNDS,100 107,MANHATTAN,P-0380,650,313,0,786,0,0,0,0,1099,313,0,786,0,0,0,0,1099,626,0,1572,0,0,0,0,2198,PROJECT DELAYED DUE TO CHANGES IN SCOPE/DESIGN,WEST 69TH TRANSVERSE BRIDGE PHASE 2,WEST 69TH TRANSVERSE BRIDGE PHASE 2,cpd11-20mn.pdf
P-5STFMHN,"Synthetic Turf Field Reconstruction at Mahoney Park, SI",846,DEPT OF PARKS AND RECREATION,NEIGHBORHOOD PARKS AND PLAYGROUNDS,100,MANHATTAN,P-1018,508,0,508,0,0,0,0,0,508,0,508,0,0,0,0,0,508,0,1016,0,0,0,0,0,1016,,STATEN ISLAND,"SYNTHETIC TURF FIELD RECONSTRUCTION AT MAHONEY PARK, SI",cpd11-20mn.pdf
P-6STFMAT,Purchase syn turf materials to recon fields in Manhattan,846,DEPT OF PARKS AND RECREATION,NEIGHBORHOOD PARKS AND PLAYGROUNDS,100,MANHATTAN,P-0245M,1111,0,1111,0,0,0,0,0,1111,0,1111,0,0,0,0,0,1111,0,2222,0,0,0,0,0,2222,,MANHATTAN,PURCHASE SYN TURF MATERIALS TO RECON FIELDS IN MANHATTAN,cpd11-20mn.pdf
SAND3TREE,"FY21- ESCR Tree Planting, Manhattan MG-1219M",846,DEPT OF PARKS AND RECREATION,LAND ACQUISITION AND TREE PLANTING,100,MANHATTAN,PU-0100,0,0,8392,0,0,0,0,0,8392,0,8392,0,0,0,0,0,8392,0,16784,0,0,0,0,0,16784,,MANHATTAN,"FY21- ESCR TREE PLANTING, MANHATTAN",cpd11-20mn.pdf
SANDY3-02,SANDY - Manhattan Plgd requirements (Type 1) MG-112M,846,DEPT OF PARKS AND RECREATION,NEIGHBORHOOD PARKS AND PLAYGROUNDS,100,MANHATTAN,P-1018,1949,140,0,0,0,0,0,0,140,140,0,0,0,0,0,0,140,280,0,0,0,0,0,0,280,PROJECT DELAYED DUE TO CHANGES IN SCOPE/DESIGN,,RECONSTRUCTION OF PLAYGROUNDS DAMAGED BY HURRICANE SANDY IN THE BOROUGH OF,cpd11-20mn.pdf
SANDY3-03,SANDY - John Jay & Tony Dapolito - boilers (MG-113M),846,DEPT OF PARKS AND RECREATION,MAJOR RECREATIONAL FACILITIES AND FACILITY RECONSTRUCTION,100,MANHATTAN,P-1018,862,311,0,107,0,0,0,0,418,311,0,107,0,0,0,0,418,622,0,214,0,0,0,0,836,,,SANDY SAFE-UP MANHATTAN BOILER REPLACEMENTS,cpd11-20mn.pdf
SANDY3-06,SANDY - PNP Friends of the Highline,846,DEPT OF PARKS AND RECREATION,MAJOR RECREATIONAL FACILITIES AND FACILITY RECONSTRUCTION,100 104,MANHATTAN,P-1018,336,0,0,0,0,34,0,0,34,0,0,0,0,34,0,0,34,0,0,0,0,68,0,0,68,PROJECT DELAYED PENDING NON-CITY GRANT APPROVAL,MANHATTAN,HIGHLINE,cpd11-20mn.pdf
SANDY3-07,SANDY - PNP Asphalt Green,846,DEPT OF PARKS AND RECREATION,MAJOR RECREATIONAL FACILITIES AND FACILITY RECONSTRUCTION,100 108,MANHATTAN,P-1018,154,0,0,0,0,15,0,0,15,0,0,0,0,15,0,0,15,0,0,0,0,30,0,0,30,PROJECT DELAYED PENDING NON-CITY GRANT APPROVAL,MANHATTAN,ASPHALT GREEN,cpd11-20mn.pdf
SANDY3-08,SANDY - PNP Battery Conservancy,846,DEPT OF PARKS AND RECREATION,NEIGHBORHOOD PARKS AND PLAYGROUNDS,100 101,MANHATTAN,P-1018,650,0,0,0,0,56,0,0,56,0,0,0,0,56,0,0,56,0,0,0,0,112,0,0,112,PROJECT DELAYED PENDING NON-CITY GRANT APPROVAL,MANHATTAN,BATTERY PARK,cpd11-20mn.pdf
SANDY3-09,SANDY - PNP Riverside Park Conservancy,846,DEPT OF PARKS AND RECREATION,NEIGHBORHOOD PARKS AND PLAYGROUNDS,100 107 109,MANHATTAN,P-1018,446,2,0,0,0,45,0,0,47,2,0,0,0,45,0,0,47,4,0,0,0,90,0,0,94,PROJECT DELAYED PENDING NON-CITY GRANT APPROVAL,MANHATTAN,RIVERSIDE PARK,cpd11-20mn.pdf
SANDY3-11,Vietnam Vet. Memorial Lighting (M046-114M),846,DEPT OF PARKS AND RECREATION,NEIGHBORHOOD PARKS AND PLAYGROUNDS,100,MANHATTAN,P-1018,600,143,0,166,0,0,0,0,309,143,0,166,0,0,0,0,309,286,0,332,0,0,0,0,618,PROJECT DELAYED DUE TO BUDGETARY CONSTRAINTS,"SOUTH STREET, MANHATTAN","R/C OF LIGHTING & ELECTR. AT VIETNAM VET. PLAZA,MANHATTAN",cpd11-20mn.pdf
SANDY3-12,SANDY-Inwood Hill Nature Center (Type 3),846,DEPT OF PARKS AND RECREATION,NEIGHBORHOOD PARKS AND PLAYGROUNDS,100,MANHATTAN,P-1018,1920,435,0,601,0,0,0,0,1036,435,0,601,0,0,0,0,1036,870,0,1202,0,0,0,0,2072,,"INWOOD HILL PK , MANHATTAN",R/C OF INWOOD HILL NATURE CENTER,cpd11-20mn.pdf
SANDY3-13,SANDY-Riverside & F. Washington Pk Shoreline (Type 3 ),846,DEPT OF PARKS AND RECREATION,NEIGHBORHOOD PARKS AND PLAYGROUNDS,100,MANHATTAN,P-1018,1770,582,1,9,0,0,0,0,592,582,1,9,0,0,0,0,592,1164,2,18,0,0,0,0,1184,PROJECT DELAYED PENDING NON-CITY GRANT APPROVAL,"RIVERSIDE & F. WASHINGTON PARKS, MANHATTAN",SHORELINE WORK IN RIVERSIDE & F. WASHINGTON PK,cpd11-20mn.pdf
SANDY3-14,SANDY-Dock at 79 Street Boat Basin M071-310M,846,DEPT OF PARKS AND RECREATION,NEIGHBORHOOD PARKS AND PLAYGROUNDS,100,MANHATTAN,P-1018,5232,545,0,7,0,0,0,0,552,545,0,7,0,0,0,0,552,1090,0,14,0,0,0,0,1104,,WEST 79 STREET BOAT BASIN,DOCK DESIGN,cpd11-20mn.pdf
SANDY3-17,SANDY- E.River Esplanade (Glick Park)-Elec (Type 3),846,DEPT OF PARKS AND RECREATION,NEIGHBORHOOD PARKS AND PLAYGROUNDS,100,MANHATTAN,P-1018,239,234,0,8,0,0,0,0,242,234,0,8,0,0,0,0,242,468,0,16,0,0,0,0,484,,"EAST RIVER ESPLANADE (GLICK PARK) , BOROUGH OF MANHATTAN",EAST RIVER ESPLANADE (GLICK PK)- ELECTRICAL REPAIR,cpd11-20mn.pdf
SANDY3-18,SANDY - Mannahatta Fountains RC (Type 3),846,DEPT OF PARKS AND RECREATION,NEIGHBORHOOD PARKS AND PLAYGROUNDS,100,MANHATTAN,P-1018,1640,367,292,0,0,0,0,0,659,367,292,0,0,0,0,0,659,734,584,0,0,0,0,0,1318,PROJECT DELAYED DUE TO CHANGES IN SCOPE/DESIGN,"MANNAHATTA (WALL STREET) , BOROUGH OF MANHATTAN",FOUNTAIN DAMAGE AND ELECTRICAL REPAIR,cpd11-20mn.pdf
SANDY3-19,SANDY - John Jay & Tony Dapolito - Electrical (Balance),846,DEPT OF PARKS AND RECREATION,NEIGHBORHOOD PARKS AND PLAYGROUNDS,100,MANHATTAN,P-1018,1018,0,0,0,0,102,0,0,102,0,0,0,0,102,0,0,102,0,0,0,0,204,0,0,204,,,SANDY - JOHN JAY & TONY DAPOLITO - ELECTRICAL (BALANCE),cpd11-20mn.pdf
SANDY3-20,Playground 103 (CIII),846,DEPT OF PARKS AND RECREATION,NEIGHBORHOOD PARKS AND PLAYGROUNDS,100,MANHATTAN,P-1018,795,64,0,14,0,0,0,0,78,64,0,14,0,0,0,0,78,128,0,28,0,0,0,0,156,,,PLAYGROUND 103 (CIII),cpd11-20mn.pdf
SANDY3-21,Four Parks Safety Surface,846,DEPT OF PARKS AND RECREATION,NEIGHBORHOOD PARKS AND PLAYGROUNDS,100,MANHATTAN,P-1018,718,0,0,0,0,72,0,0,72,0,0,0,0,72,0,0,72,0,0,0,0,144,0,0,144,PROJECT DELAYED DUE TO CHANGES IN SCOPE/DESIGN,,FOUR PARKS SAFETY SURFACE,cpd11-20mn.pdf
SANDY3-23,Manhattan B,846,DEPT OF PARKS AND RECREATION,NEIGHBORHOOD PARKS AND PLAYGROUNDS,100,MANHATTAN,P-1018,354,0,0,0,0,36,0,0,36,0,0,0,0,36,0,0,36,0,0,0,0,72,0,0,72,,,MANHATTAN B - IN KIND,cpd11-20mn.pdf
SANDY3-24,SANDY-Inwood Nature Center Exhibit Displays,846,DEPT OF PARKS AND RECREATION,MAJOR RECREATIONAL FACILITIES AND FACILITY RECONSTRUCTION,100,MANHATTAN,P-1018,330,18,25,0,0,0,0,0,43,18,25,0,0,0,0,0,43,36,50,0,0,0,0,0,86,,"INWOOD HILL NATURE CENTER, MANHATTAN",RECONSTRUCTION OF INWOOD NATURE CENTER EXHIBIT DISPLAY,cpd11-20mn.pdf
SANDY3-25,Riverside Park Electrical Repairs,846,DEPT OF PARKS AND RECREATION,NEIGHBORHOOD PARKS AND PLAYGROUNDS,100,MANHATTAN,P-1018,1691,0,169,0,0,0,0,0,169,0,169,0,0,0,0,0,169,0,338,0,0,0,0,0,338,,"RIVERSIDE DR. TO HUDSON RIVER, W. 72 ST.TO ST CLAIR PL. MANHATTAN.",RIVERSIDE PARK ELECTRICAL REPAIRS.,cpd11-20mn.pdf
AGNYCHANG,NYCHANGE PROJECT WITH DFTA,850,DEPT OF DESIGN & CONSTRUCTION,DEPARTMENT FOR THE AGING BUILDING RECONSTRUCTION,103,MANHATTAN,HR-0025 AG-0001 AG-M001 AG-D001,1000,1759,0,0,0,12010,0,7734,21503,1759,0,0,0,12010,0,7734,21503,3518,0,0,0,24020,0,15468,43006,PROJECT DELAYED DUE TO BUDGETARY CONSTRAINTS,,SEPT 2012 ADD 254 PROJECT. NYCHANGE PROJECT WITH DFTA. SCOPE IS TO UPGRADE THE SENIOR,cpd11-20mn.pdf
BBJ-M,Borough Based Jails New Manhattan Detention Facility,850,DEPT OF DESIGN & CONSTRUCTION,New Jail Facilities,,MANHATTAN,C-0114,0,0,100,232424,416188,511726,509493,458382,2128313,0,100,232424,416188,511726,509493,458382,2128313,0,200,464848,832376,1023452,1018986,916764,4256626,,,CONSTRUCTION OF NEW MANHATTAN FACILITY,cpd11-20mn.pdf
CC1C3,1 CENTRE ST.- OFFICES FROM 49-51 CHAMBERS ST. - 21C3,850,DEPT OF DESIGN & CONSTRUCTION,REHABILITATION OF CITY-OWNED OFFICE SPACE,101,MANHATTAN,PW-0077,3740,8852,149,120,0,0,0,0,9121,8852,149,120,0,0,0,0,9121,17704,298,240,0,0,0,0,18242,PROJECT DELAYED DUE TO UNFORESEEN SITE/FIELD CONDITION,,49-51 CHAMBERS AND 346 BROADWAY 21C3,cpd11-20mn.pdf
CC253B,100 GOLD- 21C3,850,DEPT OF DESIGN & CONSTRUCTION,REHABILITATION OF CITY-OWNED OFFICE SPACE,101,MANHATTAN,PW-0077,17078,16880,207,0,0,0,0,0,17087,16880,207,0,0,0,0,0,17087,33760,414,0,0,0,0,0,34174,PROJECT DELAYED DUE TO BUDGETARY CONSTRAINTS,,253 BROADWAY 21C3,cpd11-20mn.pdf
CO283SID2,100 CENTRE STREET - SIDEWALK REPLACEMENT,850,DEPT OF DESIGN & CONSTRUCTION,RECONSTRUCTION/RENOVATION OF COURT FACILITIES,101,MANHATTAN,CO-0283,6808,7696,96,0,0,0,0,0,7792,7696,96,0,0,0,0,0,7792,15392,192,0,0,0,0,0,15584,PROJECT DELAYED DUE TO CHANGES IN SCOPE/DESIGN,,100 CENTRE STREET - SIDEWALK REPLACEMENT,cpd11-20mn.pdf
CO283TOIL,100 CENTRE ST.- CODE COMPLIANT TOILET UPGRADE,850,DEPT OF DESIGN & CONSTRUCTION,RECONSTRUCTION/RENOVATION OF COURT FACILITIES,101,MANHATTAN,CO-0283,5500,1004,0,384,0,7238,0,0,8626,1004,0,384,0,7238,0,0,8626,2008,0,768,0,14476,0,0,17252,PROJECT DELAYED DUE TO BUDGETARY CONSTRAINTS,,100 CENTRE ST.- CODE COMPLIANT TOILET UPGRADE,cpd11-20mn.pdf
CO283WT,100 CENTRE STREET - WATER TANK,850,DEPT OF DESIGN & CONSTRUCTION,RECONSTRUCTION/RENOVATION OF COURT FACILITIES,101,MANHATTAN,CO-0283,3769,0,39,3976,0,0,0,0,4015,0,39,3976,0,0,0,0,4015,0,78,7952,0,0,0,0,8030,,,100 CENTRE STREET - WATER TANK,cpd11-20mn.pdf
CO285FIRE,60 LAFAYETTE ST - FIRE ALARM UPGRADE,850,DEPT OF DESIGN & CONSTRUCTION,RECONSTRUCTION/RENOVATION OF COURT FACILITIES,101,MANHATTAN,CO-0285,10826,809,166,0,10051,0,0,0,11026,809,166,0,10051,0,0,0,11026,1618,332,0,20102,0,0,0,22052,,,60 LAFAYETTE ST - FIRE ALARM DESIGN & REPLACEMENT,cpd11-20mn.pdf
CO304REHB,60 CENTRE ST. - RECONSTRUCTION,850,DEPT OF DESIGN & CONSTRUCTION,RECONSTRUCTION/RENOVATION OF COURT FACILITIES,101,MANHATTAN,CO-0304,15869,2005,310,1540,0,13295,0,0,17150,2005,310,1540,0,13295,0,0,17150,4010,620,3080,0,26590,0,0,34300,PROJECT DELAYED DUE TO BUDGETARY CONSTRAINTS,"60 CENTRE STREET, NEW YORK, NY","RESTORATION OF THE BUILDING ENVELOPE INTEGRITY - BASEMENT, ROOF & FACADE",cpd11-20mn.pdf
CO306EXT2,170 E121 ST. EXTERIOR - LL11,850,DEPT OF DESIGN & CONSTRUCTION,RECONSTRUCTION/RENOVATION OF COURT FACILITIES,111,MANHATTAN,CO-0306,1633,0,86,0,0,2839,0,0,2925,0,86,0,0,2839,0,0,2925,0,172,0,0,5678,0,0,5850,PROJECT DELAYED DUE TO BUDGETARY CONSTRAINTS,,FACADE,cpd11-20mn.pdf
CO80ROOF2,27 MADISON AVE - ROOF & MISC. OPERATIONS SPACES UPGRADE,850,DEPT OF DESIGN & CONSTRUCTION,RECONSTRUCTION/RENOVATION OF COURT FACILITIES,105,MANHATTAN,CO-0080,3881,2378,0,0,0,0,0,0,2378,2378,0,0,0,0,0,0,2378,4756,0,0,0,0,0,0,4756,PROJECT DELAYED DUE TO UNFORESEEN SITE/FIELD CONDITION,,27 MADISON AVE - ROOF & MISC. OPERATIONS SPACES UPGRADE,cpd11-20mn.pdf
CO81ELEC,31 CHAMBERS ST. - ELECTRICAL AND FA SYSTEM UPGRADE,850,DEPT OF DESIGN & CONSTRUCTION,IMPROVEMENT AND EXPANSION OF COURT FACILITIES,101,MANHATTAN,CO-0081,19090,100,0,0,0,2000,2753,27307,32160,100,0,0,0,2000,2753,27307,32160,200,0,0,0,4000,5506,54614,64320,PROJECT DELAYED DUE TO CHANGES IN SCOPE/DESIGN,,MANHATTAN SURROGATE'S COURT ELECTRICAL AND FIRE ALARM SYSTEM UPGRADESAND DOOR,cpd11-20mn.pdf
CO81SKY2,31 CHAMBERST ST.- RENOVATE SKYLIGHT,850,DEPT OF DESIGN & CONSTRUCTION,IMPROVEMENT AND EXPANSION OF COURT FACILITIES,101,MANHATTAN,CO-0264 CO-0081,6189,10308,480,1732,0,0,0,0,12520,10308,480,1732,0,0,0,0,12520,20616,960,3464,0,0,0,0,25040,PROJECT DELAYED DUE TO UNFORESEEN SITE/FIELD CONDITION,,SKYLIGHT RESTORATION AND SURROUNDING SPACE,cpd11-20mn.pdf
E14-0008,DCAS - MANHATTAN SUPREME COURT COMP ENERGY UPGRADE,850,DEPT OF DESIGN & CONSTRUCTION,"BUILDING CONSTRUCTION, RECONSTRUCTION OR RETROFIT",,MANHATTAN,PU-0025,9566,13533,150,268,0,0,0,0,13951,13533,150,268,0,0,0,0,13951,27066,300,536,0,0,0,0,27902,PROJECT DELAYED DUE TO UNFORESEEN SITE/FIELD CONDITION,,ENERGY UPGRADE,cpd11-20mn.pdf
E14-0017,DHS - Bellevue Men's Shelter,850,DEPT OF DESIGN & CONSTRUCTION,"BUILDING CONSTRUCTION, RECONSTRUCTION OR RETROFIT",101,MANHATTAN,PU-0025,2782,4990,109,0,0,0,0,0,5099,4990,109,0,0,0,0,0,5099,9980,218,0,0,0,0,0,10198,PROJECT DELAYED DUE TO UNFORESEEN SITE/FIELD CONDITION,,DHS - BELLEVUE MEN'S SHELTER,cpd11-20mn.pdf
E16-0003,DCAS - Manhattan Civil Court,850,DEPT OF DESIGN & CONSTRUCTION,"BUILDING CONSTRUCTION, RECONSTRUCTION OR RETROFIT",101,MANHATTAN,PU-0025,3780,815,4641,540,0,0,0,0,5996,815,4641,540,0,0,0,0,5996,1630,9282,1080,0,0,0,0,11992,PROJECT DELAYED DUE TO UNFORESEEN SITE/FIELD CONDITION,,MANHATTAN CIVIL COURT,cpd11-20mn.pdf
E16-0005,DSNY -Manhattan 3 District Garage,850,DEPT OF DESIGN & CONSTRUCTION,"BUILDING CONSTRUCTION, RECONSTRUCTION OR RETROFIT",103,MANHATTAN,PU-0025,3427,1621,100,141,0,0,0,0,1862,1621,100,141,0,0,0,0,1862,3242,200,282,0,0,0,0,3724,PROJECT DELAYED DUE TO UNFORESEEN SITE/FIELD CONDITION,,MANHATTAN 3 DISTRICT GARAGE,cpd11-20mn.pdf
E17-0001,DCAS - LOUIS J LEFKOWITZ - ENERGY EFFICIENCY UPGRADE,850,DEPT OF DESIGN & CONSTRUCTION,"BUILDING CONSTRUCTION, RECONSTRUCTION OR RETROFIT",102,MANHATTAN,PU-0025,3422,913,326,6656,0,0,0,0,7895,913,326,6656,0,0,0,0,7895,1826,652,13312,0,0,0,0,15790,,,ENERGY EFFICIENCY UPGRADE,cpd11-20mn.pdf
EO26-0002,DCAS-Manhattan Municipal Building - Heat Light Installation,850,DEPT OF DESIGN & CONSTRUCTION,"BUILDING CONSTRUCTION, RECONSTRUCTION OR RETROFIT",101,MANHATTAN,PU-0025,300,0,0,146,684,0,0,0,830,0,0,146,684,0,0,0,830,0,0,292,1368,0,0,0,1660,,,CITY HALL CAMPUS,cpd11-20mn.pdf
EO26-0003,DFTA-Cypress Hills Senior Center - Lighting Upgrade,850,DEPT OF DESIGN & CONSTRUCTION,"BUILDING CONSTRUCTION, RECONSTRUCTION OR RETROFIT",101,MANHATTAN,PU-0025,300,0,0,94,376,0,0,0,470,0,0,94,376,0,0,0,470,0,0,188,752,0,0,0,940,,,CYPRESS HILLS SENIOR CENTER - LIGHTING UPGRADE AND DHW HEATERS,cpd11-20mn.pdf
F175LC8,RENOVATION L8,850,DEPT OF DESIGN & CONSTRUCTION,NEW FACILITIES AND RENOVATIONS,101,MANHATTAN,F-0175,2859,13788,76,0,0,0,0,0,13864,13788,76,0,0,0,0,0,13864,27576,152,0,0,0,0,0,27728,PROJECT DELAYED DUE TO UNFORESEEN SITE/FIELD CONDITION,,RENOVATION L8,cpd11-20mn.pdf
F175MCE23,ELECTRIC & TOILETS - EC23,850,DEPT OF DESIGN & CONSTRUCTION,NEW FACILITIES AND RENOVATIONS,105,MANHATTAN,F-0175,1201,6751,131,0,0,0,0,0,6882,6751,131,0,0,0,0,0,6882,13502,262,0,0,0,0,0,13764,PROJECT DELAYED DUE TO UNFORESEEN SITE/FIELD CONDITION,,ELECTRIC & TOILETS - EC23,cpd11-20mn.pdf
HBMA24662,W 128TH ST PED BRIDGE BIN,850,DEPT OF DESIGN & CONSTRUCTION,FAIR BRIDGES,100,MANHATTAN,HB-0215,14143,2065,0,12511,0,0,0,0,14576,2065,0,12511,0,0,0,0,14576,4130,0,25022,0,0,0,0,29152,,W 128TH ST PED BRIDGE BIN,W 128TH ST PED BRIDGE BIN,cpd11-20mn.pdf
HBPED100M,PED BRIDGE - E 81 ST (M),850,DEPT OF DESIGN & CONSTRUCTION,FAIR BRIDGES,100 108,MANHATTAN,P-0245M,18118,17177,726,0,0,0,0,0,17903,17177,726,0,0,0,0,0,17903,34354,1452,0,0,0,0,0,35806,PROJECT DELAYED DUE TO UNFORESEEN SITE/FIELD CONDITION,PED BRIDGE - E 81 ST (M),PED BRIDGE - E 81 ST (M),cpd11-20mn.pdf
HH112BEES,BELLEVUE - ELECT SVC UPGRADE,850,DEPT OF DESIGN & CONSTRUCTION,SHELTERS FOR HOMELESS INDIVIDUALS,,MANHATTAN,HH-0112,3131,17986,1513,1542,0,0,0,0,21041,17986,1513,1542,0,0,0,0,21041,35972,3026,3084,0,0,0,0,42082,PROJECT DELAYED DUE TO BUDGETARY CONSTRAINTS,,BELLEVUE - ELECT SVC UPGRADE,cpd11-20mn.pdf
HH112BLBR,BELLEVUE BATHROOMS RECONSTRUCTION,850,DEPT OF DESIGN & CONSTRUCTION,SHELTERS FOR HOMELESS INDIVIDUALS,,MANHATTAN,HH-0112,18200,1682,3700,878,1826,10474,0,0,18560,1682,3700,878,1826,10474,0,0,18560,3364,7400,1756,3652,20948,0,0,37120,,,RECONSTRUCT ALL BATHROOMS AT BELLEVUE MEN'S SHELTER,cpd11-20mn.pdf
HH112BLCY,BELLEVUE COURTYARD,850,DEPT OF DESIGN & CONSTRUCTION,SHELTERS FOR HOMELESS INDIVIDUALS,,MANHATTAN,HH-0112,5700,0,0,0,0,250,5000,0,5250,0,0,0,0,250,5000,0,5250,0,0,0,0,500,10000,0,10500,PROJECT DELAYED DUE TO BUDGETARY CONSTRAINTS,,RECONSTRUCT COURTYARD AT BELLEVUE,cpd11-20mn.pdf
HH112BLEN,BELLEVUE MAIN ATRIUM,850,DEPT OF DESIGN & CONSTRUCTION,SHELTERS FOR HOMELESS INDIVIDUALS,,MANHATTAN,HH-0112,11200,1444,0,0,775,9571,0,0,11790,1444,0,0,775,9571,0,0,11790,2888,0,0,1550,19142,0,0,23580,PROJECT DELAYED DUE TO BUDGETARY CONSTRAINTS,,RECONSTRUCT MAIN ATRIUM ENTRANCEWAY AT BELLEVUE,cpd11-20mn.pdf
HH112BLFS,BELLEVUE MEN'S RESIDENCE- FIRE SAFETY,850,DEPT OF DESIGN & CONSTRUCTION,SHELTERS FOR HOMELESS INDIVIDUALS,,MANHATTAN,HH-0112,14792,1173,0,1510,7300,6000,0,0,15983,1173,0,1510,7300,6000,0,0,15983,2346,0,3020,14600,12000,0,0,31966,,,UPGRADE AND MODERNIZE FIRE SAFETY SYSTEM,cpd11-20mn.pdf
HH112BLRR,BELLEVUE ROOF/ FACADE,850,DEPT OF DESIGN & CONSTRUCTION,SHELTERS FOR HOMELESS INDIVIDUALS,,MANHATTAN,HH-0112,19139,19849,0,26098,1509,858,0,0,48314,19849,0,26098,1509,858,0,0,48314,39698,0,52196,3018,1716,0,0,96628,,,BELLEVUE ROOF/ FACADE,cpd11-20mn.pdf
HH112BVDV,BELLEVUE DIVERSION INTERIOR RENOVATION,850,DEPT OF DESIGN & CONSTRUCTION,SHELTERS FOR HOMELESS INDIVIDUALS,,MANHATTAN,HH-0112,1412,1351,248,0,0,0,0,0,1599,1351,248,0,0,0,0,0,1599,2702,496,0,0,0,0,0,3198,PROJECT DELAYED DUE TO BUDGETARY CONSTRAINTS,,BELLEVUE DIVERSION INTERIOR RENOVATION,cpd11-20mn.pdf
HH112CGIU,Keener Assessment Shelter - Fire Alarm Upgrade,850,DEPT OF DESIGN & CONSTRUCTION,SHELTERS FOR HOMELESS INDIVIDUALS,,MANHATTAN,HH-0112,1320,199,846,0,0,0,0,0,1045,199,846,0,0,0,0,0,1045,398,1692,0,0,0,0,0,2090,,,ADULT SHELTER AT 65 CHARLES GAY LOOP - INTERIOR UPGRADE,cpd11-20mn.pdf
HH112CTFS,CLARKE THOMAS FIRE SAFETY,850,DEPT OF DESIGN & CONSTRUCTION,SHELTERS FOR HOMELESS INDIVIDUALS,,MANHATTAN,HH-0112,1855,293,0,642,0,0,0,0,935,293,0,642,0,0,0,0,935,586,0,1284,0,0,0,0,1870,PROJECT DELAYED DUE TO BUDGETARY CONSTRAINTS,,CLARKE THOMAS FIRE SAFETY,cpd11-20mn.pdf
HH112FTRF,FT. WASHINGTON ARMORY ROOF REPLACEMENT,850,DEPT OF DESIGN & CONSTRUCTION,SHELTERS FOR HOMELESS INDIVIDUALS,,MANHATTAN,HH-0112,5400,1005,0,230,5320,5648,0,0,12203,1005,0,230,5320,5648,0,0,12203,2010,0,460,10640,11296,0,0,24406,PROJECT DELAYED DUE TO BUDGETARY CONSTRAINTS,,FORT WASHINGTON ARMORY - ROOF REPLACEMENT,cpd11-20mn.pdf
HH112FWFA,FT. WASHINGTON - FIRE ALARM,850,DEPT OF DESIGN & CONSTRUCTION,SHELTERS FOR HOMELESS INDIVIDUALS,,MANHATTAN,HH-0112,639,2537,37,0,3190,0,0,0,5764,2537,37,0,3190,0,0,0,5764,5074,74,0,6380,0,0,0,11528,,,FT. WASHINGTON - FIRE ALARM,cpd11-20mn.pdf
HH112HMFA,HARLEM 1 FIRE SAFETY,850,DEPT OF DESIGN & CONSTRUCTION,SHELTERS FOR HOMELESS INDIVIDUALS,,MANHATTAN,HH-0112,886,412,0,618,0,0,0,0,1030,412,0,618,0,0,0,0,1030,824,0,1236,0,0,0,0,2060,PROJECT DELAYED DUE TO BUDGETARY CONSTRAINTS,,HARLEM 1 FIRE SAFETY,cpd11-20mn.pdf
HH112HSFA,HELP SEC - FIRE SAFETY,850,DEPT OF DESIGN & CONSTRUCTION,SHELTERS FOR HOMELESS INDIVIDUALS,,MANHATTAN,HH-0112,2406,679,180,0,1981,0,0,0,2840,679,180,0,1981,0,0,0,2840,1358,360,0,3962,0,0,0,5680,PROJECT DELAYED DUE TO BUDGETARY CONSTRAINTS,,HELP SEC - FIRE SAFETY,cpd11-20mn.pdf
HH112KEFA,Kenton Hall Fire Safety,850,DEPT OF DESIGN & CONSTRUCTION,SHELTERS FOR HOMELESS INDIVIDUALS,,MANHATTAN,HH-0112,630,281,0,0,1349,0,0,0,1630,281,0,0,1349,0,0,0,1630,562,0,0,2698,0,0,0,3260,PROJECT DELAYED DUE TO BUDGETARY CONSTRAINTS,,FIRE SAFETY SYTEM,cpd11-20mn.pdf
HH112KELC,282 EAST 3RD STREET - ELECTRICAL UPGRADE,850,DEPT OF DESIGN & CONSTRUCTION,SHELTERS FOR HOMELESS INDIVIDUALS,,MANHATTAN,HH-0112,5000,822,0,0,670,2300,2300,0,6092,822,0,0,670,2300,2300,0,6092,1644,0,0,1340,4600,4600,0,12184,PROJECT DELAYED DUE TO BUDGETARY CONSTRAINTS,,EAST 3RD STREET - KITCHENS AND ELECTRICAL UPGRADE,cpd11-20mn.pdf
HH112SWFA,SCHWARTZ WARDS ISLAND FIRE SAFETY,850,DEPT OF DESIGN & CONSTRUCTION,SHELTERS FOR HOMELESS INDIVIDUALS,111,MANHATTAN,HH-0112,2488,210,0,0,850,1500,0,0,2560,210,0,0,850,1500,0,0,2560,420,0,0,1700,3000,0,0,5120,PROJECT DELAYED DUE TO BUDGETARY CONSTRAINTS,,FIRE SAFETY SYSTEM,cpd11-20mn.pdf
HH112THFA,8 EAST THIRD ST SHELTER FIRE SAFETY,850,DEPT OF DESIGN & CONSTRUCTION,SHELTERS FOR HOMELESS INDIVIDUALS,,MANHATTAN,HH-0112,1110,0,0,1150,0,0,0,0,1150,0,0,1150,0,0,0,0,1150,0,0,2300,0,0,0,0,2300,PROJECT DELAYED DUE TO BUDGETARY CONSTRAINTS,,FIRE SAFETY SYSTEM,cpd11-20mn.pdf
HH112WBLR,WARDS ISLAND COMPLEX - BOILERS AND FUEL STORAGE TANKS,850,DEPT OF DESIGN & CONSTRUCTION,SHELTERS FOR HOMELESS INDIVIDUALS,,MANHATTAN,HH-0112,9251,10339,0,0,273,0,0,0,10612,10339,0,0,273,0,0,0,10612,20678,0,0,546,0,0,0,21224,PROJECT DELAYED DUE TO BUDGETARY CONSTRAINTS,,WARDS ISLAND COMPLEX - BOILER AND FUEL STORAGE REPLACEMENT,cpd11-20mn.pdf
HH115JCEK,Jennie Clarke Elec and Kitchen,850,DEPT OF DESIGN & CONSTRUCTION,SHELTERS FOR HOMELESS FAMILIES,,MANHATTAN,HH-0115,7253,63,0,630,0,7773,0,0,8466,63,0,630,0,7773,0,0,8466,126,0,1260,0,15546,0,0,16932,PROJECT DELAYED DUE TO BUDGETARY CONSTRAINTS,,JENNIE CLARKE ELECTRIC AND KITCHEN,cpd11-20mn.pdf
HH115JCFB,JENNIE CLARK RESIDENCE - FIRE ALARM UPGRADE,850,DEPT OF DESIGN & CONSTRUCTION,SHELTERS FOR HOMELESS FAMILIES,,MANHATTAN,HH-0115,1598,1175,446,0,0,0,0,0,1621,1175,446,0,0,0,0,0,1621,2350,892,0,0,0,0,0,3242,PROJECT DELAYED DUE TO BUDGETARY CONSTRAINTS,,JENNIE CLARK RESIDENCE - FIRE ALARM UPGRADE,cpd11-20mn.pdf
HH115REGX,REGENT FAMILY RESIDENCE EXTERIOR UPGRADE,850,DEPT OF DESIGN & CONSTRUCTION,SHELTERS FOR HOMELESS FAMILIES,,MANHATTAN,HH-0115,1080,12680,1790,0,0,0,0,0,14470,12680,1790,0,0,0,0,0,14470,25360,3580,0,0,0,0,0,28940,PROJECT DELAYED DUE TO BUDGETARY CONSTRAINTS,,ALL ARCHITECTURAL AND ENGINEERING DESIGN SERVICES DURING CONSTRUCTIONREQUIRED FOR ALL,cpd11-20mn.pdf
HH115RFEU,REGENT FAMILY APT. ELEC UPGRADE,850,DEPT OF DESIGN & CONSTRUCTION,SHELTERS FOR HOMELESS FAMILIES,,MANHATTAN,HH-0115,7650,1457,0,0,3056,6000,5000,9897,25410,1457,0,0,3056,6000,5000,9897,25410,2914,0,0,6112,12000,10000,19794,50820,,,APT. ELECT UPGRADE,cpd11-20mn.pdf
HL82125VR,125 WORTH ST. - OFFICE OF VITAL RECORDS 1ST FLOOR (LVL 3B),850,DEPT OF DESIGN & CONSTRUCTION,CLINIC RENOVATION AND REHABILITATION,101,MANHATTAN,HL-0082 ED-D075,2890,4169,66,0,0,0,0,0,4235,4169,66,0,0,0,0,0,4235,8338,132,0,0,0,0,0,8470,PROJECT DELAYED DUE TO BUDGETARY CONSTRAINTS,,RENOVATIONS FOR OFFICE VITAL RECORDS SPACE ON 1ST FLOOR,cpd11-20mn.pdf
HL82CHNWH,COMMUNITY HEALTHCARE NETWORK-WASHINGTON HEIGHTS,850,DEPT OF DESIGN & CONSTRUCTION,CLINIC RENOVATION AND REHABILITATION,112,MANHATTAN,HL-D999,560,0,1000,0,0,0,0,0,1000,0,1000,0,0,0,0,0,1000,0,2000,0,0,0,0,0,2000,PROJECT DELAYED PENDING RESOLUTION OF LEGAL ISSUES,,COMMUNITY HEALTHCARE NETWORK-WASHINGTON HEIGHTS,cpd11-20mn.pdf
HL82DNA9F,INITIAL OUTFITTING FOR THE NEW DNA LAB 9TH FLOOR- OCME,850,DEPT OF DESIGN & CONSTRUCTION,EQUIPMENT AND VEHICLES,100,MANHATTAN,HL-0082,15277,14572,0,0,0,0,262,0,14834,14572,0,0,0,0,262,0,14834,29144,0,0,0,0,524,0,29668,PROJECT DELAYED DUE TO BUDGETARY CONSTRAINTS,,,cpd11-20mn.pdf
HL82MANAT,Manhattan Animal Care Center Upgrade,850,DEPT OF DESIGN & CONSTRUCTION,ANIMAL CARE,,MANHATTAN,HL-0082,5000,2038,5398,0,0,0,0,0,7436,2038,5398,0,0,0,0,0,7436,4076,10796,0,0,0,0,0,14872,PROJECT DELAYED DUE TO UNFORESEEN SITE/FIELD CONDITION,,MANHATTAN ANIMAL SHELTER UPGRADE EXISTING GARAGE AND PET RECEIVING CENTER,cpd11-20mn.pdf
HWBARUCH,Baruch College - 25th Street Plaza (MED-634),850,DEPT OF DESIGN & CONSTRUCTION,PRIMARY STREET RECONSTRUCTION,100 105 106,MANHATTAN,HW-1684 WM-0001,4100,5837,632,0,0,0,0,0,6469,5837,632,0,0,0,0,0,6469,11674,1264,0,0,0,0,0,12938,PROJECT DELAYED DUE TO UNFORESEEN SITE/FIELD CONDITION,BARUCH COLLEGE - 25TH STREET PLAZA (LOCATED BETWEEN LEX AND 3RD AVE),BARUCH COLLEGE - 25TH STREET PLAZA (LOCATED BETWEEN LEX AND 3RD AVE),cpd11-20mn.pdf
HWD10211,185th St. - Streetscape Improvements,850,DEPT OF DESIGN & CONSTRUCTION,PRIMARY STREET RECONSTRUCTION,100 112,MANHATTAN,WM-0001 EP-0007,1500,4926,95,0,0,0,0,0,5021,4926,95,0,0,0,0,0,5021,9852,190,0,0,0,0,0,10042,PROJECT DELAYED DUE TO UNFORESEEN SITE/FIELD CONDITION,185TH STREET PUBLIC PLAZA,185TH STREET PUBLIC PLAZA,cpd11-20mn.pdf
HWM100SNC,"79TH STREET SBS, MED-673",850,DEPT OF DESIGN & CONSTRUCTION,PRIMARY STREET RECONSTRUCTION,100,MANHATTAN,HW-1684,11500,2372,0,0,18899,0,0,0,21271,2372,0,0,18899,0,0,0,21271,4744,0,0,37798,0,0,0,42542,PROJECT DELAYED DUE TO BUDGETARY CONSTRAINTS,79TH STREET SBS,79TH STREET SBS,cpd11-20mn.pdf
HWM1159,REHABILITATION OF PECK SLIP,850,DEPT OF DESIGN & CONSTRUCTION,PRIMARY STREET RECONSTRUCTION,101,MANHATTAN,HW-0944,9621,6880,0,0,0,0,0,0,6880,6880,0,0,0,0,0,0,6880,13760,0,0,0,0,0,0,13760,PROJECT DELAYED DUE TO CHANGES IN SCOPE/DESIGN,,,cpd11-20mn.pdf
HWM12AVE,12th Avenue Accessibility Improvements,850,DEPT OF DESIGN & CONSTRUCTION,PRIMARY STREET RECONSTRUCTION,100,MANHATTAN,HW-0001M HW-D102 HW-0001,2300,0,984,0,0,4749,0,0,5733,0,984,0,0,4749,0,0,5733,0,1968,0,0,9498,0,0,11466,,12TH AVENUE ACCESSIBILITY IMPROVEMENTS,12TH AVENUE ACCESSIBILITY IMPROVEMENTS,cpd11-20mn.pdf
HWM2025,Delancey Street Safety Improvements (MED-667),850,DEPT OF DESIGN & CONSTRUCTION,PRIMARY STREET RECONSTRUCTION,100,MANHATTAN,HW-0001M HW-0001 HW-D102 HW-M002,24177,985,0,35918,0,0,0,0,36903,985,0,35918,0,0,0,0,36903,1970,0,71836,0,0,0,0,73806,PROJECT DELAYED DUE TO UNFORESEEN SITE/FIELD CONDITION,,DELANCEY STREET SAFETY IMPROVEMENTS,cpd11-20mn.pdf
HWMM008,"EAST 86TH ST STREETSCAPE-225 EAST 79TH ,MADISON TO YORK AVE",850,DEPT OF DESIGN & CONSTRUCTION,PRIMARY STREET RECONSTRUCTION,100 108,MANHATTAN,HW-0001M,1000,12409,0,0,0,0,0,0,12409,12409,0,0,0,0,0,0,12409,24818,0,0,0,0,0,0,24818,PROJECT DELAYED DUE TO UNFORESEEN SITE/FIELD CONDITION,EAST 86TH MERCHANT/RESIDENTS ASSOCIATION-STREETSCAPE IMPRV.,EAST 86TH MERCHANT/RESIDENT ASSOCIATION-STREETSCAPE IMPRV.,cpd11-20mn.pdf
HWMME43ST,"43rd Street Shared Street, MED-670",850,DEPT OF DESIGN & CONSTRUCTION,PRIMARY STREET RECONSTRUCTION,100,MANHATTAN,HW-0001M,11000,1855,0,0,15778,0,0,0,17633,1855,0,0,15778,0,0,0,17633,3710,0,0,31556,0,0,0,35266,,43RD STREET SHARED STREET,HWMME43ST,cpd11-20mn.pdf
HWMNYPL,New York Public Library Pedestrian Improvements,850,DEPT OF DESIGN & CONSTRUCTION,PRIMARY STREET RECONSTRUCTION,100,MANHATTAN,HW-0001M HW-0200 TF-0002 TF-0502,4832,623,45,2899,0,0,0,0,3567,623,45,2899,0,0,0,0,3567,1246,90,5798,0,0,0,0,7134,PROJECT DELAYED DUE TO UNFORESEEN SITE/FIELD CONDITION,NEW YORK PUBLIC LIBRARY PEDESTRIAN IMPROVEMENTS,NEW YORK PUBLIC LIBRARY PEDESTRIAN IMPROVEMENTS,cpd11-20mn.pdf
HWMP116,RECON OF ASTOR PLACE AND COOPER SQUARE,850,DEPT OF DESIGN & CONSTRUCTION,PRIMARY STREET RECONSTRUCTION,103,MANHATTAN,TF-0002 P-0245M,5895,26986,5,0,32,0,0,0,27023,26986,5,0,32,0,0,0,27023,53972,10,0,64,0,0,0,54046,PROJECT DELAYED DUE TO UNFORESEEN SITE/FIELD CONDITION,,,cpd11-20mn.pdf
HWMP2012,TIMES SQUARE (SEN002160),850,DEPT OF DESIGN & CONSTRUCTION,PRIMARY STREET RECONSTRUCTION,105,MANHATTAN,HW-0944 HW-0001 HW-1666,24719,70168,2,335,0,3260,0,0,73765,70168,2,335,0,3260,0,0,73765,140336,4,670,0,6520,0,0,147530,PROJECT DELAYED DUE TO UNFORESEEN SITE/FIELD CONDITION,TIMES SQUARE,TIMES SQUARE,cpd11-20mn.pdf
HWMP2019,RECONSTRUCTION OF EAST HOUSTON STREET (MED-604),850,DEPT OF DESIGN & CONSTRUCTION,PRIMARY STREET RECONSTRUCTION,100 103,MANHATTAN,HW-0001M,3903,37818,93,0,0,0,0,0,37911,37818,93,0,0,0,0,0,37911,75636,186,0,0,0,0,0,75822,PROJECT DELAYED DUE TO UNFORESEEN SITE/FIELD CONDITION,RECONSTRUCTION OF EAST HOUSTON STREET,RECONSTRUCTION OF EAST HOUSTON STREET,cpd11-20mn.pdf
HWMP2020,"Reconstruction of Gansevoort Area, Manhattan",850,DEPT OF DESIGN & CONSTRUCTION,PRIMARY STREET RECONSTRUCTION,100 102,MANHATTAN,HW-0001M TF-0002 WM-0001,14700,19426,1409,0,0,0,0,0,20835,19426,1409,0,0,0,0,0,20835,38852,2818,0,0,0,0,0,41670,PROJECT DELAYED DUE TO UNFORESEEN SITE/FIELD CONDITION,RECONSTRUCTION OF GANSEVOORT AREA,RECONSTRUCTION OF GANSEVOORT AREA,cpd11-20mn.pdf
HWMWTCA7A,"RECONSTRUCTION OF GREENWICH ST, HARRISON ST & LEONARD ST",850,DEPT OF DESIGN & CONSTRUCTION,PRIMARY STREET RECONSTRUCTION,101,MANHATTAN,HW-0944,5676,1477,0,0,0,0,0,0,1477,1477,0,0,0,0,0,0,1477,2954,0,0,0,0,0,0,2954,PROJECT DELAYED DUE TO UNFORESEEN SITE/FIELD CONDITION,"RECONSTRUCTION OF GREENWICH ST, HARRISON ST & LEONARD ST","RECONSTRUCTION OF GREENWICH ST, HARRISON ST & LEONARD ST",cpd11-20mn.pdf
HWMWTCA7D,RECONSTRUCTION OF PECK SLIP - FRONT ST TO PEARL ST,850,DEPT OF DESIGN & CONSTRUCTION,PRIMARY STREET RECONSTRUCTION,101,MANHATTAN,HW-1670 TF-0002 TF-0502,6489,260,0,0,0,0,0,8,268,260,0,0,0,0,0,8,268,520,0,0,0,0,0,16,536,PROJECT DELAYED DUE TO CHANGES IN SCOPE/DESIGN,RECONSTRUCTION OF PECK SLIP - FRONT ST TO PEARL ST,RECONSTRUCTION OF PECK SLIP - FRONT ST TO PEARL ST,cpd11-20mn.pdf
HWMWTCA7E,RECONSTRUCTION OF WORTH ST - HUDSON ST TO EAST BROADWAY,850,DEPT OF DESIGN & CONSTRUCTION,PRIMARY STREET RECONSTRUCTION,101,MANHATTAN,TF-0502 HW-0001M HW-0944 HW-1670,7045,4332,1051,0,0,0,0,0,5383,4332,1051,0,0,0,0,0,5383,8664,2102,0,0,0,0,0,10766,PROJECT DELAYED DUE TO CHANGES IN SCOPE/DESIGN,RECONSTRUCTION OF WORTH ST - HUDSON ST TO EAST BROADWAY,RECONSTRUCTION OF WORTH ST - HUDSON ST TO EAST BROADWAY,cpd11-20mn.pdf
HWMWTCA7F,RECONSTRUCTION OF WARREN ST - WEST ST TO BROADWAY,850,DEPT OF DESIGN & CONSTRUCTION,PRIMARY STREET RECONSTRUCTION,101,MANHATTAN,HW-0944 HW-1670,5680,2195,8,0,0,0,0,0,2203,2195,8,0,0,0,0,0,2203,4390,16,0,0,0,0,0,4406,PROJECT DELAYED DUE TO UNFORESEEN SITE/FIELD CONDITION,RECONSTRUCTION OF WARREN ST - WEST ST TO BROADWAY,RECONSTRUCTION OF WARREN ST - WEST ST TO BROADWAY,cpd11-20mn.pdf
HWMWTCA8B,"RECONSTRUCTION OF FULTON ST & ANCILLARY STREETSCAPE, MED-601",850,DEPT OF DESIGN & CONSTRUCTION,PRIMARY STREET RECONSTRUCTION,101,MANHATTAN,HW-1670 HW-0001M HW-0944 HW-0200,26563,5025,67,0,1,0,0,0,5093,5025,67,0,1,0,0,0,5093,10050,134,0,2,0,0,0,10186,PROJECT DELAYED DUE TO UNFORESEEN SITE/FIELD CONDITION,RECONSTRUCTION OF FULTON ST & ANCILLARY STREETSCAPE,RECONSTRUCTION OF FULTON ST & ANCILLARY STREETSCAPE,cpd11-20mn.pdf
HWMWTCB1,Reconstruction of Nassau St,850,DEPT OF DESIGN & CONSTRUCTION,PRIMARY STREET RECONSTRUCTION,100,MANHATTAN,HW-0001M TF-0002 TF-0502,12650,456,0,3767,0,0,0,0,4223,456,0,3767,0,0,0,0,4223,912,0,7534,0,0,0,0,8446,PROJECT DELAYED DUE TO UNFORESEEN SITE/FIELD CONDITION,RECONSTRUCTION OF NASSAU ST,RECONSTRUCTION OF NASSAU ST,cpd11-20mn.pdf
HWMWTCB2,Reconstruction of Greenwich,850,DEPT OF DESIGN & CONSTRUCTION,PRIMARY STREET RECONSTRUCTION,100,MANHATTAN,HW-0001M HW-0200 HW-0944 TF-0002 TF-0502,21360,1238,4343,0,0,0,0,0,5581,1238,4343,0,0,0,0,0,5581,2476,8686,0,0,0,0,0,11162,PROJECT DELAYED DUE TO UNFORESEEN SITE/FIELD CONDITION,RECONSTRUCTION OF GREENWICH,RECONSTRUCTION OF GREENWICH,cpd11-20mn.pdf
HWMWTCB6,"Reconstruction of Vesey St, MED-668",850,DEPT OF DESIGN & CONSTRUCTION,PRIMARY STREET RECONSTRUCTION,100,MANHATTAN,HW-0001M,23010,895,0,2802,0,0,0,0,3697,895,0,2802,0,0,0,0,3697,1790,0,5604,0,0,0,0,7394,,RECONSTRUCTION OF VESEY ST,RECONSTRUCTION OF VESEY ST,cpd11-20mn.pdf
HWMWTCB7,Reconstruction of Trinity Pl,850,DEPT OF DESIGN & CONSTRUCTION,PRIMARY STREET RECONSTRUCTION,100,MANHATTAN,HW-0001M,39140,752,0,8054,0,0,0,0,8806,752,0,8054,0,0,0,0,8806,1504,0,16108,0,0,0,0,17612,PROJECT DELAYED DUE TO CHANGES IN SCOPE/DESIGN,RECONSTRUCTION OF TRINITY PL,RECONSTRUCTION OF TRINITY PL,cpd11-20mn.pdf
HWMWTCB8,Reconstruction of Broadway Phase 2,850,DEPT OF DESIGN & CONSTRUCTION,PRIMARY STREET RECONSTRUCTION,100,MANHATTAN,HW-0001M SE-0002M WM-0001 WM-0006,67660,600,598,0,0,7510,0,0,8708,600,598,0,0,7510,0,0,8708,1200,1196,0,0,15020,0,0,17416,PROJECT DELAYED DUE TO UNFORESEEN SITE/FIELD CONDITION,RECONSTRUCTION OF BROADWAY PHASE 2,RECONSTRUCTION OF BROADWAY PHASE 2,cpd11-20mn.pdf
HWPLZ003M,Montefiore Park and Plaza Reconstruction/Improvement,850,DEPT OF DESIGN & CONSTRUCTION,PRIMARY STREET RECONSTRUCTION,100 109,MANHATTAN,WM-0001 WM-0006 HW-1684,6003,16923,1509,0,0,0,0,0,18432,16923,1509,0,0,0,0,0,18432,33846,3018,0,0,0,0,0,36864,PROJECT DELAYED DUE TO UNFORESEEN SITE/FIELD CONDITION,MONTEFIORE PARK AND PLAZA RECONSTRUCTION/IMPROVEMENT,MONTEFIORE PARK AND PLAZA RECONSTRUCTION/IMPROVEMENT,cpd11-20mn.pdf
HWPLZ012M,Bogardus Plaza Clock Tower,850,DEPT OF DESIGN & CONSTRUCTION,PRIMARY STREET RECONSTRUCTION,100 101,MANHATTAN,HW-1684 TF-0502,1835,9225,376,0,0,0,0,0,9601,9225,376,0,0,0,0,0,9601,18450,752,0,0,0,0,0,19202,PROJECT DELAYED DUE TO UNFORESEEN SITE/FIELD CONDITION,BOGARDUS PLAZA CLOCK TOWER,BOGARDUS PLAZA CLOCK TOWER,cpd11-20mn.pdf
HWPLZ015M,Pershing Square East Plaza/Streetscape Reconstruction,850,DEPT OF DESIGN & CONSTRUCTION,PRIMARY STREET RECONSTRUCTION,100,MANHATTAN,HW-0001M,13020,1622,0,12017,0,0,0,0,13639,1622,0,12017,0,0,0,0,13639,3244,0,24034,0,0,0,0,27278,PROJECT DELAYED DUE TO UNFORESEEN SITE/FIELD CONDITION,PERSHING SQUARE EAST PLAZA/STREETSCAPE RECONSTRUCTION,PERSHING SQUARE EAST PLAZA/STREETSCAPE RECONSTRUCTION,cpd11-20mn.pdf
HWPR19M,Pedestrian Ramp Rehabilitation - Manhattan,850,DEPT OF DESIGN & CONSTRUCTION,PEDESTRIAN RAMP CONSTRUCTION,100,MANHATTAN,HW-0200,12156,5354,8401,1089,0,0,0,0,14844,5354,8401,1089,0,0,0,0,14844,10708,16802,2178,0,0,0,0,29688,PROJECT DELAYED DUE TO UNFORESEEN SITE/FIELD CONDITION,,PEDESTRIAN RAMP REHABILITATION - MANHATTAN,cpd11-20mn.pdf
HWPR19MC1,Complex Upgrades Ped Ramps - Manhattan,850,DEPT OF DESIGN & CONSTRUCTION,PEDESTRIAN RAMP CONSTRUCTION,100,MANHATTAN,HW-0200,8516,1293,0,7815,0,0,0,0,9108,1293,0,7815,0,0,0,0,9108,2586,0,15630,0,0,0,0,18216,PROJECT DELAYED DUE TO BUDGETARY CONSTRAINTS,COMPLEX UPGRADES PED RAMPS - MANHATTAN,COMPLEX UPGRADES PED RAMPS - MANHATTAN,cpd11-20mn.pdf
HWPR19MC2,Complex Upgrades Ped Ramps - Manhattan,850,DEPT OF DESIGN & CONSTRUCTION,PEDESTRIAN RAMP CONSTRUCTION,100,MANHATTAN,HW-0200,8043,1199,0,7497,0,0,0,0,8696,1199,0,7497,0,0,0,0,8696,2398,0,14994,0,0,0,0,17392,PROJECT DELAYED DUE TO BUDGETARY CONSTRAINTS,COMPLEX UPGRADES PED RAMPS - MANHATTAN,COMPLEX UPGRADES PED RAMPS - MANHATTAN,cpd11-20mn.pdf
HWPR20MCL,Non-Standard Upgrades Ped Ramp - Manhattan Landmark,850,DEPT OF DESIGN & CONSTRUCTION,PEDESTRIAN RAMP CONSTRUCTION,100,MANHATTAN,HW-0200,7257,384,505,6752,0,0,0,0,7641,384,505,6752,0,0,0,0,7641,768,1010,13504,0,0,0,0,15282,PROJECT DELAYED DUE TO BUDGETARY CONSTRAINTS,COMPLEX UPGRADES PED RAMP - MANHATTAN LANDMARK,COMPLEX UPGRADES PED RAMP - MANHATTAN LANDMARK,cpd11-20mn.pdf
HWS2011M,PRIOR NOTICE SIDEWALKS - MANHATTAN (SIM),850,DEPT OF DESIGN & CONSTRUCTION,SIDEWALK RECONSTRUCTION,100,MANHATTAN,HW-0200,2879,2658,0,0,0,0,0,0,2658,2658,0,0,0,0,0,0,2658,5316,0,0,0,0,0,0,5316,,PRIOR NOTICE SIDEWALKS - MANHATTAN (SIM),PRIOR NOTICE SIDEWALKS - MANHATTAN (SIM),cpd11-20mn.pdf
HWS2013M,PRIOR NOTICE SIDEWALKS - MANHATTAN,850,DEPT OF DESIGN & CONSTRUCTION,SIDEWALK RECONSTRUCTION,100,MANHATTAN,HW-0200,0,2069,42,0,0,0,0,0,2111,2069,42,0,0,0,0,0,2111,4138,84,0,0,0,0,0,4222,,PRIOR NOTICE SIDEWALKS - MANHATTAN,PRIOR NOTICE SIDEWALKS - MANHATTAN,cpd11-20mn.pdf
HWS2018M,Prior Notice Sidewalks - Manhattan,850,DEPT OF DESIGN & CONSTRUCTION,SIDEWALK RECONSTRUCTION,100,MANHATTAN,HW-0200,2338,3336,40,0,0,0,0,0,3376,3336,40,0,0,0,0,0,3376,6672,80,0,0,0,0,0,6752,,PRIOR NOTICE SIDEWALKS - MANHATTAN,PRIOR NOTICE SIDEWALKS - MANHATTAN,cpd11-20mn.pdf
LNCA0996S,96TH STREET - Exterior Rehabilitation,850,DEPT OF DESIGN & CONSTRUCTION,ESSENTIAL RECONSTRUCTION OF FACILITIES,108,MANHATTAN,LN-D008 LN-0008,670,1964,329,0,0,0,0,0,2293,1964,329,0,0,0,0,0,2293,3928,658,0,0,0,0,0,4586,PROJECT DELAYED DUE TO BUDGETARY CONSTRAINTS,,EXTERIOR REHABILITATION,cpd11-20mn.pdf
LNCA09KIP,KIPS BAY - Exterior Rehabilitation,850,DEPT OF DESIGN & CONSTRUCTION,ESSENTIAL RECONSTRUCTION OF FACILITIES,106,MANHATTAN,LN-D003 LN-D008,758,347,0,0,0,1672,0,0,2019,347,0,0,0,1672,0,0,2019,694,0,0,0,3344,0,0,4038,PROJECT DELAYED DUE TO BUDGETARY CONSTRAINTS,,EXTERIOR REHABILITATION,cpd11-20mn.pdf
LNCA10115,115TH STREET - Removal and Replacement of Floors,850,DEPT OF DESIGN & CONSTRUCTION,IMPROVEMENTS TO EXISTING FACILITIES,110,MANHATTAN,LN-0008 LN-D008 LN-M001,334,2949,232,0,0,0,0,0,3181,2949,232,0,0,0,0,0,3181,5898,464,0,0,0,0,0,6362,PROJECT DELAYED DUE TO BUDGETARY CONSTRAINTS,,REMOVAL AND REPLACEMENT OF FLOORS,cpd11-20mn.pdf
LNCA10AGL,AGUILAR - Facade Restoration,850,DEPT OF DESIGN & CONSTRUCTION,IMPROVEMENTS TO EXISTING FACILITIES,111,MANHATTAN,LN-D008 LN-0008 LN-D003,525,758,1227,0,0,0,0,0,1985,758,1227,0,0,0,0,0,1985,1516,2454,0,0,0,0,0,3970,PROJECT DELAYED DUE TO BUDGETARY CONSTRAINTS,,FACADE RESTORATION,cpd11-20mn.pdf
LNCA10JMB,JEFFERSON MARKET - ADA Accessibility,850,DEPT OF DESIGN & CONSTRUCTION,IMPROVEMENTS TO EXISTING FACILITIES,102,MANHATTAN,LN-0008 LN-D008 LN-0101M,1540,10929,201,787,0,0,0,0,11917,10929,201,787,0,0,0,0,11917,21858,402,1574,0,0,0,0,23834,PROJECT DELAYED DUE TO BUDGETARY CONSTRAINTS,,JEFFERSON MARKET - ADA ACCESSIBILITY,cpd11-20mn.pdf
LNCA10RIS,ROOSEVELT ISLAND - NEW BRANCH LIBRARY,850,DEPT OF DESIGN & CONSTRUCTION,EXPANSION AND CONSTRUCTION OF FACILITIES,108,MANHATTAN,LN-0008,5700,9045,252,0,75,0,0,0,9372,9045,252,0,75,0,0,0,9372,18090,504,0,150,0,0,0,18744,PROJECT DELAYED DUE TO BUDGETARY CONSTRAINTS,,ROOSEVELT ISL - SITE SLECTION/DESIGN,cpd11-20mn.pdf
LNCA1167S,67TH STREET - Partial Interior Renovation,850,DEPT OF DESIGN & CONSTRUCTION,ESSENTIAL RECONSTRUCTION OF FACILITIES,108,MANHATTAN,LN-0008,500,3229,11,0,105,0,0,0,3345,3229,11,0,105,0,0,0,3345,6458,22,0,210,0,0,0,6690,PROJECT DELAYED DUE TO CHANGES IN SCOPE/DESIGN,,INTERIOR,cpd11-20mn.pdf
LNCA11BLD,BLOOMINGDALE - Interior Renovation,850,DEPT OF DESIGN & CONSTRUCTION,ESSENTIAL RECONSTRUCTION OF FACILITIES,107,MANHATTAN,LN-0008,200,3263,452,0,0,0,0,0,3715,3263,452,0,0,0,0,0,3715,6526,904,0,0,0,0,0,7430,PROJECT DELAYED DUE TO BUDGETARY CONSTRAINTS,,INTERIOR,cpd11-20mn.pdf
LNCA12EPH,EPIPHANY - FACADE RESTORATION,850,DEPT OF DESIGN & CONSTRUCTION,ESSENTIAL RECONSTRUCTION OF FACILITIES,100 106,MANHATTAN,LN-D008 LN-0008,700,370,0,0,0,1558,0,0,1928,370,0,0,0,1558,0,0,1928,740,0,0,0,3116,0,0,3856,PROJECT DELAYED DUE TO CHANGES IN SCOPE/DESIGN,,FACADE,cpd11-20mn.pdf
LNCA12SWP,SEWARD PARK - Replace sidealk over vault and waterproof,850,DEPT OF DESIGN & CONSTRUCTION,ESSENTIAL RECONSTRUCTION OF FACILITIES,100 103,MANHATTAN,LN-D008,250,320,0,0,69,0,0,0,389,320,0,0,69,0,0,0,389,640,0,0,138,0,0,0,778,PROJECT DELAYED DUE TO CHANGES IN SCOPE/DESIGN,,REPLACE SIDEALK OVER VAULT AND WATERPROOF,cpd11-20mn.pdf
LNCA13CCL,COUNTEE CULLEN,850,DEPT OF DESIGN & CONSTRUCTION,ESSENTIAL RECONSTRUCTION OF FACILITIES,110,MANHATTAN,LN-D008,560,606,100,158,0,0,0,0,864,606,100,158,0,0,0,0,864,1212,200,316,0,0,0,0,1728,PROJECT DELAYED DUE TO CHANGES IN SCOPE/DESIGN,,BOILER,cpd11-20mn.pdf
LNCA13GBR,GEORGE BRUCE,850,DEPT OF DESIGN & CONSTRUCTION,ESSENTIAL RECONSTRUCTION OF FACILITIES,109,MANHATTAN,LN-D008 LN-0008,2650,362,103,165,3614,0,0,0,4244,362,103,165,3614,0,0,0,4244,724,206,330,7228,0,0,0,8488,PROJECT DELAYED DUE TO CHANGES IN SCOPE/DESIGN,,ROOF / BOILER,cpd11-20mn.pdf
LNCA13HAM,HAMILTON FISH,850,DEPT OF DESIGN & CONSTRUCTION,ESSENTIAL RECONSTRUCTION OF FACILITIES,100 103,MANHATTAN,LN-0008 LN-D008 PU-0025,2590,1545,35,8271,56,0,0,0,9907,1545,35,8271,56,0,0,0,9907,3090,70,16542,112,0,0,0,19814,PROJECT DELAYED DUE TO CHANGES IN SCOPE/DESIGN,,REHABILITATION,cpd11-20mn.pdf
LNCA13HUD,HUDSON PARK,850,DEPT OF DESIGN & CONSTRUCTION,ESSENTIAL RECONSTRUCTION OF FACILITIES,100 102,MANHATTAN,LN-D008 LN-0008 LN-0101M,2550,619,0,0,0,4193,1840,200,6852,619,0,0,0,4193,1840,200,6852,1238,0,0,0,8386,3680,400,13704,PROJECT DELAYED DUE TO CHANGES IN SCOPE/DESIGN,,RENOVATION,cpd11-20mn.pdf
LNCA13MLB,MUHLENBERG,850,DEPT OF DESIGN & CONSTRUCTION,ESSENTIAL RECONSTRUCTION OF FACILITIES,104,MANHATTAN,LN-D008 LN-0101M LN-0008,709,307,802,0,0,0,0,0,1109,307,802,0,0,0,0,0,1109,614,1604,0,0,0,0,0,2218,PROJECT DELAYED DUE TO BUDGETARY CONSTRAINTS,,ELEVATOR,cpd11-20mn.pdf
LNCA13NAM,NEW AMSTERDAM - HVAC and Cooling Tower,850,DEPT OF DESIGN & CONSTRUCTION,IMPROVEMENTS TO EXISTING FACILITIES,100 101,MANHATTAN,LN-0008,3024,4688,760,0,0,0,0,0,5448,4688,760,0,0,0,0,0,5448,9376,1520,0,0,0,0,0,10896,PROJECT DELAYED DUE TO CHANGES IN SCOPE/DESIGN,,HVAC AND COOLING TOWER,cpd11-20mn.pdf
LNCA14MBG,HVAC and Related Work,850,DEPT OF DESIGN & CONSTRUCTION,ESSENTIAL RECONSTRUCTION OF FACILITIES,100,MANHATTAN,LN-D008 LN-0008 LN-M001,500,581,2074,0,0,0,0,0,2655,581,2074,0,0,0,0,0,2655,1162,4148,0,0,0,0,0,5310,PROJECT DELAYED PENDING RESOLUTION OF LEGAL ISSUES,,HVAC AND RELATED WORK,cpd11-20mn.pdf
LNCA15SPK,New Boiler,850,DEPT OF DESIGN & CONSTRUCTION,ESSENTIAL RECONSTRUCTION OF FACILITIES,100,MANHATTAN,LN-D008,963,1052,54,0,0,0,0,0,1106,1052,54,0,0,0,0,0,1106,2104,108,0,0,0,0,0,2212,PROJECT DELAYED DUE TO BUDGETARY CONSTRAINTS,,NEW BOILER,cpd11-20mn.pdf
LNCAL15CC,Countee Cullen,850,DEPT OF DESIGN & CONSTRUCTION,ESSENTIAL RECONSTRUCTION OF FACILITIES,100,MANHATTAN,LN-D008 LN-0008 LN-M001 LN-D003,2593,994,6330,0,0,0,0,0,7324,994,6330,0,0,0,0,0,7324,1988,12660,0,0,0,0,0,14648,PROJECT DELAYED DUE TO BUDGETARY CONSTRAINTS,,COUNTEE CULLEN,cpd11-20mn.pdf
LNEA08MHV,MANHATTAN (Northern) - HVAC @ Four Branch Libraries,850,DEPT OF DESIGN & CONSTRUCTION,ESSENTIAL RECONSTRUCTION OF FACILITIES,100 108 109 111 112,MANHATTAN,LN-D008 LN-0101M LN-D003 LN-M001 LN-0008,4460,4285,2362,762,0,0,0,0,7409,4285,2362,762,0,0,0,0,7409,8570,4724,1524,0,0,0,0,14818,PROJECT DELAYED DUE TO UNFORESEEN SITE/FIELD CONDITION,,HVAC @ FOUR BRANCHS - MANHATTAN                                              125TH STREET BRANCH,cpd11-20mn.pdf
LNEA13HGR,HAMILTON GRANGE,850,DEPT OF DESIGN & CONSTRUCTION,ESSENTIAL RECONSTRUCTION OF FACILITIES,100 109,MANHATTAN,LN-0008 LN-D008 LN-0101X,885,843,0,260,2557,0,0,0,3660,843,0,260,2557,0,0,0,3660,1686,0,520,5114,0,0,0,7320,PROJECT DELAYED DUE TO BUDGETARY CONSTRAINTS,,EXTERIOR REHABILIATION/ WINDOW REPLACEMENT,cpd11-20mn.pdf
LNEM12MLB,MUHLENBERG - Sidewalk Vault,850,DEPT OF DESIGN & CONSTRUCTION,ESSENTIAL RECONSTRUCTION OF FACILITIES,104,MANHATTAN,LN-0008 LN-D008,856,320,716,0,0,0,0,0,1036,320,716,0,0,0,0,0,1036,640,1432,0,0,0,0,0,2072,PROJECT DELAYED DUE TO BUDGETARY CONSTRAINTS,,VAULT,cpd11-20mn.pdf
LNEM13JMK,JEFFERSON MARKET,850,DEPT OF DESIGN & CONSTRUCTION,ESSENTIAL RECONSTRUCTION OF FACILITIES,100 102,MANHATTAN,LN-0101M LN-0008 LN-0101R,362,620,0,93,0,0,0,0,713,620,0,93,0,0,0,0,713,1240,0,186,0,0,0,0,1426,PROJECT DELAYED DUE TO BUDGETARY CONSTRAINTS,,FIRE,cpd11-20mn.pdf
LNMNA08LS,MANHATTAN - Life Safety Projects @ 17 Branch Libraries,850,DEPT OF DESIGN & CONSTRUCTION,ESSENTIAL RECONSTRUCTION OF FACILITIES,100,MANHATTAN,LN-D008 LN-0101M LN-D003 LN-0101X LN-0008,3719,5440,669,0,0,0,0,0,6109,5440,669,0,0,0,0,0,6109,10880,1338,0,0,0,0,0,12218,PROJECT DELAYED DUE TO UNFORESEEN SITE/FIELD CONDITION,,LIFE SAFETY PROJECTS @ 16 BRANCH LIBRARIES - MANHATTAN,cpd11-20mn.pdf
LRCA17SCH,SCHOMBURG - Renovation Phase II Passthrough,850,DEPT OF DESIGN & CONSTRUCTION,ESSENTIAL RECONSTRUCTION OF FACILITIES,100 110,MANHATTAN,L-D002,14458,13351,0,0,0,0,1374,0,14725,13351,0,0,0,0,1374,0,14725,26702,0,0,0,0,2748,0,29450,PROJECT DELAYED DUE TO BUDGETARY CONSTRAINTS,,PHASEII,cpd11-20mn.pdf
MED-594,WM RPLMT IN E 46 ST & E 47 ST B/T MADISON AV & LEXINGTON AV,850,DEPT OF DESIGN & CONSTRUCTION,TRUNK AND DISTRIBUTION MAIN REPLACEMENT,105,MANHATTAN,WM-0001 EP-0007 TF-0502,772,1163,0,0,27824,0,0,0,28987,1163,0,0,27824,0,0,0,28987,2326,0,0,55648,0,0,0,57974,PROJECT DELAYED DUE TO CHANGES IN SCOPE/DESIGN,,WM RPLMT IN E 46 ST & E 47 ST B/T MADISON AV & LEXINGTON AV,cpd11-20mn.pdf
MED-596,TRUNK WM IN HUDSON ST FRM LAIGHT ST TO WORTH ST,850,DEPT OF DESIGN & CONSTRUCTION,AUGMENTATION OF WATER SUPPLY SYSTEMS,101,MANHATTAN,SE-0944,7769,49000,0,0,0,0,0,0,49000,49000,0,0,0,0,0,0,49000,98000,0,0,0,0,0,0,98000,PROJECT DELAYED DUE TO UNFORESEEN SITE/FIELD CONDITION,,"TRUNK WM IN HUDSON ST FRM LAIGHT ST TO WORTH ST, ETC TO CONNECT TO SHAFT 29B (TUNNEL #3)",cpd11-20mn.pdf
MED-597,TRUNK WM IN EAST 31 STREET FRM 5TH AV TO 2ND AV,850,DEPT OF DESIGN & CONSTRUCTION,TRUNK AND DISTRIBUTION MAIN REPLACEMENT,105 106,MANHATTAN,WM-0006 WM-0001 SE-0002M,6454,174,0,0,0,14944,0,0,15118,174,0,0,0,14944,0,0,15118,348,0,0,0,29888,0,0,30236,PROJECT DELAYED DUE TO CHANGES IN SCOPE/DESIGN,,TRUNK WM IN EAST 31 STREET FRM 5TH AV TO 2ND AV,cpd11-20mn.pdf
MED-598B,TRUNK WM IN W 30 ST - 9 AV TO 10 AV (SHAFT 26B) - PHASE B,850,DEPT OF DESIGN & CONSTRUCTION,TRUNK AND DISTRIBUTION MAIN REPLACEMENT,104 105,MANHATTAN,WM-0006 WM-0001 SE-0002M TF-0002 TF-0502,64919,52589,6749,0,0,0,0,0,59338,52589,6749,0,0,0,0,0,59338,105178,13498,0,0,0,0,0,118676,PROJECT DELAYED DUE TO UNFORESEEN SITE/FIELD CONDITION,TRUNK WM IN W 30 ST - 9 AV TO 10 AV (SHAFT 26B) - PHASE B,TRUNK WM IN W 30 ST - 9 AV TO 10 AV (SHAFT 26B) - PHASE B,cpd11-20mn.pdf
MED-604,TRUNK & DIS WM IN EAST HOUSTONS ST (HWMP2019),850,DEPT OF DESIGN & CONSTRUCTION,TRUNK AND DISTRIBUTION MAIN REPLACEMENT,103,MANHATTAN,WM-0006,11357,33186,508,0,0,0,0,0,33694,33186,508,0,0,0,0,0,33694,66372,1016,0,0,0,0,0,67388,PROJECT DELAYED DUE TO UNFORESEEN SITE/FIELD CONDITION,,TRUNK & DIS WM IN EAST HOUSTONS ST B/T BOWERY & FDR DR,cpd11-20mn.pdf
MED-607,TRUNK MAIN CONN TO SHAFT 32B IN 2ND AVE. INTER. OF E. 35ST.,850,DEPT OF DESIGN & CONSTRUCTION,TRUNK AND DISTRIBUTION MAIN REPLACEMENT,106,MANHATTAN,WM-0006 WM-0001 SE-0002M,13913,44221,3472,0,0,0,0,0,47693,44221,3472,0,0,0,0,0,47693,88442,6944,0,0,0,0,0,95386,PROJECT DELAYED DUE TO CHANGES IN SCOPE/DESIGN,,TRUNK MAIN CONN TO SHAFT 32B IN 2ND AVE. INTER. OF E. 35ST.,cpd11-20mn.pdf
MED-609,"TRUNK MAIN IN W60 ST, W.E. AVE TO COLUMBUS AV",850,DEPT OF DESIGN & CONSTRUCTION,TRUNK AND DISTRIBUTION MAIN EXTENSION,107,MANHATTAN,EP-0007,9031,100440,711,0,0,0,0,0,101151,100440,711,0,0,0,0,0,101151,200880,1422,0,0,0,0,0,202302,PROJECT DELAYED DUE TO UNFORESEEN SITE/FIELD CONDITION,,"TRUNK MAIN IN W60 ST, WEST END AVE TO COLUMBUS AV, TO CONNECT TO SHAFT 24B",cpd11-20mn.pdf
MED-610,TRUNK MAIN CONNECTION TO SHAFT 27B,850,DEPT OF DESIGN & CONSTRUCTION,TRUNK AND DISTRIBUTION MAIN EXTENSION,103,MANHATTAN,HW-D102,14250,30547,55,0,0,0,0,0,30602,30547,55,0,0,0,0,0,30602,61094,110,0,0,0,0,0,61204,PROJECT DELAYED DUE TO UNFORESEEN SITE/FIELD CONDITION,,TRUNK MAIN CONNECTION TO SHAFT 27B IN HUDSON ST BETW GANSEVOORT ST & W 13 ST,cpd11-20mn.pdf
MED-611,TRUNK WM REPLACMT IN TRANSVERSE RD 3,850,DEPT OF DESIGN & CONSTRUCTION,AUGMENTATION OF WATER SUPPLY SYSTEMS,108,MANHATTAN,WM-0006 WM-0001,4158,0,0,0,0,0,4158,0,4158,0,0,0,0,0,4158,0,4158,0,0,0,0,0,8316,0,8316,,,"TRUNK WM REPLACMT IN TRANSVERSE RD 3, B/T 85 ST & 86 ST",cpd11-20mn.pdf
MED-619,"Trunk Main replacement, b'way b/t w 93 & 97 st, Manh",850,DEPT OF DESIGN & CONSTRUCTION,TRUNK AND DISTRIBUTION MAIN REPLACEMENT,107,MANHATTAN,WM-0006 WM-0001 SE-0002M,7751,831,0,0,9987,0,0,0,10818,831,0,0,9987,0,0,0,10818,1662,0,0,19974,0,0,0,21636,,,"RUNK MAIN REPLACEMENT, B'WAY B/T W 93 & 97 ST, MANH",cpd11-20mn.pdf
MED-622,"Water Main Replacement Park Ave, Man (HWPLZ004M)",850,DEPT OF DESIGN & CONSTRUCTION,TRUNK AND DISTRIBUTION MAIN REPLACEMENT,105,MANHATTAN,WM-0001 WM-0006,2475,14688,147,0,0,0,0,0,14835,14688,147,0,0,0,0,0,14835,29376,294,0,0,0,0,0,29670,PROJECT DELAYED DUE TO UNFORESEEN SITE/FIELD CONDITION,,"PERSHING SQ W PLAZA WM REPLACEMENT PARK AVE B/T E 40 & 42 ST, MANH",cpd11-20mn.pdf
MED-625,WEST 14TH STREET,850,DEPT OF DESIGN & CONSTRUCTION,TRUNK AND DISTRIBUTION MAIN REPLACEMENT,100,MANHATTAN,WM-0001 WM-0944,3900,32146,2198,495,0,0,0,0,34839,32146,2198,495,0,0,0,0,34839,64292,4396,990,0,0,0,0,69678,PROJECT DELAYED DUE TO UNFORESEEN SITE/FIELD CONDITION,,DISTRIBUTION WATER MAIN EXTENSIONS/REPLACEMENTS,cpd11-20mn.pdf
MED-667,Replacement of Water main in Delancey Street (HWM2025),850,DEPT OF DESIGN & CONSTRUCTION,AUGMENTATION OF WATER SUPPLY SYSTEMS,100,MANHATTAN,SE-0002M WM-0001 WM-0006,11122,0,0,10084,0,0,0,0,10084,0,0,10084,0,0,0,0,10084,0,0,20168,0,0,0,0,20168,PROJECT DELAYED DUE TO UNFORESEEN SITE/FIELD CONDITION,,"REPLACEMENT OF WATER MAIN IN DELANCEY STREET BETWEEN BOWERY AND CLINTON STREET,",cpd11-20mn.pdf
MED-668,Installation of Distri WM & appurtenances Vesey street,850,DEPT OF DESIGN & CONSTRUCTION,AUGMENTATION OF WATER SUPPLY SYSTEMS,100,MANHATTAN,WM-0001,917,0,0,797,0,0,0,0,797,0,0,797,0,0,0,0,797,0,0,1594,0,0,0,0,1594,,,INSTALLATION OF DISTRIBUTION WATER MAIN AND APPURTENANCES IN VESEY STREET BETWEEN,cpd11-20mn.pdf
MED-670,"Replacement of distriibution WM in 43rd Street, HWMME43ST",850,DEPT OF DESIGN & CONSTRUCTION,AUGMENTATION OF WATER SUPPLY SYSTEMS,100,MANHATTAN,WM-0001 SE-0002M,2486,50,0,0,2486,0,0,0,2536,50,0,0,2486,0,0,0,2536,100,0,0,4972,0,0,0,5072,,,REPLACEMENT OF DISTRIBUTION WATER MAINS IN E 43RD STREET BETWEEN LEXINGTON AVENUE AND,cpd11-20mn.pdf
MEDA-003,Accelerated Distribution WM replcmnt & sewer rebhab - MAN,850,DEPT OF DESIGN & CONSTRUCTION,TRUNK AND DISTRIBUTION MAIN REPLACEMENT,100,MANHATTAN,WM-0001,17900,21365,14728,0,0,0,0,0,36093,21365,14728,0,0,0,0,0,36093,42730,29456,0,0,0,0,0,72186,PROJECT DELAYED DUE TO UNFORESEEN SITE/FIELD CONDITION,,"ACCELERATED DISTRIBUTION WATER MAIN REPLCMNT & SEWER REBHAB/REPLCMNT,MANHATTAN",cpd11-20mn.pdf
P-303ERPK,East River Park,850,DEPT OF DESIGN & CONSTRUCTION,"LARGE, MAJOR AND REGIONAL PARK RECONSTRUCTION",100,MANHATTAN,RE-0025,9274,1087,37,0,7874,0,0,0,8998,1087,37,0,7874,0,0,0,8998,2174,74,0,15748,0,0,0,17996,PROJECT DELAYED DUE TO UNFORESEEN SITE/FIELD CONDITION,EAST RIVER PARK,EAST RIVER PARK,cpd11-20mn.pdf
P-30420SP,West 20th St. Park Demolition & Abatement,850,DEPT OF DESIGN & CONSTRUCTION,NEIGHBORHOOD PARKS AND PLAYGROUNDS,100,MANHATTAN,ED-0075,1000,2574,0,0,0,0,299,0,2873,2574,0,0,0,0,299,0,2873,5148,0,0,0,0,598,0,5746,PROJECT DELAYED DUE TO UNFORESEEN SITE/FIELD CONDITION,"20TH STREET PARK CONSTRUCTION, MANHATTAN",20TH STREET PARK CONSTRUCTION,cpd11-20mn.pdf
P-3RANDAL,"Randall's Island Infrastructure, Roadways, Drainage, & CS",850,DEPT OF DESIGN & CONSTRUCTION,NEIGHBORHOOD PARKS AND PLAYGROUNDS,111,MANHATTAN,P-0944,16700,2309,0,0,15171,0,0,0,17480,2309,0,0,15171,0,0,0,17480,4618,0,0,30342,0,0,0,34960,PROJECT DELAYED DUE TO UNFORESEEN SITE/FIELD CONDITION,RANDALL'S ISLAND,CONCESSION,cpd11-20mn.pdf
PO79BMAHJ,One Police Plaza,850,DEPT OF DESIGN & CONSTRUCTION,POLICE FACILITIES,100 101,MANHATTAN,PO-0079,5063,2569,89,0,0,0,0,0,2658,2569,89,0,0,0,0,0,2658,5138,178,0,0,0,0,0,5316,PROJECT DELAYED DUE TO BUDGETARY CONSTRAINTS,ONE POLICE PLAZA AND POLICE ACADEMY,FACADE REPAIR FOR ONE POLICE PLAZA AND POLICE ACADEMY AT 235 E 29TH STREET MANHATTAN,cpd11-20mn.pdf
PO79BMAHQ,ONE POLICE PLAZA PAVING AND LANDSCAPING,850,DEPT OF DESIGN & CONSTRUCTION,POLICE FACILITIES,100,MANHATTAN,PO-0079,816,602,1938,0,0,0,0,0,2540,602,1938,0,0,0,0,0,2540,1204,3876,0,0,0,0,0,5080,PROJECT DELAYED DUE TO UNFORESEEN SITE/FIELD CONDITION,ONE POLICE PLAZA,ONE POLICE PLAZA,cpd11-20mn.pdf
PO79BMAJU,"26TH PRECINCT ROOF, WINDOWS & FACADE",850,DEPT OF DESIGN & CONSTRUCTION,POLICE FACILITIES,100,MANHATTAN,PO-0079,2903,1161,138,6277,0,0,0,0,7576,1161,138,6277,0,0,0,0,7576,2322,276,12554,0,0,0,0,15152,PROJECT DELAYED DUE TO BUDGETARY CONSTRAINTS,,"ROOF, WINDOWS, FACADE",cpd11-20mn.pdf
PV034NWCH,AMNH - Northwest Coast Hall Renovation,850,DEPT OF DESIGN & CONSTRUCTION,ESSENTIAL RECONSTRUCTION OF FACILITIES,107,MANHATTAN,PV-0034,3060,0,0,0,0,3000,0,0,3000,0,0,0,0,3000,0,0,3000,0,0,0,0,6000,0,0,6000,PROJECT DELAYED DUE TO CHANGES IN SCOPE/DESIGN,,RENOVATION,cpd11-20mn.pdf
PV234CSV1,CSV - Clemente Soto Velez - Interior Code Compliance,850,DEPT OF DESIGN & CONSTRUCTION,ESSENTIAL RECONSTRUCTION OF FACILITIES,103,MANHATTAN,PV-0234 PV-D234 PV-M467 PV-0467 PW-0077 PW-C077 PV-M234,1500,303,0,10290,0,0,0,0,10593,303,0,10290,0,0,0,0,10593,606,0,20580,0,0,0,0,21186,PROJECT DELAYED DUE TO BUDGETARY CONSTRAINTS,"107 SUFFOLK STREET, NY NY 10002","CSV - CLEMENTE SOTO VELEZ - INTERIOR CODE COMPLIANCE - ADA ACCESS, RESTROOMS, EGRESS,",cpd11-20mn.pdf
PV241EXTR,MCNY - Exterior Facade Rehabilitation,850,DEPT OF DESIGN & CONSTRUCTION,ESSENTIAL RECONSTRUCTION OF FACILITIES,,MANHATTAN,PV-D241 PV-0241 PV-M241 PV-0467,2296,708,90,3857,0,0,0,0,4655,708,90,3857,0,0,0,0,4655,1416,180,7714,0,0,0,0,9310,PROJECT DELAYED DUE TO BUDGETARY CONSTRAINTS,"1220 FIFTH AVENUE, MANHATTAN, NY",FACADE RENOVATION AND REHABILITATION.,cpd11-20mn.pdf
PV467-122,122C - 122 Community Center Bldg Reconstruction,850,DEPT OF DESIGN & CONSTRUCTION,ESSENTIAL RECONSTRUCTION OF FACILITIES,103,MANHATTAN,PV-0467 PV-M788 PV-M467 PV-D467 PV-0788,16812,34247,869,0,0,0,0,0,35116,34247,869,0,0,0,0,0,35116,68494,1738,0,0,0,0,0,70232,PROJECT DELAYED DUE TO UNFORESEEN SITE/FIELD CONDITION,"150 1ST AVENUE, NEW YORK NY",PS 122 - BLDG RECONSTRUCTION,cpd11-20mn.pdf
PW195SA,"80 CENTRE ST. - SAFE ACCESS, REPLACEMENT OF CATWALKS",850,DEPT OF DESIGN & CONSTRUCTION,REHABILITATION OF CITY-OWNED OFFICE SPACE,101,MANHATTAN,PW-0195,186,0,0,0,195,0,0,0,195,0,0,0,195,0,0,0,195,0,0,0,390,0,0,0,390,PROJECT DELAYED DUE TO BUDGETARY CONSTRAINTS,,"80 CENTRE ST. - SAFE ACCESS, REPLACEMENT OF SIDEWALKS",cpd11-20mn.pdf
PW195SW2,80 CENTRE ST. - SIDEWALK REHABILITATION,850,DEPT OF DESIGN & CONSTRUCTION,REHABILITATION OF CITY-OWNED OFFICE SPACE,101,MANHATTAN,PW-0195,2240,855,471,3872,0,0,0,0,5198,855,471,3872,0,0,0,0,5198,1710,942,7744,0,0,0,0,10396,PROJECT DELAYED DUE TO BUDGETARY CONSTRAINTS,,80 CENTRE ST. - SIDEWALK REHABILITATION,cpd11-20mn.pdf
PW29380FC,80 CENTRE ST.- FIRE ALARMS/SPRINKLERS,850,DEPT OF DESIGN & CONSTRUCTION,LEGAL MANDATES AND CORRECTION OF UNSAFE CONDITIONS,101,MANHATTAN,PW-0293,44728,15,2864,3300,855,36435,0,0,43469,15,2864,3300,855,36435,0,0,43469,30,5728,6600,1710,72870,0,0,86938,,,80 CENTRE ST.- FIRE ALARMS/SPRINKLERS,cpd11-20mn.pdf
PW316BWY2,280 BROADWAY - EXTERIOR,850,DEPT OF DESIGN & CONSTRUCTION,LEGAL MANDATES AND CORRECTION OF UNSAFE CONDITIONS,101,MANHATTAN,PW-0077 PW-0316,24398,22502,571,90,0,0,0,0,23163,22502,571,90,0,0,0,0,23163,45004,1142,180,0,0,0,0,46326,,,EXTERIOR WORK AT 280 BROADWAY -,cpd11-20mn.pdf
PW3171C,1 CENTRE STREET- FACADE REHAB,850,DEPT OF DESIGN & CONSTRUCTION,LEGAL MANDATES AND CORRECTION OF UNSAFE CONDITIONS,101,MANHATTAN,PW-0317,8334,9,0,0,0,0,0,24811,24820,9,0,0,0,0,0,24811,24820,18,0,0,0,0,0,49622,49640,PROJECT DELAYED DUE TO BUDGETARY CONSTRAINTS,,1 CENTRE STREET - FACADE REPAIRS,cpd11-20mn.pdf
PW3172L,2 LAFAYETTE STREET - FACADE REPAIRS,850,DEPT OF DESIGN & CONSTRUCTION,LEGAL MANDATES AND CORRECTION OF UNSAFE CONDITIONS,101,MANHATTAN,PW-0317 PW-0080,4850,37,20,746,10,3185,0,0,3998,37,20,746,10,3185,0,0,3998,74,40,1492,20,6370,0,0,7996,,,2 LAFAYETTE STREET - FACADE REPAIRS,cpd11-20mn.pdf
PW317WOR,125 WORTH STREET - FACADE REPAIRS,850,DEPT OF DESIGN & CONSTRUCTION,LEGAL MANDATES AND CORRECTION OF UNSAFE CONDITIONS,101,MANHATTAN,PW-0316 PW-0266,4050,0,0,863,5037,0,0,0,5900,0,0,863,5037,0,0,0,5900,0,0,1726,10074,0,0,0,11800,,,125 WORTH STREET - FACADE REAPIRS,cpd11-20mn.pdf
PW357ELEV,253 BROADWAY- ELEVATOR MODERNIZATION,850,DEPT OF DESIGN & CONSTRUCTION,REHABILITATION OF CITY-OWNED OFFICE SPACE,101,MANHATTAN,PW-0357,2653,6960,5174,0,0,0,0,0,12134,6960,5174,0,0,0,0,0,12134,13920,10348,0,0,0,0,0,24268,PROJECT DELAYED DUE TO BUDGETARY CONSTRAINTS,,253 BROADWAY ELEVATOR MODERNIZATION,cpd11-20mn.pdf
PW357FIRE,253 BROADWAY- FIRE ALARM REPLACEMENT,850,DEPT OF DESIGN & CONSTRUCTION,LEGAL MANDATES AND CORRECTION OF UNSAFE CONDITIONS,101,MANHATTAN,PW-0293,2743,7384,1085,17144,0,0,0,0,25613,7384,1085,17144,0,0,0,0,25613,14768,2170,34288,0,0,0,0,51226,PROJECT DELAYED DUE TO BUDGETARY CONSTRAINTS,,253 BROADWAY FIRE ALARM REPLACEMENT,cpd11-20mn.pdf
PW77102S3,CITY HALL STEPS RECONSTRUCTION,850,DEPT OF DESIGN & CONSTRUCTION,REHABILITATION OF CITY-OWNED OFFICE SPACE,101,MANHATTAN,PW-0077,3284,449,276,4305,0,0,0,0,5030,449,276,4305,0,0,0,0,5030,898,552,8610,0,0,0,0,10060,,,STEPS,cpd11-20mn.pdf
PW7722R,22 READE STREET EXTERIOR,850,DEPT OF DESIGN & CONSTRUCTION,LEGAL MANDATES AND CORRECTION OF UNSAFE CONDITIONS,101,MANHATTAN,PW-0077,21175,274,0,3196,0,25380,0,0,28850,274,0,3196,0,25380,0,0,28850,548,0,6392,0,50760,0,0,57700,,,THE EXTERIOR RECONSTRUCTION OF THE CITY PLANNING BUILDING,cpd11-20mn.pdf
PW77CHROT,City Hall Rotunda,850,DEPT OF DESIGN & CONSTRUCTION,REHABILITATION OF CITY-OWNED OFFICE SPACE,100 101,MANHATTAN,PW-0077,27114,24589,0,322,0,0,0,0,24911,24589,0,322,0,0,0,0,24911,49178,0,644,0,0,0,0,49822,PROJECT DELAYED DUE TO BUDGETARY CONSTRAINTS,,CENTRE STREET,cpd11-20mn.pdf
PW77GLDA2,100 GOLD ST.- MIS HVAC UPGRADES,850,DEPT OF DESIGN & CONSTRUCTION,REHABILITATION OF CITY-OWNED OFFICE SPACE,101,MANHATTAN,PW-0077,2535,3913,300,302,0,0,0,0,4515,3913,300,302,0,0,0,0,4515,7826,600,604,0,0,0,0,9030,PROJECT DELAYED DUE TO BUDGETARY CONSTRAINTS,,100 GOLD ST.- MIS HVAC UPGRADES,cpd11-20mn.pdf
PW77GLDWN,100 GOLD ST.- WINDOW REPLACEMENT AND EXTERIOR REHABILITATION,850,DEPT OF DESIGN & CONSTRUCTION,REHABILITATION OF CITY-OWNED OFFICE SPACE,101,MANHATTAN,PW-0077,1655,0,0,0,0,0,3828,0,3828,0,0,0,0,0,3828,0,3828,0,0,0,0,0,7656,0,7656,PROJECT DELAYED DUE TO BUDGETARY CONSTRAINTS,,100 GOLD STREET WINDOW REPLACEMENT AND EXTERIOR REHAB,cpd11-20mn.pdf
PW77LYA,"253 BROADWAY- LPC MOVE TO 2nd, 11th, 12th, 13th FLS",850,DEPT OF DESIGN & CONSTRUCTION,REHABILITATION OF CITY-OWNED OFFICE SPACE,101,MANHATTAN,PW-0077,23714,41349,3236,6436,0,0,4593,4592,60206,41349,3236,6436,0,0,4593,4592,60206,82698,6472,12872,0,0,9186,9184,120412,PROJECT DELAYED DUE TO BUDGETARY CONSTRAINTS,,"253 BROADWAY- LPC MOVE FROM 1 CENTRE ST, 9TH FLOOR",cpd11-20mn.pdf
PW80DYCD2,2 LAFAYETTE STREET- DYCD RELOCATION,850,DEPT OF DESIGN & CONSTRUCTION,REHABILITATION OF CITY-OWNED OFFICE SPACE,101,MANHATTAN,PW-0077 PW-0293,34658,63686,6913,0,0,0,0,0,70599,63686,6913,0,0,0,0,0,70599,127372,13826,0,0,0,0,0,141198,PROJECT DELAYED DUE TO UNFORESEEN SITE/FIELD CONDITION,,DYCD RELOCATION TO 2 LAFAYETTE STREET.,cpd11-20mn.pdf
PWD005FS,FORTUNE SOCIETY,850,DEPT OF DESIGN & CONSTRUCTION,MISCELLANEOUS CONSTRUCTION,105,MANHATTAN,PW-D005,500,0,500,0,0,0,0,0,500,0,500,0,0,0,0,0,500,0,1000,0,0,0,0,0,1000,PROJECT DELAYED PENDING RESOLUTION OF LEGAL ISSUES,,STRUCTURAL ISSUES SUCH AS WATER INFLUTRATION,cpd11-20mn.pdf
PWD005NEW,NONTRADITIONAL EMPLOYMENT FOR WOMEN,850,DEPT OF DESIGN & CONSTRUCTION,RENOVATION OF OTHER CITY-OWNED FACILITIES,104,MANHATTAN,PW-D005 ED-D075 PW-M077,870,1862,144,0,1500,614,0,1,4121,1862,144,0,1500,614,0,1,4121,3724,288,0,3000,1228,0,2,8242,PROJECT DELAYED PENDING NON-CITY GRANT APPROVAL,,NO SCOPE FROM COUNCIL STAFF,cpd11-20mn.pdf
S195-227S,Spring St Salt Enclosure,850,DEPT OF DESIGN & CONSTRUCTION,GARAGES AND FACILITIES,101,MANHATTAN,S-0195,10375,21949,176,0,0,0,0,0,22125,21949,176,0,0,0,0,0,22125,43898,352,0,0,0,0,0,44250,PROJECT DELAYED DUE TO CHANGES IN SCOPE/DESIGN,,CONSTRUCTION OF A SALT ENCLOSURE,cpd11-20mn.pdf
S216-401A,EAST 91st ST MARINE TRANSFER STATION,850,DEPT OF DESIGN & CONSTRUCTION,SOLID WASTE MANAGEMENT,100 108,MANHATTAN,S-0216,131355,244770,4164,0,0,0,0,0,248934,244770,4164,0,0,0,0,0,248934,489540,8328,0,0,0,0,0,497868,PROJECT DELAYED DUE TO BUDGETARY CONSTRAINTS,E 91ST ST MTS,E 91ST ST MTS,cpd11-20mn.pdf
S216-401R,"CONSTRUCTION, E. 92 ST RAMP TO E. 91 ST MTS",850,DEPT OF DESIGN & CONSTRUCTION,SOLID WASTE MANAGEMENT,100,MANHATTAN,S-0216,19926,5739,212,0,19473,0,0,0,25424,5739,212,0,19473,0,0,0,25424,11478,424,0,38946,0,0,0,50848,PROJECT DELAYED DUE TO UNFORESEEN SITE/FIELD CONDITION,,CONSTRUCTION OF A RAMP FROM EAST 92ND STREET TO THE EAST 91ST STREET MARINE TRANSFER,cpd11-20mn.pdf
S216-404A,GANSEVOORT MARINE TRANSFER STATION,850,DEPT OF DESIGN & CONSTRUCTION,SOLID WASTE MANAGEMENT,100 102,MANHATTAN,S-0216,89458,36473,0,0,0,0,0,52872,89345,36473,0,0,0,0,0,52872,89345,72946,0,0,0,0,0,105744,178690,PROJECT DELAYED DUE TO UNFORESEEN SITE/FIELD CONDITION,GANSEVOORT MTS SITE,GANSEVOORT MTS,cpd11-20mn.pdf
S216-415A,WEST 59th STREET MTS,850,DEPT OF DESIGN & CONSTRUCTION,SOLID WASTE MANAGEMENT,100 104 107,MANHATTAN,S-0216,60937,97111,4769,0,0,0,0,0,101880,97111,4769,0,0,0,0,0,101880,194222,9538,0,0,0,0,0,203760,PROJECT DELAYED DUE TO UNFORESEEN SITE/FIELD CONDITION,WEST 59TH ST MTS SITE,WEST 59TH ST MTS,cpd11-20mn.pdf
S219-233A,CONSTRUCTION MANHATTAN 1/2/5 GARAGE,850,DEPT OF DESIGN & CONSTRUCTION,GARAGES AND FACILITIES,101 102 105,MANHATTAN,S-0219,147907,213583,0,0,0,0,0,1076,214659,213583,0,0,0,0,0,1076,214659,427166,0,0,0,0,0,2152,429318,PROJECT DELAYED DUE TO CHANGES IN SCOPE/DESIGN,BLOCK 596 LOT 50 MANHATTAN,"CONSTRUCTION OF A NEW SANITATION GARAGE TO SERVICE MANHATTAN COMMUNITY DISTRICTS 1, 2,",cpd11-20mn.pdf
SANDBHFW,Sandy,850,DEPT OF DESIGN & CONSTRUCTION,NEW FACILITIES,,MANHATTAN,HO-0214,90000,0,750,0,0,7750,0,0,8500,0,750,0,0,7750,0,0,8500,0,1500,0,0,15500,0,0,17000,,SERVICE ROAD PARALLEL TO FDR BETWEEN 25TH AND 30TH STREETS,BELLEVUE FLOOD WALL TO BUILT ALONG THE SERVICE ROAD PARALLEL TO THE FDR FROM 25TH TO,cpd11-20mn.pdf
SANDHW06,Reconstruction of Vestry Street- Hurricane Sandy,850,DEPT OF DESIGN & CONSTRUCTION,PRIMARY STREET RECONSTRUCTION,100,MANHATTAN,HW-0001M WM-0001 SE-0002M HW-0200 TF-0002 TF-0502,2232,2689,1446,0,80,0,0,0,4215,2689,1446,0,80,0,0,0,4215,5378,2892,0,160,0,0,0,8430,PROJECT DELAYED DUE TO UNFORESEEN SITE/FIELD CONDITION,RECONSTRUCTION OF VESTRY STREET- HURRICANE SANDY,RECONSTRUCTION OF VESTRY STREET- HURRICANE SANDY,cpd11-20mn.pdf
SANDHW08,Reconstruction of Front Street-Hurricane Sandy,850,DEPT OF DESIGN & CONSTRUCTION,PRIMARY STREET RECONSTRUCTION,100,MANHATTAN,HW-0944 HW-0001M,4888,4050,726,0,0,0,0,0,4776,4050,726,0,0,0,0,0,4776,8100,1452,0,0,0,0,0,9552,PROJECT DELAYED DUE TO UNFORESEEN SITE/FIELD CONDITION,RECONSTRUCTION OF FRONT STREET-HURRICANE SANDY,RECONSTRUCTION OF FRONT STREET-HURRICANE SANDY,cpd11-20mn.pdf
SANDSLIP,100 OLD SLIP RESTORATION & SYSTEMS REPLACEMENT,850,DEPT OF DESIGN & CONSTRUCTION,POLICE FACILITIES,100,MANHATTAN,PO-0079,19124,681,0,0,0,0,0,0,681,681,0,0,0,0,0,0,681,1362,0,0,0,0,0,0,1362,,,100 OLD SLIP RESTORATION,cpd11-20mn.pdf
SEN002152,COMBINE SEWERS IN WORTH ST,850,DEPT OF DESIGN & CONSTRUCTION,PROGRAMMATIC REPLACEMENT AND RECONSTRUCTION,101 102,MANHATTAN,WM-0006,8443,30666,750,0,0,0,0,0,31416,30666,750,0,0,0,0,0,31416,61332,1500,0,0,0,0,0,62832,PROJECT DELAYED DUE TO UNFORESEEN SITE/FIELD CONDITION,,"REPLACEMENT OF COMBINE SEWER IN WOTH STREET BETWEEN CENTRE ST AND MULBERRY ST, ETC.",cpd11-20mn.pdf
SEN002153,Water Main in Water St. (w/HWMWTCA7D),850,DEPT OF DESIGN & CONSTRUCTION,REPLACEMENT OF CHRONICALLY FAILING COMPONENTS,101,MANHATTAN,WM-0001,565,1367,627,0,0,0,0,0,1994,1367,627,0,0,0,0,0,1994,2734,1254,0,0,0,0,0,3988,PROJECT DELAYED DUE TO CHANGES IN SCOPE/DESIGN,,WATER MAIN AND SEWER WORK IN WATER ST. BETW BEEKMAN ST. AND DOVER ST.,cpd11-20mn.pdf
SEN002157,"Replacement of Combined Sewer in E. 26th Street, Manhattan",850,DEPT OF DESIGN & CONSTRUCTION,REPLACEMENT OF CHRONICALLY FAILING COMPONENTS,106 112,MANHATTAN,SE-0002M WM-0001 EP-0007,2816,19417,1263,0,0,0,0,0,20680,19417,1263,0,0,0,0,0,20680,38834,2526,0,0,0,0,0,41360,PROJECT DELAYED DUE TO CHANGES IN SCOPE/DESIGN,,REPLMT OF COMB SEWER IN E. 26 ST B/T 1ST AV & FDR,cpd11-20mn.pdf
SEN002161,Water main & Sewer work in Broadway b/t Leonard & Cortlandt,850,DEPT OF DESIGN & CONSTRUCTION,REPLACEMENT OF CHRONICALLY FAILING COMPONENTS,101,MANHATTAN,SE-0002M,489,0,489,0,0,0,0,0,489,0,489,0,0,0,0,0,489,0,978,0,0,0,0,0,978,PROJECT DELAYED DUE TO UNFORESEEN SITE/FIELD CONDITION,,WATER MAIN & SEWER WORK IN BROADWAY B/T LEONARD & CORTLANDT STREET,cpd11-20mn.pdf
SEN002169,RECON OF COMBINED SEWER & WM IN YORK AVE,850,DEPT OF DESIGN & CONSTRUCTION,REPLACEMENT OR AUGMENTATION OF EXISTING SYSTEMS,108,MANHATTAN,SE-0002M WM-0001 HW-0200,1220,16718,2760,0,0,0,0,0,19478,16718,2760,0,0,0,0,0,19478,33436,5520,0,0,0,0,0,38956,PROJECT DELAYED DUE TO BUDGETARY CONSTRAINTS,,RECON OF COMB SWR & WM IN YORK AV B/T 61 & 63 STREET,cpd11-20mn.pdf
SEN002178,Replacement & guniting comb SE in W. Broadway,850,DEPT OF DESIGN & CONSTRUCTION,REPLACEMENT OR AUGMENTATION OF EXISTING SYSTEMS,101,MANHATTAN,SE-0002M TF-0502 EP-0007 SE-0944,1069,550,3268,0,0,0,0,0,3818,550,3268,0,0,0,0,0,3818,1100,6536,0,0,0,0,0,7636,,,COMBINED SEWER REPLACEMENT AND GUNITING IN WEST BROADWAY BETWEEN THOMAS & LEONARD,cpd11-20mn.pdf
TAVREH,Tavern on the Green Structure,850,DEPT OF DESIGN & CONSTRUCTION,MAJOR RECREATIONAL FACILITIES AND FACILITY RECONSTRUCTION,,MANHATTAN,P-1018,10894,20272,0,0,0,150,0,0,20422,20272,0,0,0,150,0,0,20422,40544,0,0,0,300,0,0,40844,PROJECT DELAYED DUE TO UNFORESEEN SITE/FIELD CONDITION,,RENOVATION OF TAVERN ON THE GREEN STRUCTUE - LANDMARK BUILDING,cpd11-20mn.pdf
TF18-2007,"DELANCEY AND ESSEX MUNICIPAL PARKING GARAGE,MANHATTAN",850,DEPT OF DESIGN & CONSTRUCTION,"Parking Meters, Lots, and Garages",100 103,MANHATTAN,TF-0018,2280,8769,219,0,0,0,0,0,8988,8769,219,0,0,0,0,0,8988,17538,438,0,0,0,0,0,17976,PROJECT DELAYED DUE TO CHANGES IN SCOPE/DESIGN,DELANCEY AND ESSEX MUNICIPAL PARKING GARAGE,DELANCEY AND ESSEX MUNICIPAL PARKING GARAGE,cpd11-20mn.pdf
70MULB1,70 MULBERRY - DEMOLITION,856,DEPT OF CITYWIDE ADMIN SERVS,REHABILITATION OF NON-WATERFRONT PROPERTIES,101,MANHATTAN,RE-0025,6470,5609,561,0,0,0,0,0,6170,5609,561,0,0,0,0,0,6170,11218,1122,0,0,0,0,0,12340,,,DEMOLITION,cpd11-20mn.pdf
70MULBREC,70 MULBERRY STREET - RECONSTRUCTION,856,DEPT OF CITYWIDE ADMIN SERVS,RENOVATION OF OTHER CITY-OWNED FACILITIES,101,MANHATTAN,PW-0077,80000,0,0,8000,0,72000,0,0,80000,0,0,8000,0,72000,0,0,80000,0,0,16000,0,144000,0,0,160000,,,"RECONSTRUCTION OF 70 MULBERRY STREET, WHICH WAS DEMOLISHED AFTER A FIRE.",cpd11-20mn.pdf
ACEDOE701,DOE - STEAM SYSTEM OPTIMIZATION,856,DEPT OF CITYWIDE ADMIN SERVS,"BUILDING CONSTRUCTION, RECONSTRUCTION OR RETROFIT",101,MANHATTAN,PU-0025,5661,0,0,5661,0,0,0,0,5661,0,0,5661,0,0,0,0,5661,0,0,11322,0,0,0,0,11322,,,DOE - STEAM SYSTEM OPTIMIZATION,cpd11-20mn.pdf
AG1RAND,DFTA -108- ST RANDOLPH SC,856,DEPT OF CITYWIDE ADMIN SERVS,DEPARTMENT FOR THE AGING BUILDING RECONSTRUCTION,109,MANHATTAN,AG-0001,2530,0,0,2530,0,0,0,0,2530,0,0,2530,0,0,0,0,2530,0,0,5060,0,0,0,0,5060,,,DYFTA -108- ST RANDOLPH SC,cpd11-20mn.pdf
AGHVACRM,2 Lafayette 9th floor DFTA IT room HVAC upgrade,856,DEPT OF CITYWIDE ADMIN SERVS,DEPARTMENT FOR THE AGING BUILDING RECONSTRUCTION,101,MANHATTAN,AG-0001,607,594,0,0,0,75,0,0,669,594,0,0,0,75,0,0,669,1188,0,0,0,150,0,0,1338,PROJECT DELAYED DUE TO BUDGETARY CONSTRAINTS,,2 LAFAYETTE 9TH FLOOR DFTA IT ROOM HVAC UPGRADE,cpd11-20mn.pdf
CENTCELL,"100 CENTRE ST- FLRS 1-3,5 & 12 FOR DOC",856,DEPT OF CITYWIDE ADMIN SERVS,BUILDING SYSTEMS AND INFRASTRUCTURE,101,MANHATTAN,C-0075,2687,3604,0,132,0,0,0,0,3736,3604,0,132,0,0,0,0,3736,7208,0,264,0,0,0,0,7472,PROJECT DELAYED DUE TO CHANGES IN SCOPE/DESIGN,"100 CENTRE ST. NY, NY 10013","DCAS WILL OVERSEE THE RENOVATION OF SPACE ON THE 1ST, 2ND, 3RD, 5TH &12TH FLOORS THAT IS",cpd11-20mn.pdf
CO283CTSP,100 CENTRE ST- COOLING TOWERS TO REPLACE SPRAY PONDS,856,DEPT OF CITYWIDE ADMIN SERVS,RECONSTRUCTION/RENOVATION OF COURT FACILITIES,101,MANHATTAN,CO-0283,9716,12857,0,726,0,0,0,0,13583,12857,0,726,0,0,0,0,13583,25714,0,1452,0,0,0,0,27166,PROJECT DELAYED DUE TO CHANGES IN SCOPE/DESIGN,,100 CENTRE - TOWERING SYSTEM TO REPLACE SPRAY PONDS,cpd11-20mn.pdf
CO283FIRE,100 CENTRE ST.- FIRE SAFETY,856,DEPT OF CITYWIDE ADMIN SERVS,RECONSTRUCTION/RENOVATION OF COURT FACILITIES,101,MANHATTAN,CO-0283,7730,8818,283,1500,0,0,0,0,10601,8818,283,1500,0,0,0,0,10601,17636,566,3000,0,0,0,0,21202,PROJECT DELAYED DUE TO BUDGETARY CONSTRAINTS,100 CENTRE ST MANHATTAN,MAKE FIRE SAFETY SYSTEM CODE COMPLIANT,cpd11-20mn.pdf
CO283LL11,100 CENTRE ST - FACADE RECONSTRUCTION,856,DEPT OF CITYWIDE ADMIN SERVS,RECONSTRUCTION/RENOVATION OF COURT FACILITIES,101,MANHATTAN,CO-0283,5578,0,0,0,0,0,5578,0,5578,0,0,0,0,0,5578,0,5578,0,0,0,0,0,11156,0,11156,,,100 CENTRE ST.- FAÝADE REPAIRS LL 11,cpd11-20mn.pdf
CO283SG,100 CENTRE ST. - SAFETY GRATINGS,856,DEPT OF CITYWIDE ADMIN SERVS,RECONSTRUCTION/RENOVATION OF COURT FACILITIES,101,MANHATTAN,CO-0283,190,0,0,0,0,40,0,150,190,0,0,0,0,40,0,150,190,0,0,0,0,80,0,300,380,PROJECT DELAYED DUE TO BUDGETARY CONSTRAINTS,,100 CENTRE STREET SAFETY GRATINGS,cpd11-20mn.pdf
CO304HEA2,60 CENTRE STREET- SPRINKLERS,856,DEPT OF CITYWIDE ADMIN SERVS,RECONSTRUCTION/RENOVATION OF COURT FACILITIES,101,MANHATTAN,CO-0304,20210,0,0,1700,0,16365,0,0,18065,0,0,1700,0,16365,0,0,18065,0,0,3400,0,32730,0,0,36130,PROJECT DELAYED DUE TO CHANGES IN SCOPE/DESIGN,,60 CENTRE STREET - HEATING UPGRADE - SPRINKLERS,cpd11-20mn.pdf
CO304HEA5,60 CENTRE ST.- HEATING DISTRIBUTION SYSTEM,856,DEPT OF CITYWIDE ADMIN SERVS,RECONSTRUCTION/RENOVATION OF COURT FACILITIES,101,MANHATTAN,CO-0304,31293,0,0,0,0,1900,0,26462,28362,0,0,0,0,1900,0,26462,28362,0,0,0,0,3800,0,52924,56724,PROJECT DELAYED DUE TO BUDGETARY CONSTRAINTS,,60 CENTRE ST.- HEATING DISTRIBUTION SYSTEM,cpd11-20mn.pdf
CO305REHB,314 W. 54TH ST.- MIDTOWN COMM COURT EXPANSION,856,DEPT OF CITYWIDE ADMIN SERVS,RECONSTRUCTION/RENOVATION OF COURT FACILITIES,104,MANHATTAN,CO-0264 CO-0305,17830,31998,245,524,0,0,0,0,32767,31998,245,524,0,0,0,0,32767,63996,490,1048,0,0,0,0,65534,PROJECT DELAYED DUE TO CHANGES IN SCOPE/DESIGN,"314 W. 54TH ST. NY, NY 10019",ROOF REPLACEMENT; INSTALLATION OF FIRE SAFETY SYSTEM; ELECTRICAL & HVAC UPGRADE; FACADE,cpd11-20mn.pdf
CO306CEIL,170 E 121 ST - HARLEM CT CEILING,856,DEPT OF CITYWIDE ADMIN SERVS,RECONSTRUCTION/RENOVATION OF COURT FACILITIES,101,MANHATTAN,CO-0306,1630,130,1352,0,0,0,0,0,1482,130,1352,0,0,0,0,0,1482,260,2704,0,0,0,0,0,2964,,,SQ/IA,cpd11-20mn.pdf
CO306MHCB,170 E. 121 ST. - HARLEM COURT BOILER,856,DEPT OF CITYWIDE ADMIN SERVS,RECONSTRUCTION/RENOVATION OF COURT FACILITIES,111,MANHATTAN,CO-0306,770,0,0,0,0,885,0,0,885,0,0,0,0,885,0,0,885,0,0,0,0,1770,0,0,1770,PROJECT DELAYED DUE TO BUDGETARY CONSTRAINTS,,BOILER REPLACEMENT,cpd11-20mn.pdf
CO81ADA1,31 CHAMBERS ST - ADA LIFT,856,DEPT OF CITYWIDE ADMIN SERVS,RECONSTRUCTION/RENOVATION OF COURT FACILITIES,101,MANHATTAN,CO-0081,347,0,347,0,0,0,0,0,347,0,347,0,0,0,0,0,347,0,694,0,0,0,0,0,694,PROJECT DELAYED DUE TO CHANGES IN SCOPE/DESIGN,,IA/SQ,cpd11-20mn.pdf
E19-0009,NYPD - 20th Precinct,856,DEPT OF CITYWIDE ADMIN SERVS,"BUILDING CONSTRUCTION, RECONSTRUCTION OR RETROFIT",101,MANHATTAN,PU-0025 PO-0079,1378,0,1731,0,0,0,0,0,1731,0,1731,0,0,0,0,0,1731,0,3462,0,0,0,0,0,3462,,,NYPD - 20TH PRECINCT,cpd11-20mn.pdf
EO26-0019,DCLA - Lincoln Center Campus,856,DEPT OF CITYWIDE ADMIN SERVS,"BUILDING CONSTRUCTION, RECONSTRUCTION OR RETROFIT",101,MANHATTAN,PU-0025,900,2324,0,175,0,0,0,0,2499,2324,0,175,0,0,0,0,2499,4648,0,350,0,0,0,0,4998,,,DCLA - LINCOLN CENTER CAMPUS,cpd11-20mn.pdf
EO26-0026,NYPL - The Library for the Performing Arts,856,DEPT OF CITYWIDE ADMIN SERVS,"BUILDING CONSTRUCTION, RECONSTRUCTION OR RETROFIT",101,MANHATTAN,PU-0025,900,0,0,1000,0,0,0,0,1000,0,0,1000,0,0,0,0,1000,0,0,2000,0,0,0,0,2000,,,NYPL - THE LIBRARY FOR THE PERFORMING ARTS,cpd11-20mn.pdf
EO26-0034,DPR-Central Park Campus,856,DEPT OF CITYWIDE ADMIN SERVS,"BUILDING CONSTRUCTION, RECONSTRUCTION OR RETROFIT",101,MANHATTAN,PU-0025,250,0,0,250,0,0,0,0,250,0,0,250,0,0,0,0,250,0,0,500,0,0,0,0,500,,,DPR-CENTRAL PARK CAMPUS,cpd11-20mn.pdf
EO26-0041,Manhattan Borough Repair Shop,856,DEPT OF CITYWIDE ADMIN SERVS,"BUILDING CONSTRUCTION, RECONSTRUCTION OR RETROFIT",101,MANHATTAN,PU-0025,700,0,1199,0,0,0,0,0,1199,0,1199,0,0,0,0,0,1199,0,2398,0,0,0,0,0,2398,,,MANHATTAN BOROUGH REPAIR SHOP,cpd11-20mn.pdf
EO26-0046,CUNY - BMCC Campus,856,DEPT OF CITYWIDE ADMIN SERVS,"BUILDING CONSTRUCTION, RECONSTRUCTION OR RETROFIT",101,MANHATTAN,PU-0025,900,0,0,3473,0,0,0,0,3473,0,0,3473,0,0,0,0,3473,0,0,6946,0,0,0,0,6946,,,CUNY - BMCC CAMPUS,cpd11-20mn.pdf
EO26-0054,CIG - David H. Koch Theater,856,DEPT OF CITYWIDE ADMIN SERVS,"BUILDING CONSTRUCTION, RECONSTRUCTION OR RETROFIT",101,MANHATTAN,PU-0025,1000,0,0,6500,0,0,0,0,6500,0,0,6500,0,0,0,0,6500,0,0,13000,0,0,0,0,13000,,,DAVID H. KOCH THEATER,cpd11-20mn.pdf
EO26-0055,DCAS - Midtown Community Court,856,DEPT OF CITYWIDE ADMIN SERVS,"BUILDING CONSTRUCTION, RECONSTRUCTION OR RETROFIT",101,MANHATTAN,PU-0025,300,0,0,248,0,0,0,0,248,0,0,248,0,0,0,0,248,0,0,496,0,0,0,0,496,PROJECT DELAYED DUE TO CHANGES IN SCOPE/DESIGN,,MIDTOWN COMMUNITY COURT,cpd11-20mn.pdf
EO26-0056,NYPD - 18th Precinct (Midtown North),856,DEPT OF CITYWIDE ADMIN SERVS,"BUILDING CONSTRUCTION, RECONSTRUCTION OR RETROFIT",101,MANHATTAN,PU-0025,300,0,0,151,0,0,0,0,151,0,0,151,0,0,0,0,151,0,0,302,0,0,0,0,302,PROJECT DELAYED DUE TO CHANGES IN SCOPE/DESIGN,,18TH PRECINCT (MIDTOWN NORTH),cpd11-20mn.pdf
EO26-0065,NYPD - 10th Precinct,856,DEPT OF CITYWIDE ADMIN SERVS,"BUILDING CONSTRUCTION, RECONSTRUCTION OR RETROFIT",101,MANHATTAN,PU-0025,300,0,0,92,0,0,0,0,92,0,0,92,0,0,0,0,92,0,0,184,0,0,0,0,184,PROJECT DELAYED DUE TO CHANGES IN SCOPE/DESIGN,,10TH PRECINCT,cpd11-20mn.pdf
EO26-0066,"NYPD -Engine Co. 39, Ladder Co. 16 and 19th Precinct Campus",856,DEPT OF CITYWIDE ADMIN SERVS,"BUILDING CONSTRUCTION, RECONSTRUCTION OR RETROFIT",101,MANHATTAN,PU-0025,300,0,0,244,0,0,0,0,244,0,0,244,0,0,0,0,244,0,0,488,0,0,0,0,488,PROJECT DELAYED DUE TO CHANGES IN SCOPE/DESIGN,,19TH PRECINCT,cpd11-20mn.pdf
EO26-0067,NYPD - 30th Precinct,856,DEPT OF CITYWIDE ADMIN SERVS,"BUILDING CONSTRUCTION, RECONSTRUCTION OR RETROFIT",101,MANHATTAN,PU-0025,300,0,0,176,0,0,0,0,176,0,0,176,0,0,0,0,176,0,0,352,0,0,0,0,352,PROJECT DELAYED DUE TO CHANGES IN SCOPE/DESIGN,,30TH PRECINCT,cpd11-20mn.pdf
EO26-0068,NYPD - 32nd Precinct,856,DEPT OF CITYWIDE ADMIN SERVS,"BUILDING CONSTRUCTION, RECONSTRUCTION OR RETROFIT",101,MANHATTAN,PU-0025,300,0,0,169,0,0,0,0,169,0,0,169,0,0,0,0,169,0,0,338,0,0,0,0,338,PROJECT DELAYED DUE TO CHANGES IN SCOPE/DESIGN,,32ND PRECINCT,cpd11-20mn.pdf
EO26-0078,DHS - MANHATTAN BOWERY SHELTER,856,DEPT OF CITYWIDE ADMIN SERVS,"BUILDING CONSTRUCTION, RECONSTRUCTION OR RETROFIT",101,MANHATTAN,PU-0025,500,0,0,300,0,0,0,0,300,0,0,300,0,0,0,0,300,0,0,600,0,0,0,0,600,PROJECT DELAYED DUE TO CHANGES IN SCOPE/DESIGN,,IA/SQ,cpd11-20mn.pdf
EO26-0081,DHS - FORT WASHINGTON ARMORY - SHELTER (PROJECT RENEWAL),856,DEPT OF CITYWIDE ADMIN SERVS,"BUILDING CONSTRUCTION, RECONSTRUCTION OR RETROFIT",101,MANHATTAN,PU-0025,500,0,1200,0,0,0,0,0,1200,0,1200,0,0,0,0,0,1200,0,2400,0,0,0,0,0,2400,PROJECT DELAYED DUE TO BUDGETARY CONSTRAINTS,,IA/SQ,cpd11-20mn.pdf
EO26-0092,CIG - METROPOLITAN MUSEUM OF ART - GALLERIES,856,DEPT OF CITYWIDE ADMIN SERVS,"BUILDING CONSTRUCTION, RECONSTRUCTION OR RETROFIT",101,MANHATTAN,PU-0025,2500,0,16575,0,0,0,0,0,16575,0,16575,0,0,0,0,0,16575,0,33150,0,0,0,0,0,33150,,,IA/SQ,cpd11-20mn.pdf
EO26-0093,CIG - METROPOLITAN MUSEUM OF ART - OFFICE SPACES,856,DEPT OF CITYWIDE ADMIN SERVS,"BUILDING CONSTRUCTION, RECONSTRUCTION OR RETROFIT",101,MANHATTAN,PU-0025,2500,0,0,2500,0,0,0,0,2500,0,0,2500,0,0,0,0,2500,0,0,5000,0,0,0,0,5000,,,IA/SQ,cpd11-20mn.pdf
EO26-0094,NYPD - 13TH PRECINCT (OLD ACADEMY),856,DEPT OF CITYWIDE ADMIN SERVS,"BUILDING CONSTRUCTION, RECONSTRUCTION OR RETROFIT",101,MANHATTAN,PU-0025,950,0,0,950,0,0,0,0,950,0,0,950,0,0,0,0,950,0,0,1900,0,0,0,0,1900,,,IA/SQ,cpd11-20mn.pdf
EO26-0095,DOH - PUBLIC HEALTH LAB - DEEP ENERGY RETROFIT,856,DEPT OF CITYWIDE ADMIN SERVS,"BUILDING CONSTRUCTION, RECONSTRUCTION OR RETROFIT",101,MANHATTAN,PU-0025,27400,0,0,26000,0,0,0,0,26000,0,0,26000,0,0,0,0,26000,0,0,52000,0,0,0,0,52000,PROJECT DELAYED DUE TO BUDGETARY CONSTRAINTS,,IA/SQ,cpd11-20mn.pdf
HR258AVEC,400 8th Ave Construction,856,DEPT OF CITYWIDE ADMIN SERVS,SOCIAL SERVICES BUILDINGS,,MANHATTAN,HR-0025,8500,0,0,2241,3362,0,0,0,5603,0,0,2241,3362,0,0,0,5603,0,0,4482,6724,0,0,0,11206,PROJECT DELAYED DUE TO CHANGES IN SCOPE/DESIGN,,,cpd11-20mn.pdf
PO79-375P,NYPD - 375 Pearl Street Renovation,856,DEPT OF CITYWIDE ADMIN SERVS,POLICE FACILITIES,100,MANHATTAN,PO-0079,11356,11352,3931,0,0,0,0,0,15283,11352,3931,0,0,0,0,0,15283,22704,7862,0,0,0,0,0,30566,,,COST ESTIMATE,cpd11-20mn.pdf
PW19325A,1 CENTRE ST.- 25TH FL BUILDOUT PH1 - SOUTH,856,DEPT OF CITYWIDE ADMIN SERVS,REHABILITATION OF CITY-OWNED OFFICE SPACE,101,MANHATTAN,PW-0193,5845,1160,0,3575,396,0,0,0,5131,1160,0,3575,396,0,0,0,5131,2320,0,7150,792,0,0,0,10262,,,DQ FT,cpd11-20mn.pdf
PW19325B,1 CENTRE ST.- 25TH FL BUILDOUT PH 2 - NORTH,856,DEPT OF CITYWIDE ADMIN SERVS,REHABILITATION OF CITY-OWNED OFFICE SPACE,101,MANHATTAN,PW-0193,9535,0,0,7306,769,0,0,0,8075,0,0,7306,769,0,0,0,8075,0,0,14612,1538,0,0,0,16150,,,SQ FT,cpd11-20mn.pdf
PW193ALM,1 CENTRE ST. - FIRE ALARM,856,DEPT OF CITYWIDE ADMIN SERVS,REHABILITATION OF CITY-OWNED OFFICE SPACE,101,MANHATTAN,PW-0193,4410,8010,0,200,0,0,0,0,8210,8010,0,200,0,0,0,0,8210,16020,0,400,0,0,0,0,16420,PROJECT DELAYED DUE TO CHANGES IN SCOPE/DESIGN,,RECONSTRUCT FIRE ALARM SYSTEM,cpd11-20mn.pdf
PW193EV13,1 CENTRE ST - 13TH FL ELEVATOR REPAIR GROUP RELOCATION,856,DEPT OF CITYWIDE ADMIN SERVS,REHABILITATION OF CITY-OWNED OFFICE SPACE,101,MANHATTAN,PW-0193,2475,0,2475,0,0,0,0,0,2475,0,2475,0,0,0,0,0,2475,0,4950,0,0,0,0,0,4950,PROJECT DELAYED DUE TO CHANGES IN SCOPE/DESIGN,,IA/SQ,cpd11-20mn.pdf
PW193FANS,1 CENTRE ST. - REPLACEMENT OF LOBBY FANS,856,DEPT OF CITYWIDE ADMIN SERVS,REHABILITATION OF CITY-OWNED OFFICE SPACE,101,MANHATTAN,PW-0077,1575,155,0,0,0,0,1291,0,1446,155,0,0,0,0,1291,0,1446,310,0,0,0,0,2582,0,2892,PROJECT DELAYED DUE TO BUDGETARY CONSTRAINTS,,"DEMOLITION OF FANS AND ASSOCIATED EQUIPMENT AND ACCESSORIES; FIELD ERECTION OF FANS,",cpd11-20mn.pdf
PW193LB,1 CENTRE ST. - HUMAN CAPITAL LONG BEACH,856,DEPT OF CITYWIDE ADMIN SERVS,REHABILITATION OF CITY-OWNED OFFICE SPACE,101,MANHATTAN,PW-0077,4027,2339,0,50,0,0,0,0,2389,2339,0,50,0,0,0,0,2389,4678,0,100,0,0,0,0,4778,PROJECT DELAYED DUE TO CHANGES IN SCOPE/DESIGN,,1 CENTRE ST. 13/14 LONG BEACH,cpd11-20mn.pdf
PW193MOME,1 CENTRE ST - MOME - A/C AND ANCILLARY WORK,856,DEPT OF CITYWIDE ADMIN SERVS,REHABILITATION OF CITY-OWNED OFFICE SPACE,101,MANHATTAN,PW-0193,600,0,0,0,0,0,500,0,500,0,0,0,0,0,500,0,500,0,0,0,0,0,1000,0,1000,PROJECT DELAYED DUE TO CHANGES IN SCOPE/DESIGN,,SQ FT,cpd11-20mn.pdf
PW195ADA,80 CENTRE ST - ADA LIFT,856,DEPT OF CITYWIDE ADMIN SERVS,REHABILITATION OF CITY-OWNED OFFICE SPACE,101,MANHATTAN,PW-0282,746,0,746,0,0,0,0,0,746,0,746,0,0,0,0,0,746,0,1492,0,0,0,0,0,1492,,,IA/SQ,cpd11-20mn.pdf
PW195RF,80 CENTRE ST.- ROOF REPLACEMENT,856,DEPT OF CITYWIDE ADMIN SERVS,REHABILITATION OF CITY-OWNED OFFICE SPACE,101,MANHATTAN,PW-0195,4925,0,0,482,0,0,4200,0,4682,0,0,482,0,0,4200,0,4682,0,0,964,0,0,8400,0,9364,,,SQ FT,cpd11-20mn.pdf
PW266TOIL,125 WORTH ST.- CODE COMPLIANT TOILET UPGRADES,856,DEPT OF CITYWIDE ADMIN SERVS,REHABILITATION OF CITY-OWNED OFFICE SPACE,101,MANHATTAN,PW-0077,2450,0,0,0,0,250,0,2200,2450,0,0,0,0,250,0,2200,2450,0,0,0,0,500,0,4400,4900,PROJECT DELAYED DUE TO BUDGETARY CONSTRAINTS,,CODE COMPLIANT TOILET UPGRADES,cpd11-20mn.pdf
PW293125D,125 WORTH STREET - FIRE ALARM -SPRINKLERS,856,DEPT OF CITYWIDE ADMIN SERVS,LEGAL MANDATES AND CORRECTION OF UNSAFE CONDITIONS,101,MANHATTAN,PW-0293,49479,0,3612,0,0,45145,0,0,48757,0,3612,0,0,45145,0,0,48757,0,7224,0,0,90290,0,0,97514,,,125 WORTH STREET - FIRE ALARM DESIGN,cpd11-20mn.pdf
PW2931C,1 CENTRE STREET - FIRE SPRINKLERS,856,DEPT OF CITYWIDE ADMIN SERVS,LEGAL MANDATES AND CORRECTION OF UNSAFE CONDITIONS,101,MANHATTAN,PW-0293,47865,86,4280,0,0,42786,0,0,47152,86,4280,0,0,42786,0,0,47152,172,8560,0,0,85572,0,0,94304,PROJECT DELAYED DUE TO BUDGETARY CONSTRAINTS,,1 CENTRE STREET - FIRE SPRINKLERS,cpd11-20mn.pdf
PW308PS1,MAYOR'S OFFICE - 100 GOLD ST - PRINTSHOP UPGRADE,856,DEPT OF CITYWIDE ADMIN SERVS,EQUIPMENT AND INTERAGENCY SERVICES,101,MANHATTAN,PW-0308,704,299,0,792,0,0,0,0,1091,299,0,792,0,0,0,0,1091,598,0,1584,0,0,0,0,2182,,,,cpd11-20mn.pdf
PW310COOL,31 CHAMBERS ST.- COLD STORAGE SYSTEM FOR DORIS,856,DEPT OF CITYWIDE ADMIN SERVS,REHABILITATION OF CITY-OWNED OFFICE SPACE,101,MANHATTAN,PW-0310,775,5,0,0,0,0,365,0,370,5,0,0,0,0,365,0,370,10,0,0,0,0,730,0,740,PROJECT DELAYED DUE TO BUDGETARY CONSTRAINTS,"31 CHAMBERS ST. NY, NY 10007","REPLACEMENT OF 2 COOLING TOWERS; REPLACEMENT OF PUMPS, CONTROLS, & STEEL DUNNAGE",cpd11-20mn.pdf
PW310FAN,31 CHAMBERS ST. - REPLACEMENT OF FAN COIL UNITS ON FIRST FL.,856,DEPT OF CITYWIDE ADMIN SERVS,REHABILITATION OF CITY-OWNED OFFICE SPACE,101,MANHATTAN,PW-0310,1035,284,0,0,0,0,1122,0,1406,284,0,0,0,0,1122,0,1406,568,0,0,0,0,2244,0,2812,PROJECT DELAYED DUE TO CHANGES IN SCOPE/DESIGN,,"REPLACE EXISITNG 20 FAN COIL UNITS ON FIRST FLOOR, ASSOCIATED EQUIPMENT AND CONTROLS.",cpd11-20mn.pdf
PW324OMIS,DCAS IT LUMP SUM,856,DEPT OF CITYWIDE ADMIN SERVS,EQUIPMENT AND INTERAGENCY SERVICES,101,MANHATTAN,PW-0324,22998,798,0,1594,4129,4575,3628,26307,41031,798,0,1594,4129,4575,3628,26307,41031,1596,0,3188,8258,9150,7256,52614,82062,PROJECT DELAYED DUE TO CHANGES IN SCOPE/DESIGN,VARIOUS DCAS FACILITIES,,cpd11-20mn.pdf
PW32671T,OCA LEASE RENEWAL AT 151 WEST BROADWAY/71 THOMAS St,856,DEPT OF CITYWIDE ADMIN SERVS,RENOVATION OF LEASED SPACE,101,MANHATTAN,PW-0326,1518,0,0,0,0,0,1518,0,1518,0,0,0,0,0,1518,0,1518,0,0,0,0,0,3036,0,3036,PROJECT DELAYED DUE TO BUDGETARY CONSTRAINTS,,OCA LEASE RENEWAL AT 151 WEST BROADWAY/71 THOMAS ST,cpd11-20mn.pdf
PW326NYCC,"CITY COUNCIL - 250 BROADWAY, FLS 14-18, 30 RENO & EXPANSION",856,DEPT OF CITYWIDE ADMIN SERVS,RENOVATION OF LEASED SPACE,101,MANHATTAN,PW-D005,24633,0,0,0,0,10000,0,0,10000,0,0,0,0,10000,0,0,10000,0,0,0,0,20000,0,0,20000,PROJECT DELAYED DUE TO CHANGES IN SCOPE/DESIGN,,SQ/IA,cpd11-20mn.pdf
PW326OMBP,OMB Pantry at 255 Greenwich,856,DEPT OF CITYWIDE ADMIN SERVS,RENOVATION OF LEASED SPACE,101,MANHATTAN,PW-0326,187,226,0,140,0,0,0,0,366,226,0,140,0,0,0,0,366,452,0,280,0,0,0,0,732,PROJECT DELAYED DUE TO CHANGES IN SCOPE/DESIGN,,LEASED SPACE - RENOVATION OF OMB PANTRY AT 255 GREENWICH,cpd11-20mn.pdf
PW326RAM,LAW DEPT - RAISE THE AGE - MANHATTAN,856,DEPT OF CITYWIDE ADMIN SERVS,RENOVATION OF LEASED SPACE,101,MANHATTAN,PW-0326,4682,0,3881,801,0,0,0,0,4682,0,3881,801,0,0,0,0,4682,0,7762,1602,0,0,0,0,9364,,,LAW DEPT - RAISE THE AGE - MANHATTAN,cpd11-20mn.pdf
PW326RE40,100 GOLD ST.- TENANT RELOCATION FROM 40 RECTOR,856,DEPT OF CITYWIDE ADMIN SERVS,RENOVATION OF LEASED SPACE,101,MANHATTAN,PW-0077,23070,10260,0,195,0,0,0,0,10455,10260,0,195,0,0,0,0,10455,20520,0,390,0,0,0,0,20910,PROJECT DELAYED DUE TO CHANGES IN SCOPE/DESIGN,,DCAS - RELOCATION FROM 40 RECTOR STREET,cpd11-20mn.pdf
PW326ZM03,CBMN - RELOCATE COMM BD 3 FROM 59 E. 4TH STREET,856,DEPT OF CITYWIDE ADMIN SERVS,RENOVATION OF LEASED SPACE,101,MANHATTAN,PW-0326,226,0,0,0,0,0,0,226,226,0,0,0,0,0,0,226,226,0,0,0,0,0,0,452,452,PROJECT DELAYED DUE TO BUDGETARY CONSTRAINTS,,MANHATTAN COMMUNITY BOARD 3 - RELOCATION FROM 59 EAST 4TH STREET,cpd11-20mn.pdf
PW326ZM09,CBMN - MANHATTAN COMMUNITY BOARD 9,856,DEPT OF CITYWIDE ADMIN SERVS,RENOVATION OF LEASED SPACE,101,MANHATTAN,PW-0326,271,0,607,0,0,0,0,0,607,0,607,0,0,0,0,0,607,0,1214,0,0,0,0,0,1214,PROJECT DELAYED DUE TO CHANGES IN SCOPE/DESIGN,,MANHATTAN COMMUNITY BOARD 9,cpd11-20mn.pdf
PW327PLZ2,1 CENTRE STREET PLAZA REHABILITATION,856,DEPT OF CITYWIDE ADMIN SERVS,REHABILITATION OF CITY-OWNED OFFICE SPACE,101,MANHATTAN,PW-0077,11555,869,1,0,0,0,10424,0,11294,869,1,0,0,0,10424,0,11294,1738,2,0,0,0,20848,0,22588,PROJECT DELAYED DUE TO BUDGETARY CONSTRAINTS,,1 CENTRE STREET PLAZA REHABILITATION,cpd11-20mn.pdf
PW340FIP2,BOE- FACILITIES IMPROVEMENT PROJECT,856,DEPT OF CITYWIDE ADMIN SERVS,BOARD OF ELECTIONS MODERNIZATION,101,MANHATTAN,PW-0340,394,0,0,394,0,0,0,0,394,0,0,394,0,0,0,0,394,0,0,788,0,0,0,0,788,,,FACILITIES IMPROVEMENT PROJECT,cpd11-20mn.pdf
PW357ELC2,253 BROADWAY- ELECTRICAL UPGRADES PHASE 2,856,DEPT OF CITYWIDE ADMIN SERVS,REHABILITATION OF CITY-OWNED OFFICE SPACE,101,MANHATTAN,PW-0357,5200,0,0,960,4720,6800,0,0,12480,0,0,960,4720,6800,0,0,12480,0,0,1920,9440,13600,0,0,24960,PROJECT DELAYED DUE TO BUDGETARY CONSTRAINTS,,253 BROADWAY- ELECTRICAL UPGRADES,cpd11-20mn.pdf
PW357EXTR,253 BROADWAY- EXTERIOR AND ROOF,856,DEPT OF CITYWIDE ADMIN SERVS,REHABILITATION OF CITY-OWNED OFFICE SPACE,101,MANHATTAN,PW-0077 PW-0357,13208,32421,16,0,142,0,0,0,32579,32421,16,0,142,0,0,0,32579,64842,32,0,284,0,0,0,65158,PROJECT DELAYED DUE TO CHANGES IN SCOPE/DESIGN,"253 BROADWAY, MANHATTAN",RECONSTRUCT ROOF AND EXTERIOR/FACADE,cpd11-20mn.pdf
PW357SA,253 AND 256 BROADWAY- SAFE ACCESS CATWALK,856,DEPT OF CITYWIDE ADMIN SERVS,REHABILITATION OF CITY-OWNED OFFICE SPACE,101,MANHATTAN,PW-0357,188,0,0,0,167,0,0,0,167,0,0,0,167,0,0,0,167,0,0,0,334,0,0,0,334,PROJECT DELAYED DUE TO BUDGETARY CONSTRAINTS,,253 AND 256 BROADWAY - SAFE ACCESS CATWALK,cpd11-20mn.pdf
PW357STM2,253 BROADWAY - RECONSTRUCT STEAM STATION,856,DEPT OF CITYWIDE ADMIN SERVS,REHABILITATION OF CITY-OWNED OFFICE SPACE,101,MANHATTAN,PW-0357,2364,0,200,0,2164,0,0,0,2364,0,200,0,2164,0,0,0,2364,0,400,0,4328,0,0,0,4728,PROJECT DELAYED DUE TO BUDGETARY CONSTRAINTS,,RECONSTRUCT STEAM STATION AT 253 BROADWAY,cpd11-20mn.pdf
PW357VAUL,253 BROADWAY - VAULT RECONSTRUCTION,856,DEPT OF CITYWIDE ADMIN SERVS,REHABILITATION OF CITY-OWNED OFFICE SPACE,101,MANHATTAN,PW-0357,10678,0,0,0,777,8930,0,0,9707,0,0,0,777,8930,0,0,9707,0,0,0,1554,17860,0,0,19414,,,SQ/IA,cpd11-20mn.pdf
PW77115CH,115 CHRYSTIE ST. - INTERIOR RENOVATIONS,856,DEPT OF CITYWIDE ADMIN SERVS,REHABILITATION OF CITY-OWNED OFFICE SPACE,101,MANHATTAN,PW-0077,4262,0,0,0,0,0,3362,0,3362,0,0,0,0,0,3362,0,3362,0,0,0,0,0,6724,0,6724,PROJECT DELAYED DUE TO BUDGETARY CONSTRAINTS,,INTERIOR RENOVATIONS,cpd11-20mn.pdf
PW77117SA,137 CENTRE ST. - SAFE ACCESS,856,DEPT OF CITYWIDE ADMIN SERVS,REHABILITATION OF CITY-OWNED OFFICE SPACE,101,MANHATTAN,PW-0077,402,0,0,0,0,0,40,308,348,0,0,0,0,0,40,308,348,0,0,0,0,0,80,616,696,PROJECT DELAYED DUE TO BUDGETARY CONSTRAINTS,,137 CENTRE STREET SAFETY GRATINGS,cpd11-20mn.pdf
PW77136A,"60 LAFAYETTE ST, 2nd 4th FL - DOP",856,DEPT OF CITYWIDE ADMIN SERVS,REHABILITATION OF CITY-OWNED OFFICE SPACE,101,MANHATTAN,PW-0077,3985,361,0,7882,0,0,0,0,8243,361,0,7882,0,0,0,0,8243,722,0,15764,0,0,0,0,16486,,,SQ/IA,cpd11-20mn.pdf
PW77137C,137 CENTRE ST. Renovation,856,DEPT OF CITYWIDE ADMIN SERVS,REHABILITATION OF CITY-OWNED OFFICE SPACE,101,MANHATTAN,PW-0077,45000,0,0,0,0,0,0,45000,45000,0,0,0,0,0,0,45000,45000,0,0,0,0,0,0,90000,90000,PROJECT DELAYED PENDING APPROVAL OF NECESSARY PERMITS,,137 CENTRE ST. RENOVATION,cpd11-20mn.pdf
PW771C09,1 CENTRE ST. - 9th Floor Renovation,856,DEPT OF CITYWIDE ADMIN SERVS,REHABILITATION OF CITY-OWNED OFFICE SPACE,101,MANHATTAN,PW-0077,20000,0,0,0,0,0,0,20000,20000,0,0,0,0,0,0,20000,20000,0,0,0,0,0,0,40000,40000,PROJECT DELAYED DUE TO BUDGETARY CONSTRAINTS,,1 CENTRE ST. - 9TH FLOOR RENOVATION,cpd11-20mn.pdf
PW771C21,1 CENTRE ST. - 21st Floor Renovation,856,DEPT OF CITYWIDE ADMIN SERVS,REHABILITATION OF CITY-OWNED OFFICE SPACE,101,MANHATTAN,PW-0077,20000,0,0,0,0,0,0,20000,20000,0,0,0,0,0,0,20000,20000,0,0,0,0,0,0,40000,40000,PROJECT DELAYED DUE TO BUDGETARY CONSTRAINTS,,1 CENTRE ST. - 21ST FLOOR RENOVATION,cpd11-20mn.pdf
PW7722R5,22 READE ST.- 5th AND 6th FLOOR BUILDOUT,856,DEPT OF CITYWIDE ADMIN SERVS,REHABILITATION OF CITY-OWNED OFFICE SPACE,101,MANHATTAN,PW-0077,9930,0,0,0,0,0,820,8208,9028,0,0,0,0,0,820,8208,9028,0,0,0,0,0,1640,16416,18056,,,$390 PER SQ FT,cpd11-20mn.pdf
PW7722REV,22 READE ST.- ELEVATOR MODERNIZATION,856,DEPT OF CITYWIDE ADMIN SERVS,REHABILITATION OF CITY-OWNED OFFICE SPACE,101,MANHATTAN,PW-0077,2976,2519,287,0,0,0,0,0,2806,2519,287,0,0,0,0,0,2806,5038,574,0,0,0,0,0,5612,,,DCAS - 22 READE STREET ELEVATOR MODERNIZATION,cpd11-20mn.pdf
PW7725RF,1 CENTER ST ROOF - 25th FLOOR,856,DEPT OF CITYWIDE ADMIN SERVS,REHABILITATION OF CITY-OWNED OFFICE SPACE,101,MANHATTAN,PW-0077,6428,0,0,5898,0,0,0,0,5898,0,0,5898,0,0,0,0,5898,0,0,11796,0,0,0,0,11796,,,IA/SQ,cpd11-20mn.pdf
PW7726RF,1 CENTRE ST - 26TH FLOOR ROOF REPLACEMENT,856,DEPT OF CITYWIDE ADMIN SERVS,REHABILITATION OF CITY-OWNED OFFICE SPACE,101,MANHATTAN,PW-0077,1071,0,0,973,0,0,0,0,973,0,0,973,0,0,0,0,973,0,0,1946,0,0,0,0,1946,,,IA/SQ,cpd11-20mn.pdf
PW7780FAC,80 CENTRE ST.- EXTERIOR REHABILITATION,856,DEPT OF CITYWIDE ADMIN SERVS,REHABILITATION OF CITY-OWNED OFFICE SPACE,101,MANHATTAN,PW-0077,2679,2856,0,77,0,0,0,0,2933,2856,0,77,0,0,0,0,2933,5712,0,154,0,0,0,0,5866,PROJECT DELAYED DUE TO CHANGES IN SCOPE/DESIGN,80 CENTRE ST MANHATTAN,RECONSTRUCT BUILDING FACADE,cpd11-20mn.pdf
PW77BOC,2 LAFAYETTE St. - 12th Fl. BOC Renovation,856,DEPT OF CITYWIDE ADMIN SERVS,REHABILITATION OF CITY-OWNED OFFICE SPACE,101,MANHATTAN,PW-0077,1807,1934,167,0,0,0,0,0,2101,1934,167,0,0,0,0,0,2101,3868,334,0,0,0,0,0,4202,,,"BOARD OF CORRECTIONS INTERIOR RENOVATION AT 2 LAFAYETTE STREET, 12TH FLOOR.",cpd11-20mn.pdf
PW77DAK01,NY COUNTY DA'S OFFICE FIRE UPGRADES,856,DEPT OF CITYWIDE ADMIN SERVS,REHABILITATION OF CITY-OWNED OFFICE SPACE,101,MANHATTAN,PW-0077 PW-0293,308,324,0,120,0,0,0,0,444,324,0,120,0,0,0,0,444,648,0,240,0,0,0,0,888,PROJECT DELAYED DUE TO CHANGES IN SCOPE/DESIGN,,NY COUNTY DA'S OFFICE - FIRE ALARM SYSTEM UPGRADES AT 80 CENTRE AND 100 CENTRE STREET,cpd11-20mn.pdf
PW77DATU,DA MANHATTAN - ADA BATHROOM UPGRADE,856,DEPT OF CITYWIDE ADMIN SERVS,LEGAL MANDATES AND CORRECTION OF UNSAFE CONDITIONS,101,MANHATTAN,PW-0077,2739,0,0,283,0,2000,0,0,2283,0,0,283,0,2000,0,0,2283,0,0,566,0,4000,0,0,4566,,,ADA AT 100 CENTRE ST,cpd11-20mn.pdf
PW77GLD2F,100 GOLD STREET 2 FLOOR - MOCs,856,DEPT OF CITYWIDE ADMIN SERVS,REHABILITATION OF CITY-OWNED OFFICE SPACE,101,MANHATTAN,PW-0077 PU-0025,11681,765,9381,3071,0,0,0,0,13217,765,9381,3071,0,0,0,0,13217,1530,18762,6142,0,0,0,0,26434,,,100 GOLD STREET 2 FLOOR - MOCS,cpd11-20mn.pdf
PW77GLDBR,100 GOLD ST - BATHROOM RENOVATION,856,DEPT OF CITYWIDE ADMIN SERVS,REHABILITATION OF CITY-OWNED OFFICE SPACE,101,MANHATTAN,PW-0077,7306,0,0,0,0,6617,0,0,6617,0,0,0,0,6617,0,0,6617,0,0,0,0,13234,0,0,13234,,,100 GOLD ST - BATHROOM RENOVATION,cpd11-20mn.pdf
PW77GLDFA,100 GOLD ST - FIRE ALARM,856,DEPT OF CITYWIDE ADMIN SERVS,REHABILITATION OF CITY-OWNED OFFICE SPACE,100,MANHATTAN,PW-0077,17160,1069,0,14581,0,0,0,0,15650,1069,0,14581,0,0,0,0,15650,2138,0,29162,0,0,0,0,31300,,,100 GOLD ST - FIRE ALARM,cpd11-20mn.pdf
PW77GLDSA,100 GOLD ST. - SAFE ACCESS/CATWALK,856,DEPT OF CITYWIDE ADMIN SERVS,REHABILITATION OF CITY-OWNED OFFICE SPACE,101,MANHATTAN,PW-0077,67,0,0,0,0,0,45,0,45,0,0,0,0,0,45,0,45,0,0,0,0,0,90,0,90,PROJECT DELAYED DUE TO BUDGETARY CONSTRAINTS,,100 GOLD ST.- SAFE ACCESS/CATWALK,cpd11-20mn.pdf
PW77MU8EL,1 CENTRE ST.- 8TH FL. COMPTROLLERS OFFICE RENOVATIONS,856,DEPT OF CITYWIDE ADMIN SERVS,REHABILITATION OF CITY-OWNED OFFICE SPACE,101,MANHATTAN,PW-0077,15094,14171,0,626,0,0,0,0,14797,14171,0,626,0,0,0,0,14797,28342,0,1252,0,0,0,0,29594,PROJECT DELAYED DUE TO CHANGES IN SCOPE/DESIGN,,1 CENTRE STREET 8TH FLOOR ELECTRICAL AND LIGHTING UPGRADE,cpd11-20mn.pdf
PW77SC14,1 CENTRE ST.- 14 FL SECURITY CAMERAS,856,DEPT OF CITYWIDE ADMIN SERVS,REHABILITATION OF CITY-OWNED OFFICE SPACE,101,MANHATTAN,PW-0077,445,45,0,355,0,0,0,0,400,45,0,355,0,0,0,0,400,90,0,710,0,0,0,0,800,,,CAMERA CONSTRUCTION,cpd11-20mn.pdf
PW77SC1C,1 CENTRE ST - DCAS POLICE CCTV SYSTEM UPGRADE,856,DEPT OF CITYWIDE ADMIN SERVS,REHABILITATION OF CITY-OWNED OFFICE SPACE,101,MANHATTAN,PW-0077,1985,158,1628,0,0,0,0,0,1786,158,1628,0,0,0,0,0,1786,316,3256,0,0,0,0,0,3572,,,SQ/IA,cpd11-20mn.pdf
PW77SC22R,22 READE ST - DCAS POLICE CCTV SYSTEM,856,DEPT OF CITYWIDE ADMIN SERVS,REHABILITATION OF CITY-OWNED OFFICE SPACE,101,MANHATTAN,PW-0077,814,73,0,742,0,0,0,0,815,73,0,742,0,0,0,0,815,146,0,1484,0,0,0,0,1630,,,SQ/IA,cpd11-20mn.pdf
PW77SC280,280 BROADWAY - DCAS POLICE CCTV SYSTEM,856,DEPT OF CITYWIDE ADMIN SERVS,REHABILITATION OF CITY-OWNED OFFICE SPACE,101,MANHATTAN,PW-0077,814,73,0,742,0,0,0,0,815,73,0,742,0,0,0,0,815,146,0,1484,0,0,0,0,1630,,,SQ/IA,cpd11-20mn.pdf
PW77SC2C,2 LAFAYETTE ST - DCAS POLICE CCTV SYSTEM,856,DEPT OF CITYWIDE ADMIN SERVS,REHABILITATION OF CITY-OWNED OFFICE SPACE,101,MANHATTAN,PW-0077,894,80,0,815,0,0,0,0,895,80,0,815,0,0,0,0,895,160,0,1630,0,0,0,0,1790,,,SQ/IA,cpd11-20mn.pdf
PW77TAX,1 CENTRE ST.- 11TH FL. TAX COMMISSION REHAB,856,DEPT OF CITYWIDE ADMIN SERVS,REHABILITATION OF CITY-OWNED OFFICE SPACE,101,MANHATTAN,PW-0077,907,1116,0,0,0,0,0,95,1211,1116,0,0,0,0,0,95,1211,2232,0,0,0,0,0,190,2422,PROJECT DELAYED DUE TO CHANGES IN SCOPE/DESIGN,,1 CENTRE ST.- TAX COMMISSION 11TH FLOOR REHAB,cpd11-20mn.pdf
PW80CT1,2 LAFAYETTE ST.- COOLING TOWER,856,DEPT OF CITYWIDE ADMIN SERVS,REHABILITATION OF CITY-OWNED OFFICE SPACE,101,MANHATTAN,PW-0080,599,0,0,58,500,0,0,0,558,0,0,58,500,0,0,0,558,0,0,116,1000,0,0,0,1116,,,UNIT,cpd11-20mn.pdf
PW80ELEC,2 LAFAYETTE STREET ELECTRICAL UPGRADE,856,DEPT OF CITYWIDE ADMIN SERVS,REHABILITATION OF CITY-OWNED OFFICE SPACE,101,MANHATTAN,PW-0080,13000,0,0,1000,0,0,12000,0,13000,0,0,1000,0,0,12000,0,13000,0,0,2000,0,0,24000,0,26000,PROJECT DELAYED DUE TO BUDGETARY CONSTRAINTS,,2 LAFAYETTE STREET ELECTRICAL UPGRADE PHASE 2,cpd11-20mn.pdf
PWCN001,Sixth Street compost project,856,DEPT OF CITYWIDE ADMIN SERVS,MISCELLANEOUS CONSTRUCTION,100 103,MANHATTAN,PW-D077,68,0,0,0,0,68,0,0,68,0,0,0,0,68,0,0,68,0,0,0,0,136,0,0,136,PROJECT DELAYED DUE TO BUDGETARY CONSTRAINTS,,SIXTH STREET COMPOST PROJECT,cpd11-20mn.pdf
PWD05CYBR,80 CENTRE ST. - NY COUNTY DA CYBERCRIME AND IDENTITY THEFT,856,DEPT OF CITYWIDE ADMIN SERVS,REHABILITATION OF CITY-OWNED OFFICE SPACE,101,MANHATTAN,PW-D005,5240,3630,92,0,0,0,0,0,3722,3630,92,0,0,0,0,0,3722,7260,184,0,0,0,0,0,7444,PROJECT DELAYED DUE TO CHANGES IN SCOPE/DESIGN,,"NY COUNTY DA'S OFFICE CYBERCRIME AND ID THEFT - CONSTRUCTION/OUTFITTING OF 11,307 SQ FT",cpd11-20mn.pdf
PWD05DAHV,80 CENTRE ST. - NY COUNTY DA HVAC UPGRADE SERVER ROOM,856,DEPT OF CITYWIDE ADMIN SERVS,REHABILITATION OF CITY-OWNED OFFICE SPACE,101,MANHATTAN,PW-D005,479,0,479,0,0,0,0,0,479,0,479,0,0,0,0,0,479,0,958,0,0,0,0,0,958,,,NEW YORK COUNTY DISTRICT ATTORNEY'S OFFICE -REPLACING THE HVAC SYSTEMIN THREE IT,cpd11-20mn.pdf
PWD5BAG,1 CENTRE ST.- BIG APPLE GREETER,856,DEPT OF CITYWIDE ADMIN SERVS,REHABILITATION OF CITY-OWNED OFFICE SPACE,101,MANHATTAN,PW-D005,917,214,0,0,0,0,0,200,414,214,0,0,0,0,0,200,414,428,0,0,0,0,0,400,828,PROJECT DELAYED DUE TO CHANGES IN SCOPE/DESIGN,,BIG APPLE GREETER AT 1 CENTRE ST.,cpd11-20mn.pdf
PWDNTEW,NONTRADITIONAL EMPLOYMENT FOR WOMEN 243 W 20th St,856,DEPT OF CITYWIDE ADMIN SERVS,MISCELLANEOUS CONSTRUCTION,,MANHATTAN,PW-D005,800,0,0,0,0,800,0,0,800,0,0,0,0,800,0,0,800,0,0,0,0,1600,0,0,1600,PROJECT DELAYED DUE TO BUDGETARY CONSTRAINTS,,NON-TRADITIONAL EMPLOYMENT FOR WOMEN -- BUILDING RENOVATION OF 243 W 20TH ST,cpd11-20mn.pdf
PWMOCSIT1,MOCS IT NETWORK INFRASTRUCTURE 100 GOLD STREET 2ND FL,856,DEPT OF CITYWIDE ADMIN SERVS,REHABILITATION OF CITY-OWNED OFFICE SPACE,101,MANHATTAN,PW-0077,684,0,0,622,0,0,0,0,622,0,0,622,0,0,0,0,622,0,0,1244,0,0,0,0,1244,,,MOCS IT NETWORK INFRASTRUCTURE 100 GOLD STREET 2ND FL,cpd11-20mn.pdf
SCACIP06,M140 - SYSTEM REPLACEMENT,856,DEPT OF CITYWIDE ADMIN SERVS,"BUILDING CONSTRUCTION, RECONSTRUCTION OR RETROFIT",101,MANHATTAN,PU-0025,500,0,0,500,0,0,0,0,500,0,0,500,0,0,0,0,500,0,0,1000,0,0,0,0,1000,,,M140 - SYSTEM REPLACEMENT,cpd11-20mn.pdf
LN20LSCRF,Library Services Center - Roof Deck Replacement,037,NEW YORK PUBLIC LIBRARY,ESSENTIAL RECONSTRUCTION OF FACILITIES,,QUEENS,LN-0110,7500,0,0,0,250,0,7250,0,7500,0,0,0,250,0,7250,0,7500,0,0,0,500,0,14500,0,15000,,,LIBRARY SERVICES CENTER - ROOF DECK REPLACEMENT,cpd11-20qn.pdf
LQ122-GEN,SYSTEMWIDE - General Projects/Infrastructure,039,QUEENS BOROUGH PUBLIC LIBRARY,ESSENTIAL RECONSTRUCTION OF FACILITIES,400,QUEENS,LQ-0122 LQ-D122,5691,0,0,12292,900,98,0,988,14278,0,0,12292,900,98,0,988,14278,0,0,24584,1800,196,0,1976,28556,PROJECT DELAYED DUE TO CHANGES IN SCOPE/DESIGN,,GENERAL PROJECTS / INFRASTRUCTURE,cpd11-20qn.pdf
LQBCHREAD,BROAD CHANNEL,039,QUEENS BOROUGH PUBLIC LIBRARY,ESSENTIAL RECONSTRUCTION OF FACILITIES,400,QUEENS,LQ-D122,250,0,0,0,230,0,0,0,230,0,0,0,230,0,0,0,230,0,0,0,460,0,0,0,460,,,LIBRARY SEATING AREA,cpd11-20qn.pdf
LQBC-ROOF,BROAD CHANNEL,039,QUEENS BOROUGH PUBLIC LIBRARY,RECONSTRUCTION NECESSARY TO MAINTAIN FACILITIES,400,QUEENS,LQ-0122,545,0,0,0,0,0,490,0,490,0,0,0,0,0,490,0,490,0,0,0,0,0,980,0,980,,,NEW ROOF,cpd11-20qn.pdf
LQBR-ROOF,BROADWAY - ROOF,039,QUEENS BOROUGH PUBLIC LIBRARY,ESSENTIAL RECONSTRUCTION OF FACILITIES,400,QUEENS,LQ-0122,1002,0,117,0,0,0,783,0,900,0,117,0,0,0,783,0,900,0,234,0,0,0,1566,0,1800,,,BROADWAY ROOF,cpd11-20qn.pdf
LQC122-JH,JACKSON HEIGHTS - Branch Expansion & Renovation,039,QUEENS BOROUGH PUBLIC LIBRARY,REPLACEMENT BRANCHES,403,QUEENS,LQ-D122 LQ-0122,2250,0,1192,0,2119,0,25197,0,28508,0,1192,0,2119,0,25197,0,28508,0,2384,0,4238,0,50394,0,57016,PROJECT DELAYED DUE TO CHANGES IN SCOPE/DESIGN,"35-51 81ST ST, JACKSON HEIGHTS 11372",EXPANSION OF EXISTING BUILDING,cpd11-20qn.pdf
LQCA19FRH,FOREST HILLS,039,QUEENS BOROUGH PUBLIC LIBRARY,RECONSTRUCTION NECESSARY TO MAINTAIN FACILITIES,400,QUEENS,LQ-D122,425,0,46,0,339,0,0,0,385,0,46,0,339,0,0,0,385,0,92,0,678,0,0,0,770,,,FOREST HILLS,cpd11-20qn.pdf
LQCA19LHS,LANGSTON HUGHES,039,QUEENS BOROUGH PUBLIC LIBRARY,RECONSTRUCTION NECESSARY TO MAINTAIN FACILITIES,400,QUEENS,LQ-D122,150,0,0,0,136,0,0,0,136,0,0,0,136,0,0,0,136,0,0,0,272,0,0,0,272,,,BMS SYSTEM,cpd11-20qn.pdf
LQCA19QVG,QUEENS VILLAGE,039,QUEENS BOROUGH PUBLIC LIBRARY,ESSENTIAL RECONSTRUCTION OF FACILITIES,400,QUEENS,LQ-D122,4400,0,0,0,3985,0,0,0,3985,0,0,0,3985,0,0,0,3985,0,0,0,7970,0,0,0,7970,,,"EXTERIOR REHABILITATION, ADA ACCESS, WINDOWS",cpd11-20qn.pdf
LQCA19WSD,WOODSIDE,039,QUEENS BOROUGH PUBLIC LIBRARY,ESSENTIAL RECONSTRUCTION OF FACILITIES,400,QUEENS,LQ-D122 LQ-0122,16156,0,1388,0,0,5740,0,8292,15420,0,1388,0,0,5740,0,8292,15420,0,2776,0,0,11480,0,16584,30840,,,BRANCH RENOVATION,cpd11-20qn.pdf
LQCA20MGR,McGoldrick,039,QUEENS BOROUGH PUBLIC LIBRARY,RECONSTRUCTION NECESSARY TO MAINTAIN FACILITIES,400,QUEENS,LQ-D122,1000,0,0,0,908,0,0,0,908,0,0,0,908,0,0,0,908,0,0,0,1816,0,0,0,1816,,,MCGOLDRICK,cpd11-20qn.pdf
LQCELHVAC,CENTRAL,039,QUEENS BOROUGH PUBLIC LIBRARY,ESSENTIAL RECONSTRUCTION OF FACILITIES,400,QUEENS,LQ-D122 LQ-0122,2000,0,1281,0,1642,0,0,10316,13239,0,1281,0,1642,0,0,10316,13239,0,2562,0,3284,0,0,20632,26478,,,"COMPREHENSIVE FACADE RESTORATION, ROOF AND HVAC SYSTEMS REPLACEMENT.",cpd11-20qn.pdf
LQCLDC-CE,Central Library,039,QUEENS BOROUGH PUBLIC LIBRARY,RECONSTRUCTION NECESSARY TO MAINTAIN FACILITIES,400,QUEENS,LQ-0122 LQ-D122,392,0,43,0,312,0,0,0,355,0,43,0,312,0,0,0,355,0,86,0,624,0,0,0,710,,,CENTRAL LIBRARY,cpd11-20qn.pdf
LQCORENOV,CORONA,039,QUEENS BOROUGH PUBLIC LIBRARY,REPLACEMENT BRANCHES,400,QUEENS,LQ-D122 LQ-D001 LQ-0122,31064,0,0,0,1673,0,0,23300,24973,0,0,0,1673,0,0,23300,24973,0,0,0,3346,0,0,46600,49946,,,CORONA RENOVATION,cpd11-20qn.pdf
LQD122LAE,LAURELTON,039,QUEENS BOROUGH PUBLIC LIBRARY,RECONSTRUCTION NECESSARY TO MAINTAIN FACILITIES,400,QUEENS,LQ-D122 LQ-0122,11233,0,0,0,3084,0,0,7187,10271,0,0,0,3084,0,0,7187,10271,0,0,0,6168,0,0,14374,20542,,,,cpd11-20qn.pdf
LQD122VEN,Mobile Library Unit,039,QUEENS BOROUGH PUBLIC LIBRARY,SUPPORT SERVICES IMPROVEMENTS,414,QUEENS,LQ-D001 LQ-D122,984,0,0,0,929,0,0,0,929,0,0,0,929,0,0,0,929,0,0,0,1858,0,0,0,1858,,,VENDING MACHINES,cpd11-20qn.pdf
LQFHREAD,FOREST HILLS OUTDOOR READING SPACE,039,QUEENS BOROUGH PUBLIC LIBRARY,SUPPORT SERVICES IMPROVEMENTS,406,QUEENS,LQ-D122,275,0,0,0,406,0,0,0,406,0,0,0,406,0,0,0,406,0,0,0,812,0,0,0,812,PROJECT DELAYED DUE TO CHANGES IN SCOPE/DESIGN,,FOREST HILLS OUTDOOR READING SPACE,cpd11-20qn.pdf
LQFHWIND,FOREST HILLS - Windows and Doors Replacement,039,QUEENS BOROUGH PUBLIC LIBRARY,RECONSTRUCTION NECESSARY TO MAINTAIN FACILITIES,406,QUEENS,LQ-Q122,600,0,0,0,544,0,0,0,544,0,0,0,544,0,0,0,544,0,0,0,1088,0,0,0,1088,PROJECT DELAYED DUE TO CHANGES IN SCOPE/DESIGN,,FOREST HILLS - WINDOWS AND DOORS REPLACEMENT,cpd11-20qn.pdf
LQFM-HVAC,FRESH MEADOWS,039,QUEENS BOROUGH PUBLIC LIBRARY,RECONSTRUCTION NECESSARY TO MAINTAIN FACILITIES,400,QUEENS,LQ-0122,1057,0,124,0,826,0,0,0,950,0,124,0,826,0,0,0,950,0,248,0,1652,0,0,0,1900,PROJECT DELAYED DUE TO CHANGES IN SCOPE/DESIGN,,HVAC,cpd11-20qn.pdf
LQHBW/D,HOWARD BEACH WINDOWS/DOORS,039,QUEENS BOROUGH PUBLIC LIBRARY,RECONSTRUCTION NECESSARY TO MAINTAIN FACILITIES,400,QUEENS,LQ-D122 LQ-0122,607,0,0,0,545,0,0,0,545,0,0,0,545,0,0,0,545,0,0,0,1090,0,0,0,1090,,,HOWARD BEACH WINDOWS/DOORS,cpd11-20qn.pdf
LQHILRENO,HILLCREST,039,QUEENS BOROUGH PUBLIC LIBRARY,ESSENTIAL RECONSTRUCTION OF FACILITIES,400,QUEENS,LQ-D122,1450,0,158,0,1156,0,0,0,1314,0,158,0,1156,0,0,0,1314,0,316,0,2312,0,0,0,2628,,,LIBRARY ROOM RENOVATION,cpd11-20qn.pdf
LQLAHEXTR,LANGSTON HUGHES,039,QUEENS BOROUGH PUBLIC LIBRARY,RECONSTRUCTION NECESSARY TO MAINTAIN FACILITIES,400,QUEENS,LQ-D122 LQ-0122,1116,0,0,0,1009,0,0,0,1009,0,0,0,1009,0,0,0,1009,0,0,0,2018,0,0,0,2018,,,EXTERIOR RESTORATION,cpd11-20qn.pdf
LQLARENOV,LAURELTON - RENOVATION,039,QUEENS BOROUGH PUBLIC LIBRARY,SUPPORT SERVICES IMPROVEMENTS,413,QUEENS,LQ-D122,345,0,0,0,345,0,0,0,345,0,0,0,345,0,0,0,345,0,0,0,690,0,0,0,690,PROJECT DELAYED DUE TO CHANGES IN SCOPE/DESIGN,,LAURELTON RENOVATION,cpd11-20qn.pdf
LQLFK-INT,Lefrak City Library - Interior renovations,039,QUEENS BOROUGH PUBLIC LIBRARY,ESSENTIAL RECONSTRUCTION OF FACILITIES,404,QUEENS,LQ-Q122 LQ-D122 LQ-0122,5000,0,0,0,2849,2000,0,0,4849,0,0,0,2849,2000,0,0,4849,0,0,0,5698,4000,0,0,9698,,,LEFRAK CITY LIBRARY - INTERIOR RENOVATIONS,cpd11-20qn.pdf
LQLI-ROOF,LONG ISLAND CITY,039,QUEENS BOROUGH PUBLIC LIBRARY,RECONSTRUCTION NECESSARY TO MAINTAIN FACILITIES,400,QUEENS,LQ-0122,1057,0,124,0,0,0,0,826,950,0,124,0,0,0,0,826,950,0,248,0,0,0,0,1652,1900,,,NEW ROOF,cpd11-20qn.pdf
LQMA-HVAC,MASPETH - HVAC,039,QUEENS BOROUGH PUBLIC LIBRARY,RECONSTRUCTION NECESSARY TO MAINTAIN FACILITIES,400,QUEENS,LQ-D122 LQ-0122,1000,0,0,0,900,0,0,0,900,0,0,0,900,0,0,0,900,0,0,0,1800,0,0,0,1800,,,MASPETH HVAC,cpd11-20qn.pdf
LQMAROOF,MASPETH ROOF,039,QUEENS BOROUGH PUBLIC LIBRARY,ESSENTIAL RECONSTRUCTION OF FACILITIES,400,QUEENS,LQ-D122 LQ-0122,1056,0,0,0,950,0,0,0,950,0,0,0,950,0,0,0,950,0,0,0,1900,0,0,0,1900,,,MASPETH ROOF,cpd11-20qn.pdf
LQNO-HVAC,NORTH HILLS - HVAC,039,QUEENS BOROUGH PUBLIC LIBRARY,ESSENTIAL RECONSTRUCTION OF FACILITIES,400,QUEENS,LQ-D122,850,0,0,0,773,0,0,0,773,0,0,0,773,0,0,0,773,0,0,0,1546,0,0,0,1546,,,NORTH HILLS - HVAC,cpd11-20qn.pdf
LQPOMHVAC,POMONOK - HVAC System Replacement,039,QUEENS BOROUGH PUBLIC LIBRARY,RECONSTRUCTION NECESSARY TO MAINTAIN FACILITIES,408,QUEENS,LQ-Q122,500,0,0,0,453,0,0,0,453,0,0,0,453,0,0,0,453,0,0,0,906,0,0,0,906,PROJECT DELAYED DUE TO CHANGES IN SCOPE/DESIGN,,POMONOK - HVAC SYSTEM REPLACEMENT,cpd11-20qn.pdf
LQQ122-MT,MITCHELL-LINDEN - Site Acquisition & Renovation,039,QUEENS BOROUGH PUBLIC LIBRARY,REPLACEMENT BRANCHES,407,QUEENS,LQ-D122 LQ-0122,7170,4300,0,0,0,2500,0,370,7170,4300,0,0,0,2500,0,370,7170,8600,0,0,0,5000,0,740,14340,PROJECT DELAYED DUE TO CHANGES IN SCOPE/DESIGN,,SITE ACQUISITION,cpd11-20qn.pdf
LQQA21CTQ,Court Square - New Library Fit Out,039,QUEENS BOROUGH PUBLIC LIBRARY,ESSENTIAL RECONSTRUCTION OF FACILITIES,,QUEENS,LQ-Q122 LQ-D122,1000,0,0,0,1801,0,0,0,1801,0,0,0,1801,0,0,0,1801,0,0,0,3602,0,0,0,3602,,,COURT SQUARE - NEW LIBRARY FIT OUT,cpd11-20qn.pdf
LQQV-TECH,QUEENS VILLAGE,039,QUEENS BOROUGH PUBLIC LIBRARY,SUPPORT SERVICES IMPROVEMENTS,400,QUEENS,LQ-D122,200,0,0,0,0,182,0,0,182,0,0,0,0,182,0,0,182,0,0,0,0,364,0,0,364,,,IMPROVEMENTS,cpd11-20qn.pdf
LQRS-EXTR,ROSEDALE,039,QUEENS BOROUGH PUBLIC LIBRARY,ESSENTIAL RECONSTRUCTION OF FACILITIES,400,QUEENS,LQ-0122 LQ-D122,13048,0,0,0,5445,0,0,7286,12731,0,0,0,5445,0,0,7286,12731,0,0,0,10890,0,0,14572,25462,,,EXPANSION AND RENOVATION,cpd11-20qn.pdf
LQSE-ROOF,SEASIDE,039,QUEENS BOROUGH PUBLIC LIBRARY,RECONSTRUCTION NECESSARY TO MAINTAIN FACILITIES,400,QUEENS,LQ-0122,891,0,0,0,0,800,0,0,800,0,0,0,0,800,0,0,800,0,0,0,0,1600,0,0,1600,,,NEW ROOF,cpd11-20qn.pdf
LQSE-WIN,SEASIDE,039,QUEENS BOROUGH PUBLIC LIBRARY,RECONSTRUCTION NECESSARY TO MAINTAIN FACILITIES,400,QUEENS,LQ-0122,891,0,0,0,800,0,0,0,800,0,0,0,800,0,0,0,800,0,0,0,1600,0,0,0,1600,,,WINDOWS AND DOORS,cpd11-20qn.pdf
LQSJ-INT,SOUTH JAMAICA,039,QUEENS BOROUGH PUBLIC LIBRARY,ESSENTIAL RECONSTRUCTION OF FACILITIES,400,QUEENS,LQ-0122,15195,0,0,0,946,0,0,7054,8000,0,0,0,946,0,0,7054,8000,0,0,0,1892,0,0,14108,16000,,,INTERIOR RENOVATION,cpd11-20qn.pdf
LQSTWSOLR,STEINWAY,039,QUEENS BOROUGH PUBLIC LIBRARY,SUPPORT SERVICES IMPROVEMENTS,400,QUEENS,LQ-D122,150,0,0,0,134,0,0,0,134,0,0,0,134,0,0,0,134,0,0,0,268,0,0,0,268,,,SOLAR PANELS,cpd11-20qn.pdf
LQSZ-RENO,SOUTH OZONE PARK - Branch Expansion and Renovation,039,QUEENS BOROUGH PUBLIC LIBRARY,ESSENTIAL RECONSTRUCTION OF FACILITIES,400,QUEENS,LQ-0122,12095,0,0,0,880,0,0,6620,7500,0,0,0,880,0,0,6620,7500,0,0,0,1760,0,0,13240,15000,,,SOUTH OZONE PARK RENOVATION,cpd11-20qn.pdf
LQWP-MASO,WINDSOR PARK - MASONRY,039,QUEENS BOROUGH PUBLIC LIBRARY,ESSENTIAL RECONSTRUCTION OF FACILITIES,400,QUEENS,LQ-0122,350,0,0,0,50,0,0,300,350,0,0,0,50,0,0,300,350,0,0,0,100,0,0,600,700,,,WINDSOR PARK MASONRY,cpd11-20qn.pdf
LQWP-TECH,WINDSOR PARK,039,QUEENS BOROUGH PUBLIC LIBRARY,SUPPORT SERVICES IMPROVEMENTS,400,QUEENS,LQ-D122,200,0,0,0,0,200,0,0,200,0,0,0,0,200,0,0,200,0,0,0,0,400,0,0,400,,,BRANCH IMPROVEMENT,cpd11-20qn.pdf
LQWS-TEEN,WOODSIDE,039,QUEENS BOROUGH PUBLIC LIBRARY,ESSENTIAL RECONSTRUCTION OF FACILITIES,400,QUEENS,LQ-D122,150,0,0,0,134,0,0,0,134,0,0,0,134,0,0,0,134,0,0,0,268,0,0,0,268,,,TEEN SPACE RENOVATION,cpd11-20qn.pdf
LQWSTTECH,WHITESTONE,039,QUEENS BOROUGH PUBLIC LIBRARY,SUPPORT SERVICES IMPROVEMENTS,400,QUEENS,LQ-D122,100,0,0,0,0,100,0,0,100,0,0,0,0,100,0,0,100,0,0,0,0,200,0,0,200,,,TECHNOLOGY INITIATIVE,cpd11-20qn.pdf
SANDYLQLS,SANDY DAMAGES - QBPL,039,QUEENS BOROUGH PUBLIC LIBRARY,RECONSTRUCTION NECESSARY TO MAINTAIN FACILITIES,400,QUEENS,LQ-0122,2963,0,0,0,0,0,0,0,0,0,0,0,0,0,0,0,0,0,0,0,0,0,0,0,0,,,HURRICANE SANDY RELATED DAMAGES - QBPL,cpd11-20qn.pdf
ACECUN201,HVAC Damper Upgrades for CUNY Community Colleges,042,CITY UNIVERSITY,MISCELLANEOUS RECONSTRUCTION,400,QUEENS,PU-0025,0,0,6050,0,0,0,0,0,6050,0,6050,0,0,0,0,0,6050,0,12100,0,0,0,0,0,12100,,,HVAC DAMPER UPGRADES,cpd11-20qn.pdf
ACECUN801,CUNY - Building Automation Controls Upgrade @ QCC,042,CITY UNIVERSITY,"BUILDING CONSTRUCTION, RECONSTRUCTION OR RETROFIT",401,QUEENS,PU-0025,4674,0,4674,0,0,0,0,0,4674,0,4674,0,0,0,0,0,4674,0,9348,0,0,0,0,0,9348,,,QUEENSBOROUGH COMMUNITY COLLEGE - BUILDING AUTOMATION CONTROLS UPGRADE PROJECT,cpd11-20qn.pdf
CA034QB13,Fire Alarm Reconstruction - Phase 3,042,CITY UNIVERSITY,MISCELLANEOUS RECONSTRUCTION,400,QUEENS,HN-0206,1000,26,974,0,0,0,0,0,1000,26,974,0,0,0,0,0,1000,52,1948,0,0,0,0,0,2000,PROJECT DELAYED DUE TO CHANGES IN SCOPE/DESIGN,,FIRE ALARM RECONSTRUCTION - PHASE 3,cpd11-20qn.pdf
CA052-017,Flushing Immigration Center,042,CITY UNIVERSITY,MISCELLANEOUS RECONSTRUCTION,400,QUEENS,HN-D300,500,0,0,500,0,0,0,0,500,0,0,500,0,0,0,0,500,0,0,1000,0,0,0,0,1000,PROJECT DELAYED DUE TO CHANGES IN SCOPE/DESIGN,,FLUSHING IMMIGRATION CENTER,cpd11-20qn.pdf
CA055QB17,CUNY ASAP Expansion,042,CITY UNIVERSITY,MISCELLANEOUS RECONSTRUCTION,400,QUEENS,HN-Q001 HN-0206,4650,2935,0,1715,0,0,0,0,4650,2935,0,1715,0,0,0,0,4650,5870,0,3430,0,0,0,0,9300,PROJECT DELAYED DUE TO CHANGES IN SCOPE/DESIGN,,CUNY ASAP EXPANSION,cpd11-20qn.pdf
CL018-015,Trial Practice Room,042,CITY UNIVERSITY,MISCELLANEOUS RECONSTRUCTION,400,QUEENS,HN-Q300,500,237,1013,0,0,0,0,0,1250,237,1013,0,0,0,0,0,1250,474,2026,0,0,0,0,0,2500,PROJECT DELAYED DUE TO CHANGES IN SCOPE/DESIGN,,TRIAL PRACTICE ROOM,cpd11-20qn.pdf
CL021-018,Renovation of Community Room,042,CITY UNIVERSITY,MISCELLANEOUS RECONSTRUCTION,411,QUEENS,HN-Q300,650,0,0,0,650,0,0,0,650,0,0,0,650,0,0,0,650,0,0,0,1300,0,0,0,1300,PROJECT DELAYED DUE TO CHANGES IN SCOPE/DESIGN,,RENOVATION OF COMMUNITY ROOM,cpd11-20qn.pdf
CL023-019,Worker Educational and Development Center,042,CITY UNIVERSITY,MISCELLANEOUS RECONSTRUCTION,411,QUEENS,HN-Q300,850,0,0,0,850,0,0,0,850,0,0,0,850,0,0,0,850,0,0,0,1700,0,0,0,1700,PROJECT DELAYED DUE TO CHANGES IN SCOPE/DESIGN,,WORKER EDUCATIONAL AND DEVELOPMENT CENTER,cpd11-20qn.pdf
CL024-019,Data Center Fire Suppression System,042,CITY UNIVERSITY,MISCELLANEOUS RECONSTRUCTION,400,QUEENS,HN-D300,1100,0,0,0,1100,0,0,0,1100,0,0,0,1100,0,0,0,1100,0,0,0,2200,0,0,0,2200,PROJECT DELAYED DUE TO CHANGES IN SCOPE/DESIGN,,NON WATERBASED FIRE SUPPRESSION,cpd11-20qn.pdf
KG037-015,Science and Resilience Institute at Jamaica Bay,042,CITY UNIVERSITY,MISCELLANEOUS RECONSTRUCTION,400,QUEENS,HN-0206,7500,0,0,0,0,0,7500,0,7500,0,0,0,0,0,7500,0,7500,0,0,0,0,0,15000,0,15000,PROJECT DELAYED DUE TO CHANGES IN SCOPE/DESIGN,,DESCRIPTION,cpd11-20qn.pdf
LAGUARDIA,LaGuardia Community College Streetscape,042,CITY UNIVERSITY,MISCELLANEOUS,400 402,QUEENS,ED-Q384,400,315,108,0,0,0,0,0,423,315,108,0,0,0,0,0,423,630,216,0,0,0,0,0,846,PROJECT DELAYED DUE TO CHANGES IN SCOPE/DESIGN,,LAGUARDIA COMMUNITY COLLEGE STREETSCAPE,cpd11-20qn.pdf
LG001-021,IT Network Infrastucture Replacements,042,CITY UNIVERSITY,MISCELLANEOUS RECONSTRUCTION,400,QUEENS,HN-D003,3100,0,3100,0,0,0,0,0,3100,0,3100,0,0,0,0,0,3100,0,6200,0,0,0,0,0,6200,,,LAGUARDIA COMMUNITY COLLEGE,cpd11-20qn.pdf
LG002-021,Greenhouse Construction,042,CITY UNIVERSITY,MISCELLANEOUS RECONSTRUCTION,400,QUEENS,HN-D003,75,0,75,0,0,0,0,0,75,0,75,0,0,0,0,0,75,0,150,0,0,0,0,0,150,,,LAGUARDIA COMMUNITY COLLEGE,cpd11-20qn.pdf
LG020-009,NEW LIBRARY SPACE,042,CITY UNIVERSITY,MISCELLANEOUS RECONSTRUCTION,400 402,QUEENS,HN-Q004,5000,7009,0,0,557,0,0,0,7566,7009,0,0,557,0,0,0,7566,14018,0,0,1114,0,0,0,15132,PROJECT DELAYED DUE TO CHANGES IN SCOPE/DESIGN,,RENOVATION AND CONSTRUCTION FOR NEW LIBRARY SPACE,cpd11-20qn.pdf
LG036-014,Library Expansion and HVAC Upgrade,042,CITY UNIVERSITY,MISCELLANEOUS RECONSTRUCTION,400 402,QUEENS,HN-Q004 HN-D004,1000,593,1407,1000,0,0,0,0,3000,593,1407,1000,0,0,0,0,3000,1186,2814,2000,0,0,0,0,6000,PROJECT DELAYED DUE TO CHANGES IN SCOPE/DESIGN,,LIBRARY EXPANSION AND HVAC UPGRADE,cpd11-20qn.pdf
LG040-016,"Center 3 Infrastr. Upgrade, Fitout",042,CITY UNIVERSITY,MISCELLANEOUS RECONSTRUCTION,400,QUEENS,HN-0206,41000,1586,1000,0,0,7000,31414,0,41000,1586,1000,0,0,7000,31414,0,41000,3172,2000,0,0,14000,62828,0,82000,PROJECT DELAYED DUE TO CHANGES IN SCOPE/DESIGN,,"CENTER 3 INFRA. UPGRADE, 5TH & 8TH FOORS FITOUT",cpd11-20qn.pdf
LG041-016,Business and Entrepreneurial Training Center,042,CITY UNIVERSITY,MISCELLANEOUS RECONSTRUCTION,402,QUEENS,HN-Q006 HN-D002 HN-Q004,3400,1115,0,6422,0,0,0,0,7537,1115,0,6422,0,0,0,0,7537,2230,0,12844,0,0,0,0,15074,PROJECT DELAYED DUE TO CHANGES IN SCOPE/DESIGN,,BUSINESS AND ENTREPRENEURIAL TRAINING CENTER,cpd11-20qn.pdf
LG043-018,Shenker Hall Lab Renovation,042,CITY UNIVERSITY,MISCELLANEOUS RECONSTRUCTION,402,QUEENS,HN-Q004 HN-D004,1500,796,0,4304,0,0,0,0,5100,796,0,4304,0,0,0,0,5100,1592,0,8608,0,0,0,0,10200,PROJECT DELAYED DUE TO CHANGES IN SCOPE/DESIGN,,SHENKAR HALL LAB RENOVATION,cpd11-20qn.pdf
LG071-019,Student Success Center,042,CITY UNIVERSITY,MISCELLANEOUS RECONSTRUCTION,402,QUEENS,HN-Q004 HN-D002,5100,0,0,4100,0,0,0,0,4100,0,0,4100,0,0,0,0,4100,0,0,8200,0,0,0,0,8200,PROJECT DELAYED DUE TO BUDGETARY CONSTRAINTS,,RENOVATION TO C BLDG - CENTRALIZEDTUTORIN HUB - 5TH FLR,cpd11-20qn.pdf
LG072-019,Archive Construction,042,CITY UNIVERSITY,MISCELLANEOUS RECONSTRUCTION,400,QUEENS,HN-D002,150,0,0,0,0,150,0,0,150,0,0,0,0,150,0,0,150,0,0,0,0,300,0,0,300,PROJECT DELAYED DUE TO BUDGETARY CONSTRAINTS,,ARCHIVE CONSTRUCTION,cpd11-20qn.pdf
LG073-020,LIBRARY PHASE II CONSTRUCTION,042,CITY UNIVERSITY,MISCELLANEOUS RECONSTRUCTION,402,QUEENS,HN-Q004 HN-D002,9100,0,0,1000,0,8100,0,0,9100,0,0,1000,0,8100,0,0,9100,0,0,2000,0,16200,0,0,18200,,,LIBRARY PHASE II CONSTRUCTION,cpd11-20qn.pdf
LG202-006,Center 3 - 8th Floor and Infrastructure,042,CITY UNIVERSITY,MISCELLANEOUS RECONSTRUCTION,400 402,QUEENS,HN-0206,10500,1500,0,120,0,0,0,0,1620,1500,0,120,0,0,0,0,1620,3000,0,240,0,0,0,0,3240,PROJECT DELAYED DUE TO CHANGES IN SCOPE/DESIGN,,"THIS PROJECT WILL RENOVATE 80,000 GSF OF SPACE ON THE 7TH AND 8TH FLOORS OF CENTER 3 FOR",cpd11-20qn.pdf
QB001-021,ADA Restroom Upgrades,042,CITY UNIVERSITY,MISCELLANEOUS RECONSTRUCTION,400,QUEENS,HN-D004,4106,0,4106,0,0,0,0,0,4106,0,4106,0,0,0,0,0,4106,0,8212,0,0,0,0,0,8212,,,AUXILLARY ENTERPRISE INC.,cpd11-20qn.pdf
QB002-010,Queensborough CC- Bathrooms/Campus Improvements,042,CITY UNIVERSITY,MISCELLANEOUS RECONSTRUCTION,411,QUEENS,HN-0206 HN-Q006 HN-D002 HN-Q004,400,66,1462,0,0,0,0,0,1528,66,1462,0,0,0,0,0,1528,132,2924,0,0,0,0,0,3056,PROJECT DELAYED DUE TO CHANGES IN SCOPE/DESIGN,,QUEENSBOROUGH CC - ART EXHIBIT SPACE BIULD-OUT,cpd11-20qn.pdf
QB045-013,Replace Three Roofs & Renovate Campus Theater,042,CITY UNIVERSITY,MISCELLANEOUS RECONSTRUCTION,400 411,QUEENS,HN-D005,1100,0,0,0,0,109,0,0,109,0,0,0,0,109,0,0,109,0,0,0,0,218,0,0,218,PROJECT DELAYED DUE TO CHANGES IN SCOPE/DESIGN,,REPLACE THREE ROOFS & RENOVATE CAMPUS THEATER,cpd11-20qn.pdf
QB054-016,Refurbishment and Upgrade of Research Labs,042,CITY UNIVERSITY,MISCELLANEOUS RECONSTRUCTION,400,QUEENS,HN-D005 HN-D002,1500,158,0,1442,0,0,0,0,1600,158,0,1442,0,0,0,0,1600,316,0,2884,0,0,0,0,3200,PROJECT DELAYED DUE TO CHANGES IN SCOPE/DESIGN,,REFURBISHMENT & UPGRADE OF RESEARCH LABS,cpd11-20qn.pdf
QB062-020,RFK Gymnasium Ventilation and Air Conditioning,042,CITY UNIVERSITY,MISCELLANEOUS RECONSTRUCTION,400,QUEENS,HN-D002,2200,0,0,300,1900,0,0,0,2200,0,0,300,1900,0,0,0,2200,0,0,600,3800,0,0,0,4400,PROJECT DELAYED DUE TO CHANGES IN SCOPE/DESIGN,,RFK GYMNASIUM VENTILATION AND AIR CONDITIONING,cpd11-20qn.pdf
QB063-020,Theater Upgrades (PHASE II),042,CITY UNIVERSITY,MISCELLANEOUS RECONSTRUCTION,400,QUEENS,HN-D002,250,0,250,0,0,0,0,0,250,0,250,0,0,0,0,0,250,0,500,0,0,0,0,0,500,,,THEATER UPGRADES,cpd11-20qn.pdf
QB200-006,Upgrade Electric System,042,CITY UNIVERSITY,"ELECTRICAL, MECHANICAL AND HVAC SYSTEM UPGRADING",400 411,QUEENS,HN-Q004 HN-D002,500,21050,0,240,0,10,0,0,21300,21050,0,240,0,10,0,0,21300,42100,0,480,0,20,0,0,42600,PROJECT DELAYED DUE TO BUDGETARY CONSTRAINTS,,THIS PROJECT WILL PROVIDE INCREASED ELECTRICAL SERVICE TO ALL BUILDINGS ON CAMPUS BY,cpd11-20qn.pdf
QC001-021,Renovate and Upgrade Lab Spaces,042,CITY UNIVERSITY,MISCELLANEOUS RECONSTRUCTION,400,QUEENS,HN-D300,2225,0,2225,0,0,0,0,0,2225,0,2225,0,0,0,0,0,2225,0,4450,0,0,0,0,0,4450,,,QUEENS COLLEGE,cpd11-20qn.pdf
QC004-013,Library and Classroom Space Upgrades,042,CITY UNIVERSITY,MISCELLANEOUS RECONSTRUCTION,400 407,QUEENS,HN-D300 HN-Q006 HN-Q300,1500,250,0,1754,0,0,0,0,2004,250,0,1754,0,0,0,0,2004,500,0,3508,0,0,0,0,4008,PROJECT DELAYED DUE TO CHANGES IN SCOPE/DESIGN,,LIBRARY AND CLASSROOM SPACE UPGRADES,cpd11-20qn.pdf
QC039-011,Louis Armstrong Visitor's Center,042,CITY UNIVERSITY,MISCELLANEOUS RECONSTRUCTION,400 408,QUEENS,HN-D300,50,0,0,0,50,0,0,0,50,0,0,0,50,0,0,0,50,0,0,0,100,0,0,0,100,PROJECT DELAYED DUE TO CHANGES IN SCOPE/DESIGN,,CREATE LOUIS ARMSTRONG HOUSE MUSEUM VISITORS CENTER,cpd11-20qn.pdf
QC047-013,Kupferberg Renovation,042,CITY UNIVERSITY,MISCELLANEOUS RECONSTRUCTION,400 407,QUEENS,HN-Q300,467,0,0,0,227,0,0,0,227,0,0,0,227,0,0,0,227,0,0,0,454,0,0,0,454,PROJECT DELAYED DUE TO CHANGES IN SCOPE/DESIGN,,ATRIUM RENOVATION,cpd11-20qn.pdf
QC054-015,Speech & Hearing Center Upgrade Ph 2,042,CITY UNIVERSITY,MISCELLANEOUS RECONSTRUCTION,400,QUEENS,HN-Q300,1500,2904,0,0,96,0,0,0,3000,2904,0,0,96,0,0,0,3000,5808,0,0,192,0,0,0,6000,PROJECT DELAYED DUE TO CHANGES IN SCOPE/DESIGN,,SPEECH & HEARING CENTER UPGRADE PH 2,cpd11-20qn.pdf
QC061-016,One Stop Service Center,042,CITY UNIVERSITY,MISCELLANEOUS RECONSTRUCTION,408,QUEENS,HN-Q300 HN-D300,1500,0,0,1500,0,0,0,0,1500,0,0,1500,0,0,0,0,1500,0,0,3000,0,0,0,0,3000,PROJECT DELAYED DUE TO CHANGES IN SCOPE/DESIGN,,SERVICE CENTER CONSTRUCTION,cpd11-20qn.pdf
QC061-017,One Stop Center,042,CITY UNIVERSITY,MISCELLANEOUS RECONSTRUCTION,400,QUEENS,HN-D300,1326,0,0,1326,0,0,0,0,1326,0,0,1326,0,0,0,0,1326,0,0,2652,0,0,0,0,2652,PROJECT DELAYED DUE TO CHANGES IN SCOPE/DESIGN,,ONE STOP CENTER,cpd11-20qn.pdf
QC065-017,Recording Studio Renovation in the Music Bldg,042,CITY UNIVERSITY,MISCELLANEOUS RECONSTRUCTION,400,QUEENS,HN-Q300,1000,161,0,0,839,0,0,0,1000,161,0,0,839,0,0,0,1000,322,0,0,1678,0,0,0,2000,PROJECT DELAYED DUE TO BUDGETARY CONSTRAINTS,,RECORDING STUDIO RENOVATION IN THE MUSIC BLDG,cpd11-20qn.pdf
QC066-017,Digital Film Center Construction,042,CITY UNIVERSITY,MISCELLANEOUS RECONSTRUCTION,400,QUEENS,HN-D300,2000,246,0,0,0,1754,0,0,2000,246,0,0,0,1754,0,0,2000,492,0,0,0,3508,0,0,4000,PROJECT DELAYED DUE TO BUDGETARY CONSTRAINTS,,DIGITAL FILM CENTER CONSTRUCTION,cpd11-20qn.pdf
QC069-018,Library Phase III Upgrade,042,CITY UNIVERSITY,MISCELLANEOUS RECONSTRUCTION,411,QUEENS,HN-Q300 HN-D300,3300,0,0,3300,0,0,0,0,3300,0,0,3300,0,0,0,0,3300,0,0,6600,0,0,0,0,6600,PROJECT DELAYED DUE TO BUDGETARY CONSTRAINTS,,LIBRARY PHASE III UPGRADE,cpd11-20qn.pdf
QC070-018,Psychology and Digital Photography Labs,042,CITY UNIVERSITY,MISCELLANEOUS RECONSTRUCTION,400,QUEENS,HN-D300,1900,0,0,0,0,1900,0,0,1900,0,0,0,0,1900,0,0,1900,0,0,0,0,3800,0,0,3800,PROJECT DELAYED DUE TO BUDGETARY CONSTRAINTS,,PSYCHOLOGY AND DIGITAL PHOTOGRAPHY LABS,cpd11-20qn.pdf
QC072-019,Renovation of Rathaus Hall Arts Center,042,CITY UNIVERSITY,MISCELLANEOUS RECONSTRUCTION,400 407,QUEENS,HN-Q300,3200,0,0,0,2200,0,0,0,2200,0,0,0,2200,0,0,0,2200,0,0,0,4400,0,0,0,4400,PROJECT DELAYED DUE TO CHANGES IN SCOPE/DESIGN,,RENOVATION OF RATHAUS HALL ARTS CENTER,cpd11-20qn.pdf
QC074-019,Biology Core Facility Upgrade,042,CITY UNIVERSITY,MISCELLANEOUS RECONSTRUCTION,400,QUEENS,HN-D300,1450,0,0,0,1450,0,0,0,1450,0,0,0,1450,0,0,0,1450,0,0,0,2900,0,0,0,2900,PROJECT DELAYED DUE TO BUDGETARY CONSTRAINTS,,BIOLOGY CORE FACILITY UPGRADE,cpd11-20qn.pdf
QC075-020,Colden Auditorium Renovation and Upgrades,042,CITY UNIVERSITY,MISCELLANEOUS RECONSTRUCTION,411,QUEENS,HN-Q300,1000,0,0,0,1000,0,0,0,1000,0,0,0,1000,0,0,0,1000,0,0,0,2000,0,0,0,2000,PROJECT DELAYED DUE TO CHANGES IN SCOPE/DESIGN,,GOLDEN AUDITORIUM RENOVATION AND UPGRADES,cpd11-20qn.pdf
QC076-020,Air Pollution Laboratory-Commoner Center,042,CITY UNIVERSITY,MISCELLANEOUS RECONSTRUCTION,400,QUEENS,HN-D300,1000,0,0,0,1000,0,0,0,1000,0,0,0,1000,0,0,0,1000,0,0,0,2000,0,0,0,2000,,,AIR POLLUTION LABORATORY-COMMONER CENTER,cpd11-20qn.pdf
QC077-020,Remsen Hall Science Bldg Upgrades,042,CITY UNIVERSITY,MISCELLANEOUS RECONSTRUCTION,400,QUEENS,HN-D300,500,0,0,0,0,500,0,0,500,0,0,0,0,500,0,0,500,0,0,0,0,1000,0,0,1000,PROJECT DELAYED DUE TO CHANGES IN SCOPE/DESIGN,,REMSEN HALL SCIENCE BLDG UPGRADES,cpd11-20qn.pdf
QC078-020,Construction of a Student Engagement and learning Ctr.,042,CITY UNIVERSITY,MISCELLANEOUS RECONSTRUCTION,400,QUEENS,HN-D300,2500,0,0,0,2500,0,0,0,2500,0,0,0,2500,0,0,0,2500,0,0,0,5000,0,0,0,5000,,,CONSTRUCTION OF A STUDENT ENGAGEMENT AND LEARNING CENTER,cpd11-20qn.pdf
QC079-020,Louis Armstrong House - Theater Lighting and Sound Systems,042,CITY UNIVERSITY,MISCELLANEOUS RECONSTRUCTION,400,QUEENS,HN-Q300,500,0,500,0,0,0,0,0,500,0,500,0,0,0,0,0,500,0,1000,0,0,0,0,0,1000,,,LOUIS ARMSTRONG HOUSE-THEATER LIGHTING AND SOUND SYSTEMS,cpd11-20qn.pdf
YC001-010,YORK COLLEGE - DISABLED ACCESS UPGRADE,042,CITY UNIVERSITY,MISCELLANEOUS RECONSTRUCTION,400 412,QUEENS,HN-D300,448,0,0,448,0,0,0,0,448,0,0,448,0,0,0,0,448,0,0,896,0,0,0,0,896,PROJECT DELAYED DUE TO CHANGES IN SCOPE/DESIGN,,DISABLED ACCESS UPGRADE,cpd11-20qn.pdf
YC001-021,Track & Field Renovations,042,CITY UNIVERSITY,MISCELLANEOUS RECONSTRUCTION,400,QUEENS,HN-D300,2000,0,2000,0,0,0,0,0,2000,0,2000,0,0,0,0,0,2000,0,4000,0,0,0,0,0,4000,,,TRACK & FIELD RENOVATIONS,cpd11-20qn.pdf
YC022-007,Financial Aid Office Renovation,042,CITY UNIVERSITY,MISCELLANEOUS RECONSTRUCTION,411,QUEENS,HN-D300,411,0,0,0,411,0,0,0,411,0,0,0,411,0,0,0,411,0,0,0,822,0,0,0,822,PROJECT DELAYED DUE TO BUDGETARY CONSTRAINTS,,FINANCIAL AID OFFICE RENOVATION,cpd11-20qn.pdf
YC025-008,SCIENCE FACILITY UPGRADES,042,CITY UNIVERSITY,DATA PROCESSING AND OTHER EQUIPMENT,,QUEENS,HN-D300 HN-Q300,3372,3297,0,74,0,0,0,0,3371,3297,0,74,0,0,0,0,3371,6594,0,148,0,0,0,0,6742,PROJECT DELAYED DUE TO CHANGES IN SCOPE/DESIGN,,,cpd11-20qn.pdf
YC027-008,"EXTERIOR BEAUTIFICATION, YORK COLLEGE",042,CITY UNIVERSITY,MISCELLANEOUS RECONSTRUCTION,400 412,QUEENS,HN-Q006,3698,0,0,0,199,0,0,0,199,0,0,0,199,0,0,0,199,0,0,0,398,0,0,0,398,PROJECT DELAYED DUE TO CHANGES IN SCOPE/DESIGN,,EXTERIOR BEAUTIFICATION,cpd11-20qn.pdf
YC028-008,IMPROVEMENTS TO THE PERFORMING ARTS CENTER,042,CITY UNIVERSITY,MISCELLANEOUS RECONSTRUCTION,,QUEENS,HN-Q300,145,0,0,0,145,0,0,0,145,0,0,0,145,0,0,0,145,0,0,0,290,0,0,0,290,PROJECT DELAYED DUE TO BUDGETARY CONSTRAINTS,,IMPROVEMENTS TO THE PERFORMING ARTS CENTER,cpd11-20qn.pdf
YC035-011,New Media Lecture Hall,042,CITY UNIVERSITY,MISCELLANEOUS RECONSTRUCTION,400 412,QUEENS,HN-Q300 HN-D300,1700,2903,83,0,0,0,0,0,2986,2903,83,0,0,0,0,0,2986,5806,166,0,0,0,0,0,5972,PROJECT DELAYED DUE TO CHANGES IN SCOPE/DESIGN,,CONVERT LECTURE HALL TO MULTIMEDIA LECTURE HALL,cpd11-20qn.pdf
YC043-013,Daycare Facility Improvements,042,CITY UNIVERSITY,MISCELLANEOUS RECONSTRUCTION,400 412,QUEENS,HN-D300,150,0,0,0,150,0,0,0,150,0,0,0,150,0,0,0,150,0,0,0,300,0,0,0,300,PROJECT DELAYED DUE TO CHANGES IN SCOPE/DESIGN,,TO INCLUDE LEAP FROG ACADEMY WITHIN DAYCARE FACILITY,cpd11-20qn.pdf
YC049-014,Renovate/Build 3D Graphics and Printing Lab,042,CITY UNIVERSITY,MISCELLANEOUS RECONSTRUCTION,400 412,QUEENS,HN-D300,200,0,0,0,0,200,0,0,200,0,0,0,0,200,0,0,200,0,0,0,0,400,0,0,400,PROJECT DELAYED DUE TO CHANGES IN SCOPE/DESIGN,,RENOVATE/BUILD 3D GRAPHICS AND PRINTING LAB,cpd11-20qn.pdf
YC051-015,Performing Arts Center Renovations,042,CITY UNIVERSITY,MISCELLANEOUS RECONSTRUCTION,400,QUEENS,HN-D300,2800,0,0,484,0,0,0,0,484,0,0,484,0,0,0,0,484,0,0,968,0,0,0,0,968,PROJECT DELAYED DUE TO CHANGES IN SCOPE/DESIGN,,PERFORMING ARTS CENTER RENOVATIONS,cpd11-20qn.pdf
YC052-016,Laboratory and Classroom Upgrades,042,CITY UNIVERSITY,MISCELLANEOUS RECONSTRUCTION,412,QUEENS,HN-Q300 HN-D300,1000,2016,0,0,1968,0,0,0,3984,2016,0,0,1968,0,0,0,3984,4032,0,0,3936,0,0,0,7968,PROJECT DELAYED DUE TO CHANGES IN SCOPE/DESIGN,,LABORATORY AND CLASSROOM UPGRADES,cpd11-20qn.pdf
YC054-017,Greenhouse Renovation,042,CITY UNIVERSITY,MISCELLANEOUS RECONSTRUCTION,400,QUEENS,HN-Q300,640,0,0,640,0,0,0,0,640,0,0,640,0,0,0,0,640,0,0,1280,0,0,0,0,1280,PROJECT DELAYED DUE TO CHANGES IN SCOPE/DESIGN,,GREENHOUSE RENOVATION,cpd11-20qn.pdf
YC055-017,Digital Convergence Center,042,CITY UNIVERSITY,MISCELLANEOUS RECONSTRUCTION,400,QUEENS,HN-D300,2000,0,0,0,0,2000,0,0,2000,0,0,0,0,2000,0,0,2000,0,0,0,0,4000,0,0,4000,PROJECT DELAYED DUE TO CHANGES IN SCOPE/DESIGN,,DIGITAL CONVERGENCE CENTER,cpd11-20qn.pdf
YC059-019,Renonvation to Track,042,CITY UNIVERSITY,MISCELLANEOUS RECONSTRUCTION,411,QUEENS,HN-Q300 HN-D300 HN-0300,1700,0,1811,930,105,0,0,0,2846,0,1811,930,105,0,0,0,2846,0,3622,1860,210,0,0,0,5692,PROJECT DELAYED DUE TO CHANGES IN SCOPE/DESIGN,,RENONVATION TO TRACK,cpd11-20qn.pdf
YC061-020,Performing Arts Center Upgrades,042,CITY UNIVERSITY,MISCELLANEOUS RECONSTRUCTION,411,QUEENS,HN-Q300 HN-D300,9105,7028,0,2077,0,0,0,0,9105,7028,0,2077,0,0,0,0,9105,14056,0,4154,0,0,0,0,18210,,,,cpd11-20qn.pdf
YC063-020,Recapture Academic Space,042,CITY UNIVERSITY,MISCELLANEOUS RECONSTRUCTION,400,QUEENS,HN-D300,2000,0,0,0,2000,0,0,0,2000,0,0,0,2000,0,0,0,2000,0,0,0,4000,0,0,0,4000,,,RECAPTURE ACADEMIC SPACE,cpd11-20qn.pdf
ACENYP601,NYPD - Old Police Academy Steam Trap Replacement,056,POLICE DEPARTMENT,"BUILDING CONSTRUCTION, RECONSTRUCTION OR RETROFIT",402,QUEENS,PU-0025,158,0,0,144,0,0,0,0,144,0,0,144,0,0,0,0,144,0,0,288,0,0,0,0,288,PROJECT DELAYED DUE TO CHANGES IN SCOPE/DESIGN,,NYPD - CENTRAL MOTOR REPAIR,cpd11-20qn.pdf
ACEPOL701,NYPD - CRS STEAM TRAP REPLACEMENT,056,POLICE DEPARTMENT,"BUILDING CONSTRUCTION, RECONSTRUCTION OR RETROFIT",401,QUEENS,PU-0025,135,0,135,0,0,0,0,0,135,0,135,0,0,0,0,0,135,0,270,0,0,0,0,0,270,PROJECT DELAYED DUE TO CHANGES IN SCOPE/DESIGN,,NYPD - CRS STEAM TRAP REPLACEMENT,cpd11-20qn.pdf
ACEPOL901,NYPD - Chiller Replacement at 10 NYPD Precincts,056,POLICE DEPARTMENT,"BUILDING CONSTRUCTION, RECONSTRUCTION OR RETROFIT",401,QUEENS,PO-0079 PU-0025,3179,0,216,2713,0,0,0,0,2929,0,216,2713,0,0,0,0,2929,0,432,5426,0,0,0,0,5858,PROJECT DELAYED DUE TO CHANGES IN SCOPE/DESIGN,,NYPD - CHILLER REPLACEMENT AT 10 NYPD PRECINCTS,cpd11-20qn.pdf
PO79BMAHH,HWY # 3 SEPTIC TANK,056,POLICE DEPARTMENT,POLICE FACILITIES,400,QUEENS,PO-0079,98,0,98,0,0,0,0,0,98,0,98,0,0,0,0,0,98,0,196,0,0,0,0,0,196,PROJECT DELAYED DUE TO CHANGES IN SCOPE/DESIGN,198-15 GRAND CENTRAL QUEENS,NEW SEPTIC TANK,cpd11-20qn.pdf
PO79BMAHM,101ST PCT HANDICAP RAMP,056,POLICE DEPARTMENT,POLICE FACILITIES,400,QUEENS,PO-0079,50,0,62,738,0,0,0,0,800,0,62,738,0,0,0,0,800,0,124,1476,0,0,0,0,1600,PROJECT DELAYED DUE TO CHANGES IN SCOPE/DESIGN,"16-12 MOTT AV, FAR ROCKWAY QUEENS NY",HANDICAP RAMP,cpd11-20qn.pdf
PO79BMAIF,110TH FACADE,056,POLICE DEPARTMENT,POLICE FACILITIES,400,QUEENS,PO-0079,259,0,259,0,0,0,0,0,259,0,259,0,0,0,0,0,259,0,518,0,0,0,0,0,518,PROJECT DELAYED DUE TO CHANGES IN SCOPE/DESIGN,110TH PCT,FACADE REHAB,cpd11-20qn.pdf
PO79BMAII,FACADE AT NYPD'S FORENSIC LABORATORY,056,POLICE DEPARTMENT,POLICE FACILITIES,400,QUEENS,PO-0079,67,0,215,2200,0,0,0,0,2415,0,215,2200,0,0,0,0,2415,0,430,4400,0,0,0,0,4830,PROJECT DELAYED DUE TO UNFORESEEN SITE/FIELD CONDITION,POLICE LAB,FACADE,cpd11-20qn.pdf
PO79BMAIJ,106th pct FACADE,056,POLICE DEPARTMENT,POLICE FACILITIES,400,QUEENS,PO-0079,790,0,310,480,0,0,0,0,790,0,310,480,0,0,0,0,790,0,620,960,0,0,0,0,1580,PROJECT DELAYED DUE TO CHANGES IN SCOPE/DESIGN,106TH PCT,FACADE,cpd11-20qn.pdf
PO79BMAKB,REPLACEMENT OF GASOLINE PIPES AT HARBOR GEORGE,056,POLICE DEPARTMENT,POLICE FACILITIES,400,QUEENS,PO-0079,135,23,112,0,0,0,0,0,135,23,112,0,0,0,0,0,135,46,224,0,0,0,0,0,270,,,ESTIMATE,cpd11-20qn.pdf
PO79BMAKH,SRG4 BATHROOM RENOVATION,056,POLICE DEPARTMENT,POLICE FACILITIES,400,QUEENS,PO-0079,884,0,884,0,0,0,0,0,884,0,884,0,0,0,0,0,884,0,1768,0,0,0,0,0,1768,,,ESTIMATE,cpd11-20qn.pdf
PO79BMAKZ,MOUNTED TROOP F AUGER COMPACTOR AND CONCRETE PAD,056,POLICE DEPARTMENT,POLICE FACILITIES,400,QUEENS,PO-0079,0,0,124,0,0,0,0,0,124,0,124,0,0,0,0,0,124,0,248,0,0,0,0,0,248,,,SCOPE DESCRIPTION,cpd11-20qn.pdf
PO79FTTIL,K9 RELOCATION FROM BAT TO FORT TILDEN,056,POLICE DEPARTMENT,POLICE FACILITIES,400,QUEENS,PO-0079 ED-0373,0,0,1010,0,7946,0,0,0,8956,0,1010,0,7946,0,0,0,8956,0,2020,0,15892,0,0,0,17912,,,SCOPE DESCRIPTION,cpd11-20qn.pdf
PO79-MED,MEDICAL DIVISION RELOCATION,056,POLICE DEPARTMENT,POLICE FACILITIES,400,QUEENS,PO-0079,1398,0,193,2060,0,0,0,0,2253,0,193,2060,0,0,0,0,2253,0,386,4120,0,0,0,0,4506,,,ESTIMATE,cpd11-20qn.pdf
POD106COM,106TH PCT - UPGRADE COMMUNITY ROOM,056,POLICE DEPARTMENT,POLICE FACILITIES,400,QUEENS,PO-D001,75,0,75,0,0,0,0,0,75,0,75,0,0,0,0,0,75,0,150,0,0,0,0,0,150,PROJECT DELAYED DUE TO CHANGES IN SCOPE/DESIGN,,RENOVATION,cpd11-20qn.pdf
POD115PRK,Parking Lot - 115th Precinct,056,POLICE DEPARTMENT,POLICE FACILITIES,400,QUEENS,PO-D079,185,0,185,0,0,0,0,0,185,0,185,0,0,0,0,0,185,0,370,0,0,0,0,0,370,,,COST ESTIMATE,cpd11-20qn.pdf
PO-Q106,106th Precinct Renovation,056,POLICE DEPARTMENT,POLICE FACILITIES,400,QUEENS,PO-Q079,1000,0,0,1000,0,0,0,0,1000,0,0,1000,0,0,0,0,1000,0,0,2000,0,0,0,0,2000,,,RENOVATION,cpd11-20qn.pdf
PO-Q107,107th Precinct Renovation,056,POLICE DEPARTMENT,POLICE FACILITIES,400,QUEENS,PO-0079,1295,1295,193,0,0,0,0,0,1488,1295,193,0,0,0,0,0,1488,2590,386,0,0,0,0,0,2976,,107TH PCT,RENOVATION,cpd11-20qn.pdf
PO-Q109,109th Precinct Locker Room Upgrade,056,POLICE DEPARTMENT,POLICE FACILITIES,400,QUEENS,PO-Q079,50,0,50,0,0,0,0,0,50,0,50,0,0,0,0,0,50,0,100,0,0,0,0,0,100,,,RECONSTRUCTION OF THE LOCKER ROOM AT THE 109TH PRECINCT,cpd11-20qn.pdf
SANDCD08,TRANSIT DISTRICT 23 ELECTRICAL,056,POLICE DEPARTMENT,POLICE FACILITIES,400,QUEENS,PO-0079,854,7,79,0,0,0,0,0,86,7,79,0,0,0,0,0,86,14,158,0,0,0,0,0,172,PROJECT DELAYED DUE TO UNFORESEEN SITE/FIELD CONDITION,,ELECTRICAL REHABILITATION,cpd11-20qn.pdf
SANDCD10,HARBOR GEORGE,056,POLICE DEPARTMENT,POLICE FACILITIES,400,QUEENS,PO-0079,748,9,66,0,0,0,0,0,75,9,66,0,0,0,0,0,75,18,132,0,0,0,0,0,150,PROJECT DELAYED DUE TO UNFORESEEN SITE/FIELD CONDITION,HARBOR GEORGE,ELECTRICAL SYTEM REHABILITATION,cpd11-20qn.pdf
ACEFDN702,FDNY - LED LIGHTING UPGRADE AT FLEET SERVICES FACILITY 35ST,057,FIRE DEPARTMENT,"BUILDING CONSTRUCTION, RECONSTRUCTION OR RETROFIT",401,QUEENS,PU-0025,1380,1320,60,0,0,0,0,0,1380,1320,60,0,0,0,0,0,1380,2640,120,0,0,0,0,0,2760,,,FDNY - LED LIGHTING UPGRADE AT FLEET SERVICES FACILITY AT 35TH ST LIC,cpd11-20qn.pdf
ACEFDN704,FDNY - DESIGN & INSTALLATION OF 97 KW SOLAR SYSTEMS AT EMS45,057,FIRE DEPARTMENT,"BUILDING CONSTRUCTION, RECONSTRUCTION OR RETROFIT",401,QUEENS,PU-0025,386,44,783,0,0,0,0,0,827,44,783,0,0,0,0,0,827,88,1566,0,0,0,0,0,1654,,,FDNY - DESIGN & INSTALLATION OF 97 KW SOLAR PHOTOVOLTAIC SYSTEMS AT EMS45,cpd11-20qn.pdf
ACEFDN802,FDNY - Lighting upgrades at 15 buildings at FDNY center,057,FIRE DEPARTMENT,"BUILDING CONSTRUCTION, RECONSTRUCTION OR RETROFIT",401,QUEENS,PU-0025,1262,0,0,1291,0,0,0,0,1291,0,0,1291,0,0,0,0,1291,0,0,2582,0,0,0,0,2582,,,LIGHTING UPGRADES AT 15 BUILDINGS AT FDNY TRAINING CENTER FORT TOTTEN,cpd11-20qn.pdf
F175FMHVC,FLEET MAINTENANCE HVAC SYSTEM UPGRADE,057,FIRE DEPARTMENT,NEW FACILITIES AND RENOVATIONS,402,QUEENS,F-0175,3321,357,0,0,3023,0,0,0,3380,357,0,0,3023,0,0,0,3380,714,0,0,6046,0,0,0,6760,PROJECT DELAYED DUE TO BUDGETARY CONSTRAINTS,,FLEET MAINTENANCE HVAC SYSTEM UPGRADE,cpd11-20qn.pdf
F175MC266,Multi-Component Renovations - EC266,057,FIRE DEPARTMENT,NEW FACILITIES AND RENOVATIONS,414,QUEENS,F-0175,6014,776,0,0,5235,2114,0,0,8125,776,0,0,5235,2114,0,0,8125,1552,0,0,10470,4228,0,0,16250,,,MULTI-COMPONENT RENOVATIONS - EC266,cpd11-20qn.pdf
F175MC304,Multi-Component Renovations - EC304,057,FIRE DEPARTMENT,NEW FACILITIES AND RENOVATIONS,413,QUEENS,F-0175,4556,556,0,0,4000,0,0,0,4556,556,0,0,4000,0,0,0,4556,1112,0,0,8000,0,0,0,9112,PROJECT DELAYED DUE TO BUDGETARY CONSTRAINTS,,MULTI-COMPONENT RENOVATIONS - EC304,cpd11-20qn.pdf
F175MC307,Multi-Component Renovations - EC307,057,FIRE DEPARTMENT,NEW FACILITIES AND RENOVATIONS,403,QUEENS,F-0175,7535,791,0,0,6750,0,0,0,7541,791,0,0,6750,0,0,0,7541,1582,0,0,13500,0,0,0,15082,PROJECT DELAYED DUE TO BUDGETARY CONSTRAINTS,,MULTI-COMPONENT RENOVATIONS - EC307,cpd11-20qn.pdf
F175WN266,WINDOW REPLACEMENT - EC266,057,FIRE DEPARTMENT,NEW FACILITIES AND RENOVATIONS,414,QUEENS,F-0175,480,0,0,0,400,0,0,0,400,0,0,0,400,0,0,0,400,0,0,0,800,0,0,0,800,PROJECT DELAYED DUE TO BUDGETARY CONSTRAINTS,,WINDOW REPLACEMENT - EC266,cpd11-20qn.pdf
F175WN329,WINDOW REPLACEMENT - EC329,057,FIRE DEPARTMENT,NEW FACILITIES AND RENOVATIONS,414,QUEENS,F-0175,480,0,0,0,400,0,0,0,400,0,0,0,400,0,0,0,400,0,0,0,800,0,0,0,800,PROJECT DELAYED DUE TO BUDGETARY CONSTRAINTS,,WINDOW REPLACEMENT - EC329,cpd11-20qn.pdf
F175WP301,Waterproofing - EC301,057,FIRE DEPARTMENT,NEW FACILITIES AND RENOVATIONS,412,QUEENS,F-0175,4122,562,0,0,3620,0,0,0,4182,562,0,0,3620,0,0,0,4182,1124,0,0,7240,0,0,0,8364,PROJECT DELAYED DUE TO BUDGETARY CONSTRAINTS,,WATERPROOFING - EC301,cpd11-20qn.pdf
F175WP303,Waterproofing - EC303,057,FIRE DEPARTMENT,NEW FACILITIES AND RENOVATIONS,412,QUEENS,F-0175,3041,394,0,0,2650,0,0,0,3044,394,0,0,2650,0,0,0,3044,788,0,0,5300,0,0,0,6088,PROJECT DELAYED DUE TO BUDGETARY CONSTRAINTS,,WATERPROOFING - EC303,cpd11-20qn.pdf
F175WP325,Roofing and Waterproofing - EC325,057,FIRE DEPARTMENT,NEW FACILITIES AND RENOVATIONS,402,QUEENS,F-0175,2172,82,0,2090,0,0,0,0,2172,82,0,2090,0,0,0,0,2172,164,0,4180,0,0,0,0,4344,PROJECT DELAYED DUE TO BUDGETARY CONSTRAINTS,,ROOFING AND WATERPROOFING - EC325,cpd11-20qn.pdf
F1WOODSID,Unmanned Telemetry - Woodside,057,FIRE DEPARTMENT,COMMUNICATIONS,402,QUEENS,F-0001,1500,97,1161,0,0,0,0,0,1258,97,1161,0,0,0,0,0,1258,194,2322,0,0,0,0,0,2516,,,UNMANNED TELEMETRY - WOODSIDE,cpd11-20qn.pdf
FD175D262,Door Replacement - EC262,057,FIRE DEPARTMENT,NEW FACILITIES AND RENOVATIONS,401,QUEENS,F-D175,150,81,69,0,0,0,0,0,150,81,69,0,0,0,0,0,150,162,138,0,0,0,0,0,300,PROJECT DELAYED DUE TO BUDGETARY CONSTRAINTS,,DOOR REPLACEMENT - EC262,cpd11-20qn.pdf
FD175D287,DOOR REPLACEMENT - EC287,057,FIRE DEPARTMENT,NEW FACILITIES AND RENOVATIONS,404,QUEENS,F-D175,150,102,0,0,0,0,0,47,149,102,0,0,0,0,0,47,149,204,0,0,0,0,0,94,298,PROJECT DELAYED DUE TO BUDGETARY CONSTRAINTS,,DOOR REPLACEMENT - EC287,cpd11-20qn.pdf
FD175D316,Door Replacement - EC316,057,FIRE DEPARTMENT,NEW FACILITIES AND RENOVATIONS,403,QUEENS,F-D175,75,0,75,0,0,0,0,0,75,0,75,0,0,0,0,0,75,0,150,0,0,0,0,0,150,,,DOOR REPLACEMENT - EC316,cpd11-20qn.pdf
FD175D324,Door Replacement - EC324,057,FIRE DEPARTMENT,NEW FACILITIES AND RENOVATIONS,404,QUEENS,F-D175,150,91,59,0,0,0,0,0,150,91,59,0,0,0,0,0,150,182,118,0,0,0,0,0,300,PROJECT DELAYED DUE TO BUDGETARY CONSTRAINTS,,DOOR REPLACEMENT - EC324,cpd11-20qn.pdf
FD175G289,Generator - EC289,057,FIRE DEPARTMENT,NEW FACILITIES AND RENOVATIONS,404,QUEENS,F-D175 F-0175,771,102,669,0,0,0,0,0,771,102,669,0,0,0,0,0,771,204,1338,0,0,0,0,0,1542,PROJECT DELAYED DUE TO BUDGETARY CONSTRAINTS,,GENERATOR - EC289,cpd11-20qn.pdf
FD175W316,Window Replacement - EC316,057,FIRE DEPARTMENT,NEW FACILITIES AND RENOVATIONS,403,QUEENS,F-D175,350,0,350,0,0,0,0,0,350,0,350,0,0,0,0,0,350,0,700,0,0,0,0,0,700,,,WINDOW REPLACEMENT - EC316,cpd11-20qn.pdf
FQ175G260,Generator - EC260,057,FIRE DEPARTMENT,NEW FACILITIES AND RENOVATIONS,,QUEENS,F-Q175,750,0,150,600,0,0,0,0,750,0,150,600,0,0,0,0,750,0,300,1200,0,0,0,0,1500,,,INSTALLATION OF NEW BUILDING GENERATOR AT EC260.,cpd11-20qn.pdf
FQ175K307,KITCHEN RENOVATION - EC307,057,FIRE DEPARTMENT,NEW FACILITIES AND RENOVATIONS,403,QUEENS,F-Q175,1200,79,1121,0,0,0,0,0,1200,79,1121,0,0,0,0,0,1200,158,2242,0,0,0,0,0,2400,PROJECT DELAYED DUE TO BUDGETARY CONSTRAINTS,,KITCHEN RENOVATION - EC307,cpd11-20qn.pdf
FQ175W275,Window Replacement EC275,057,FIRE DEPARTMENT,NEW FACILITIES AND RENOVATIONS,412,QUEENS,F-Q175,500,279,0,0,0,0,0,221,500,279,0,0,0,0,0,221,500,558,0,0,0,0,0,442,1000,PROJECT DELAYED DUE TO BUDGETARY CONSTRAINTS,,WINDOW REPLACEMENT AT EC 275,cpd11-20qn.pdf
FQ175WASH,REPLACEMENT OF WASHERS AND DRYERS,057,FIRE DEPARTMENT,NEW FACILITIES AND RENOVATIONS,,QUEENS,F-Q175,1000,0,1000,0,0,0,0,0,1000,0,1000,0,0,0,0,0,1000,0,2000,0,0,0,0,0,2000,,,FDNY DECONTAMINATION FACILITY,cpd11-20qn.pdf
ACEDHS801,DHS - Gas fired condensing hot water systems,071,DEPT OF HOMELESS SERVICES,"BUILDING CONSTRUCTION, RECONSTRUCTION OR RETROFIT",401,QUEENS,PU-0025,115,0,0,0,115,0,0,0,115,0,0,0,115,0,0,0,115,0,0,0,230,0,0,0,230,,,GAS FIRED CONDENSING HOT WATER SYSTEMS FOR DOMESTIC HOT WATER (BRIARWOOD),cpd11-20qn.pdf
HH112BARS,"Shelter at 21-10 Borden Avenue, 11110 - Roof/Skylight Replac",071,DEPT OF HOMELESS SERVICES,SHELTERS FOR HOMELESS INDIVIDUALS,402,QUEENS,HH-0112,6650,384,116,0,0,6000,0,0,6500,384,116,0,0,6000,0,0,6500,768,232,0,0,12000,0,0,13000,,,"SHELTER AT 21-10 BORDEN AVENUE, 11110 - ROOF/SKYLIGHT REPLACEMENT",cpd11-20qn.pdf
HH112BOFW,Borden Avenue Flood Mitigation,071,DEPT OF HOMELESS SERVICES,SHELTERS FOR HOMELESS INDIVIDUALS,,QUEENS,HH-0112,2479,42,0,578,0,0,0,0,620,42,0,578,0,0,0,0,620,84,0,1156,0,0,0,0,1240,,,FLOOD MITIGATION,cpd11-20qn.pdf
HH115BWRF,BRIARWOOD FAMILY RESIDENCE - ROOF AND FACADE UPGRADE,071,DEPT OF HOMELESS SERVICES,SHELTERS FOR HOMELESS FAMILIES,408,QUEENS,HH-0115,1030,83,0,947,0,0,0,0,1030,83,0,947,0,0,0,0,1030,166,0,1894,0,0,0,0,2060,,,BRIARWOOD FAMILY RESIDENCE - ROOF AND FACADE UPGRADE,cpd11-20qn.pdf
HH115JAEX,JAMAICA FAMILY EXTERIOR,071,DEPT OF HOMELESS SERVICES,SHELTERS FOR HOMELESS FAMILIES,412,QUEENS,HH-0115,3250,250,0,3000,0,0,0,0,3250,250,0,3000,0,0,0,0,3250,500,0,6000,0,0,0,0,6500,,,JAMAICA FAMILY EXTERIOR,cpd11-20qn.pdf
HH115SINT,SPRINGFIELD BLD FACADE RECONSTRUCTION,071,DEPT OF HOMELESS SERVICES,SHELTERS FOR HOMELESS FAMILIES,401,QUEENS,HH-0112,576,0,0,48,0,528,0,0,576,0,0,48,0,528,0,0,576,0,0,96,0,1056,0,0,1152,,,FACADE RECONSTRUCTION,cpd11-20qn.pdf
HH115SMEP,SPRINGFIELD BLD BOILER RECONSTRUCTION,071,DEPT OF HOMELESS SERVICES,SHELTERS FOR HOMELESS FAMILIES,401,QUEENS,HH-0112,420,0,420,0,0,0,0,0,420,0,420,0,0,0,0,0,420,0,840,0,0,0,0,0,840,,,BOILER RECONST,cpd11-20qn.pdf
SOLARDHS2,Solar PV system at Borden Avenue facility,071,DEPT OF HOMELESS SERVICES,MISCELLANEOUS ENERGY EFFICIENCY AND SUSTAINABILITY,401,QUEENS,PU-0025,1428,0,0,1313,0,0,0,0,1313,0,0,1313,0,0,0,0,1313,0,0,2626,0,0,0,0,2626,,,"SOLAR PV SYSTEM AT BORDEN AVENUE FACILITY AT 21-10 BORDEN AVENUE, QUEENS",cpd11-20qn.pdf
C101-SEC,PERIMETER SECURITY & CAMERA REPLACEMENT,072,DEPARTMENT OF CORRECTION,BUILDING SYSTEMS AND INFRASTRUCTURE,400,QUEENS,C-0101,1500,0,0,1500,0,0,0,0,1500,0,0,1500,0,0,0,0,1500,0,0,3000,0,0,0,0,3000,,,,cpd11-20qn.pdf
C75SEWR,RECONSTRUCTION OF RI SEWER LINES,072,DEPARTMENT OF CORRECTION,BUILDING SYSTEMS AND INFRASTRUCTURE,400 401,QUEENS,C-0075,1550,2069,500,0,7060,0,0,0,9629,2069,500,0,7060,0,0,0,9629,4138,1000,0,14120,0,0,0,19258,PROJECT DELAYED DUE TO UNFORESEEN SITE/FIELD CONDITION,,RIKER ISLAND SEWER LINES HAVE DETERIORATED AND NEED TO BE RECONSTRUCTED.,cpd11-20qn.pdf
HRCNSJMS2,South Jamaica MSC renovation.,096,HUMAN RESOURCES ADMINISTRATION,SOCIAL SERVICES BUILDINGS,,QUEENS,HR-D002,190,0,0,0,0,190,0,0,190,0,0,0,0,190,0,0,190,0,0,0,0,380,0,0,380,PROJECT DELAYED DUE TO CHANGES IN SCOPE/DESIGN,,RENOVATION OF SOUTH JAMAICA MSC,cpd11-20qn.pdf
HRCNSJMSC,South Jamaica MSC renovation,096,HUMAN RESOURCES ADMINISTRATION,SOCIAL SERVICES BUILDINGS,,QUEENS,HR-D002,250,0,0,0,0,298,0,0,298,0,0,0,0,298,0,0,298,0,0,0,0,596,0,0,596,PROJECT DELAYED DUE TO CHANGES IN SCOPE/DESIGN,,RENOVATION,cpd11-20qn.pdf
AGIPRH,Institute for the Pueroe Rican hispanic,125,DEPARTMENT FOR THE AGING,DEPARTMENT FOR THE AGING BUILDING RECONSTRUCTION,401,QUEENS,AG-D001,0,0,0,180,0,0,0,0,180,0,0,180,0,0,0,0,180,0,0,360,0,0,0,0,360,,,INSTITUTE FOR THE PUEROE RICAN HISPANIC,cpd11-20qn.pdf
AGWOODRE1,Woodside houses new gym for the elderly,125,DEPARTMENT FOR THE AGING,DEPARTMENT FOR THE AGING BUILDING RECONSTRUCTION,401,QUEENS,AG-D001,65,0,0,0,65,0,0,0,65,0,0,0,65,0,0,0,65,0,0,0,130,0,0,0,130,,,WOODSIDE HOUSE NEW GYM FOR THE ELDERLY,cpd11-20qn.pdf
PV040BTH1,FTH - Flushing Town Hall - Bathroom Renovations HLD,126,DEPARTMENT OF CULTURAL AFFAIRS,ESSENTIAL RECONSTRUCTION OF FACILITIES,,QUEENS,PV-Q040 PV-D040 PV-0040,1022,0,0,0,0,1936,0,80,2016,0,0,0,0,1936,0,80,2016,0,0,0,0,3872,0,160,4032,,,RENVATIONS TO BATHROOM IN FTH.,cpd11-20qn.pdf
PV050CYLT,MMI - Courtyard Lighting,126,DEPARTMENT OF CULTURAL AFFAIRS,ESSENTIAL RECONSTRUCTION OF FACILITIES,401,QUEENS,PV-Q050 PV-D050,750,0,0,0,0,957,0,0,957,0,0,0,0,957,0,0,957,0,0,0,0,1914,0,0,1914,PROJECT DELAYED DUE TO CHANGES IN SCOPE/DESIGN,,INSTALLATION OF NEW LIGHTING IN COURTYARD NEEDED FOR SPECIAL EVENTS AND EMERGENCIES.,cpd11-20qn.pdf
PV050ENTR,MMI - Upgrades to Building Entrance,126,DEPARTMENT OF CULTURAL AFFAIRS,ESSENTIAL RECONSTRUCTION OF FACILITIES,,QUEENS,PV-D050,223,0,0,223,0,0,0,0,223,0,0,223,0,0,0,0,223,0,0,446,0,0,0,0,446,,,"UPGRADES TO ENTRANCE INCLUDING FACADE LIGHTING, SIGNAGE INFRASTRUCTURE, DIGITAL KIOSKS",cpd11-20qn.pdf
PV050MECH,MMI - Mechanical Systems Upgrade,126,DEPARTMENT OF CULTURAL AFFAIRS,ESSENTIAL RECONSTRUCTION OF FACILITIES,,QUEENS,PV-D050 PV-Q050 PV-0050,1724,0,0,0,0,2253,0,481,2734,0,0,0,0,2253,0,481,2734,0,0,0,0,4506,0,962,5468,,,"UPGRADES TO HVAC, BMS AND SECURITY SYSTEMS.",cpd11-20qn.pdf
PV272KIDS,QBG - Kids Culture Garden Exhibit,126,DEPARTMENT OF CULTURAL AFFAIRS,ESSENTIAL RECONSTRUCTION OF FACILITIES,,QUEENS,PV-Q272,5133,0,0,0,1250,0,0,0,1250,0,0,0,1250,0,0,0,1250,0,0,0,2500,0,0,0,2500,,43-5- MAIN STREET FLUSHING QUEENS NY,KIDS CULTURE GARDEN PLAY EXHIBIT,cpd11-20qn.pdf
PV274-AH2,NYHOS - New York Hall of Science - Air Handlers Replacement,126,DEPARTMENT OF CULTURAL AFFAIRS,ESSENTIAL RECONSTRUCTION OF FACILITIES,407,QUEENS,PV-0274,4500,0,0,0,0,3950,0,0,3950,0,0,0,0,3950,0,0,3950,0,0,0,0,7900,0,0,7900,,,AIR HANDLERS,cpd11-20qn.pdf
PV274ELV2,NYHOS - New York Hall of Science - Elevator,126,DEPARTMENT OF CULTURAL AFFAIRS,ESSENTIAL RECONSTRUCTION OF FACILITIES,,QUEENS,PV-Q274 PV-0274,1986,0,0,0,0,1765,0,0,1765,0,0,0,0,1765,0,0,1765,0,0,0,0,3530,0,0,3530,,,NYHOS - NEW YORK HALL OF SCIENCE - ELEVATOR,cpd11-20qn.pdf
PV274PERI,"NYHOS - New York Hall of Science, Perimeter Landscaping",126,DEPARTMENT OF CULTURAL AFFAIRS,ESSENTIAL RECONSTRUCTION OF FACILITIES,407,QUEENS,PV-D274 PV-0274,1186,0,0,0,0,1186,600,0,1786,0,0,0,0,1186,600,0,1786,0,0,0,0,2372,1200,0,3572,PROJECT DELAYED DUE TO CHANGES IN SCOPE/DESIGN,,NEW PERIMETER FENCE AND SECURITY CAMERAS.,cpd11-20qn.pdf
PV466BOIL,QTIP - Queens Theater in the Park Boiler,126,DEPARTMENT OF CULTURAL AFFAIRS,ESSENTIAL RECONSTRUCTION OF FACILITIES,400 407,QUEENS,PV-0466 PV-Q466,1041,0,0,1542,0,0,0,0,1542,0,0,1542,0,0,0,0,1542,0,0,3084,0,0,0,0,3084,,,CONSTRUCTION,cpd11-20qn.pdf
PV466QTP,QTIP - Queens Theater in the Park Shulman Theatre Renovation,126,DEPARTMENT OF CULTURAL AFFAIRS,ESSENTIAL RECONSTRUCTION OF FACILITIES,400 407,QUEENS,PV-D466 PV-Q466 PV-0466,2846,0,0,0,0,3445,0,0,3445,0,0,0,0,3445,0,0,3445,0,0,0,0,6890,0,0,6890,PROJECT DELAYED DUE TO CHANGES IN SCOPE/DESIGN,,RENOVATION,cpd11-20qn.pdf
PV501ATTC,PS1 - Attic Renovation for Studios,126,DEPARTMENT OF CULTURAL AFFAIRS,ESSENTIAL RECONSTRUCTION OF FACILITIES,401,QUEENS,PV-D501 PV-Q501 PV-0501 PV-D467,2230,0,0,0,0,4011,620,0,4631,0,0,0,0,4011,620,0,4631,0,0,0,0,8022,1240,0,9262,PROJECT DELAYED DUE TO CHANGES IN SCOPE/DESIGN,,RENOVATION OF PS1'S ATTIC SPACE AND BASEMENT TO CREATE ARTISTS STUDIOS AND EDUCATION,cpd11-20qn.pdf
PV501ELEV,PS1 - Elevator Renovation,126,DEPARTMENT OF CULTURAL AFFAIRS,ESSENTIAL RECONSTRUCTION OF FACILITIES,401,QUEENS,PV-0501,563,0,0,0,0,0,500,0,500,0,0,0,0,0,500,0,500,0,0,0,0,0,1000,0,1000,,,CONSTRUCTION,cpd11-20qn.pdf
PV501-PS1,PS1 - Acquisition for studio and gallery space,126,DEPARTMENT OF CULTURAL AFFAIRS,ESSENTIAL RECONSTRUCTION OF FACILITIES,402,QUEENS,PV-D501 PV-Q501 PV-0501,4000,0,0,0,0,5000,2500,0,7500,0,0,0,0,5000,2500,0,7500,0,0,0,0,10000,5000,0,15000,PROJECT DELAYED PENDING RESOLUTION OF LEGAL ISSUES,,ACQUISITION,cpd11-20qn.pdf
PV501ROOF,PS1 - Renovation of PS1 Roof Areas PH 2,126,DEPARTMENT OF CULTURAL AFFAIRS,ESSENTIAL RECONSTRUCTION OF FACILITIES,402,QUEENS,PV-D501 PV-Q501 PV-0501,3500,0,0,0,0,3500,0,0,3500,0,0,0,0,3500,0,0,3500,0,0,0,0,7000,0,0,7000,,,"RENOVATION OF PS1 ROOF AREAS, SUBSEQUENT PHASE OF PS1'S ROOF ACCESS AND ATTIC PROJECT",cpd11-20qn.pdf
PV501RPH1,PS1 - Renovation of PS1 Roof Areas PH 1,126,DEPARTMENT OF CULTURAL AFFAIRS,ESSENTIAL RECONSTRUCTION OF FACILITIES,402,QUEENS,PV-Q501 PV-D501,0,0,0,0,0,1111,0,0,1111,0,0,0,0,1111,0,0,1111,0,0,0,0,2222,0,0,2222,,,ROOF RENOVATION,cpd11-20qn.pdf
PV502ELEV,JCAL - Elevator Reconstruction/Modernization Section,126,DEPARTMENT OF CULTURAL AFFAIRS,ESSENTIAL RECONSTRUCTION OF FACILITIES,412,QUEENS,PV-Q502 PV-D502 PV-0502,3217,0,0,306,0,1453,1119,0,2878,0,0,306,0,1453,1119,0,2878,0,0,612,0,2906,2238,0,5756,,,ELEVATOR UPGRADES,cpd11-20qn.pdf
PV502-SDW,JCAL - JPAC Outdoor Performance Space & Sidewals,126,DEPARTMENT OF CULTURAL AFFAIRS,ESSENTIAL RECONSTRUCTION OF FACILITIES,412,QUEENS,PV-D502 PV-Q502 PV-0502,2443,0,0,0,0,1245,927,0,2172,0,0,0,0,1245,927,0,2172,0,0,0,0,2490,1854,0,4344,,,CONSTRUCTION,cpd11-20qn.pdf
BEACH20,Beach 20th St. Plaza Improvements,801,DEPT OF SMALL BUSINESS SERVICES,COMMUNITY DEVELOPMENT,400 414,QUEENS,ED-Q384,811,1186,0,0,0,0,0,41,1227,1186,0,0,0,0,0,41,1227,2372,0,0,0,0,0,82,2454,PROJECT DELAYED DUE TO CHANGES IN SCOPE/DESIGN,,BEACH 20TH ST. PLAZA IMPROVEMENTS,cpd11-20qn.pdf
COLPJFK,JFK Site A (COLLEGE POINT Relocation),801,DEPT OF SMALL BUSINESS SERVICES,PORT DEVELOPMENT,400 407,QUEENS,PO-0079,19002,27247,0,0,0,0,0,299,27546,27247,0,0,0,0,0,299,27546,54494,0,0,0,0,0,598,55092,PROJECT DELAYED DUE TO CHANGES IN SCOPE/DESIGN,,JFK SITE A (COLLEGE POINT RELOCATION),cpd11-20qn.pdf
COLUMBPL,Columbus Plaza,801,DEPT OF SMALL BUSINESS SERVICES,NEIGHBORHOOD REVITALIZATION,400,QUEENS,ED-0075,1000,0,0,0,0,0,0,1009,1009,0,0,0,0,0,0,1009,1009,0,0,0,0,0,0,2018,2018,PROJECT DELAYED DUE TO CHANGES IN SCOPE/DESIGN,,COLUMBUS PLAZA,cpd11-20qn.pdf
CPCDRAIN,College Point - Drainage Rehab,801,DEPT OF SMALL BUSINESS SERVICES,MISCELLANEOUS,400 407,QUEENS,ED-0075,400,125,0,0,0,0,0,275,400,125,0,0,0,0,0,275,400,250,0,0,0,0,0,550,800,PROJECT DELAYED DUE TO CHANGES IN SCOPE/DESIGN,,COLLEGE POINT - DRAINAGE REHAB,cpd11-20qn.pdf
ECODOCKHC,ECO-DOCK AT HALLETS COVE,801,DEPT OF SMALL BUSINESS SERVICES,MISCELLANEOUS,400,QUEENS,P-Q245 ED-D401 ED-0409,1000,1159,0,2320,0,1521,0,0,5000,1159,0,2320,0,1521,0,0,5000,2318,0,4640,0,3042,0,0,10000,,,ECODOCKHC,cpd11-20qn.pdf
FABARGEHP,FA Barge Replacement - Hunters Point South 5307,801,DEPT OF SMALL BUSINESS SERVICES,MISCELLANEOUS,402,QUEENS,ED-0409,2500,99,0,0,45,0,856,0,1000,99,0,0,45,0,856,0,1000,198,0,0,90,0,1712,0,2000,PROJECT DELAYED DUE TO CHANGES IN SCOPE/DESIGN,,FA BARGE REPLACEMENT - HUNTS POINT 5307,cpd11-20qn.pdf
GRANDAVEE,Grand Ave. Commercial Revitalization,801,DEPT OF SMALL BUSINESS SERVICES,COMMERCIAL DEVELOPMENT,405,QUEENS,ED-D384,500,0,0,0,500,0,0,0,500,0,0,0,500,0,0,0,500,0,0,0,1000,0,0,0,1000,PROJECT DELAYED DUE TO CHANGES IN SCOPE/DESIGN,,GRAND AVE. COMMERCIAL REVITALZATION,cpd11-20qn.pdf
HWQ1186,ROCKAWAY BEACH BULKHEAD,801,DEPT OF SMALL BUSINESS SERVICES,PRIMARY STREET RECONSTRUCTION,400 414,QUEENS,ED-0075 HW-0001Q,21140,25118,0,0,0,0,0,1323,26441,25118,0,0,0,0,0,1323,26441,50236,0,0,0,0,0,2646,52882,PROJECT DELAYED DUE TO CHANGES IN SCOPE/DESIGN,ROCKAWAY BEACH BULKHEAD BETWEEN RIIS PARK & BEACH 116TH ST,ROCKAWAY BEACH BULKHEAD BETWEEN RIIS PARK & BEACH 116TH ST,cpd11-20qn.pdf
HWQ1191,Vernon Boulevard Bulkhead Replacement,801,DEPT OF SMALL BUSINESS SERVICES,PRIMARY STREET RECONSTRUCTION,400,QUEENS,HW-0001Q RE-0025,1750,4543,0,0,0,55,258,153,5009,4543,0,0,0,55,258,153,5009,9086,0,0,0,110,516,306,10018,PROJECT DELAYED DUE TO CHANGES IN SCOPE/DESIGN,VERNON BOULEVARD BULKHEAD REPLACEMENT,VERNON BOULEVARD BULKHEAD REPLACEMENT,cpd11-20qn.pdf
HWQ187A,132nd St Construction - 20th Ave to Linden Place,801,DEPT OF SMALL BUSINESS SERVICES,PRIMARY STREET RECONSTRUCTION,407,QUEENS,HW-1674 HW-0001Q HW-0001 ED-0075 SE-0200Q,7000,15018,997,20646,0,1705,0,919,39285,15018,997,20646,0,1705,0,919,39285,30036,1994,41292,0,3410,0,1838,78570,PROJECT DELAYED DUE TO CHANGES IN SCOPE/DESIGN,,CONSTRUCTION OF 132ND STREET BETWEEN 20TH AVE AND LINDEN PLACE IN THECOLLEGE POINT,cpd11-20qn.pdf
HWQ662D,"Springfield Gardens Residential Area, Reconstruction",801,DEPT OF SMALL BUSINESS SERVICES,PRIMARY STREET RECONSTRUCTION,413,QUEENS,WM-0006 WM-0001 HW-0792 SE-0727 HW-0662,23020,4741,0,0,0,0,0,6110,10851,4741,0,0,0,0,0,6110,10851,9482,0,0,0,0,0,12220,21702,PROJECT DELAYED DUE TO CHANGES IN SCOPE/DESIGN,"SPRINGFIELD GARDENS RESIDENTIAL AREA, RECONSTRUCTION SITE D.","SPRINGFIELD GARDENS RESIDENTIAL AREA, RECONSTRUCTION SITE D.",cpd11-20qn.pdf
HWQ662D1,"Springfield Gardens Residential Area, Reconstruction",801,DEPT OF SMALL BUSINESS SERVICES,PRIMARY STREET RECONSTRUCTION,413,QUEENS,HW-0662 HW-0200 TF-0002 HW-0001Q WM-0001 SE-0005 HW-0C01Q HW-0792,66457,64917,1146,0,0,0,45,460,66568,64917,1146,0,0,0,45,460,66568,129834,2292,0,0,0,90,920,133136,PROJECT DELAYED DUE TO CHANGES IN SCOPE/DESIGN,,SPRINGFIELD GARDENS PHASE D- CONSTRUCTION,cpd11-20qn.pdf
HWQ996,Harper Street Yard Bulkhead Renovation,801,DEPT OF SMALL BUSINESS SERVICES,FACILITY RECONSTRUCTION,400 407,QUEENS,HW-0003,8000,6493,0,0,0,0,0,3476,9969,6493,0,0,0,0,0,3476,9969,12986,0,0,0,0,0,6952,19938,PROJECT DELAYED DUE TO CHANGES IN SCOPE/DESIGN,HARPER STREET YARD BULKHEAD RENOVATION,HARPER STREET YARD BULKHEAD RENOVATION,cpd11-20qn.pdf
HWQWILLET,Willets Point - Van Wyck Improvements,801,DEPT OF SMALL BUSINESS SERVICES,PRIMARY STREET RECONSTRUCTION,400 407,QUEENS,HW-0001Q,61000,0,0,0,0,0,0,61000,61000,0,0,0,0,0,0,61000,61000,0,0,0,0,0,0,122000,122000,PROJECT DELAYED DUE TO CHANGES IN SCOPE/DESIGN,,WILLETS POINT - VAN WYCK IMPROVEMENTS,cpd11-20qn.pdf
JAMAAECT,GDJC - Atlantic Avenue Extension - Construction,801,DEPT OF SMALL BUSINESS SERVICES,COMMERCIAL DEVELOPMENT,400,QUEENS,ED-Q384 HW-0001Q ED-0075,11318,7875,1,0,0,2,0,1969,9847,7875,1,0,0,2,0,1969,9847,15750,2,0,0,4,0,3938,19694,PROJECT DELAYED DUE TO CHANGES IN SCOPE/DESIGN,,GDJC - ATLANTIC AVENUE EXTENSION - CONSTRUCTION INCLUDING PM AND CM FEES.,cpd11-20qn.pdf
JAMCMFEE,GDJC AAE and Station Plaza CM,801,DEPT OF SMALL BUSINESS SERVICES,COMMERCIAL DEVELOPMENT,400 412,QUEENS,ED-0075,6200,158,0,0,0,0,199,0,357,158,0,0,0,0,199,0,357,316,0,0,0,0,398,0,714,PROJECT DELAYED DUE TO CHANGES IN SCOPE/DESIGN,,GJDC AAE AND STATION PLAZA CM,cpd11-20qn.pdf
JAMECODEV,FA - GDJC Transportation Center Intermodal Facilities,801,DEPT OF SMALL BUSINESS SERVICES,SIDEWALK RECONSTRUCTION,400 412,QUEENS,ED-0075,5712,4097,0,0,0,0,0,142,4239,4097,0,0,0,0,0,142,4239,8194,0,0,0,0,0,284,8478,PROJECT DELAYED DUE TO CHANGES IN SCOPE/DESIGN,"JAMAICA, QUEENS","ENVIRONMENTAL STUDIES, PRELIMINARY AND FINAL DESIGN",cpd11-20qn.pdf
JAMSTPLZ,Station Plaza Design & Construction,801,DEPT OF SMALL BUSINESS SERVICES,MISCELLANEOUS,400,QUEENS,HW-0001Q ED-0075,27212,0,250,0,0,0,13375,0,13625,0,250,0,0,0,13375,0,13625,0,500,0,0,0,26750,0,27250,,,STATION PLAZA DESIGN & CONSTRUCTION,cpd11-20qn.pdf
PWD99AERO,FA - College of Aeronautics,801,DEPT OF SMALL BUSINESS SERVICES,MISCELLANEOUS CONSTRUCTION,403,QUEENS,ED-0075,135,0,0,0,0,0,0,3000,3000,0,0,0,0,0,0,3000,3000,0,0,0,0,0,0,6000,6000,PROJECT DELAYED DUE TO CHANGES IN SCOPE/DESIGN,,"NEW LIBRARY, AUDITORIUM, CAFETERIA AND STUDENT CENTER",cpd11-20qn.pdf
QNSPLGA,Queens Plaza Garage,801,DEPT OF SMALL BUSINESS SERVICES,COMMERCIAL DEVELOPMENT,400 401 402,QUEENS,ED-0075,30270,2435,0,0,0,0,0,84,2519,2435,0,0,0,0,0,84,2519,4870,0,0,0,0,0,168,5038,PROJECT DELAYED DUE TO CHANGES IN SCOPE/DESIGN,,QUEENS PLAZA GARAGE,cpd11-20qn.pdf
QUEENSC,Queens Commercial Corridors,801,DEPT OF SMALL BUSINESS SERVICES,COMMERCIAL DEVELOPMENT,400,QUEENS,ED-D075 ED-Q384,1378,172,0,0,300,0,0,500,972,172,0,0,300,0,0,500,972,344,0,0,600,0,0,1000,1944,PROJECT DELAYED DUE TO CHANGES IN SCOPE/DESIGN,QUEENS COMMERCIAL CORRIDORS - PHASE I,QUEENS COMMERCIAL CORRIDORS - PHASE I,cpd11-20qn.pdf
QUEENSCAS,QUEENS COMMERCIAL CORRIDOR AT ASTORIA,801,DEPT OF SMALL BUSINESS SERVICES,MISCELLANEOUS,400,QUEENS,ED-Q384,200,0,200,0,0,0,0,0,200,0,200,0,0,0,0,0,200,0,400,0,0,0,0,0,400,PROJECT DELAYED DUE TO CHANGES IN SCOPE/DESIGN,,QUEENS COMMERCIAL CORRIDOR AT ASTORIA--GREENSPACE AROUND THE CLOCK BETWEEN 30TH,cpd11-20qn.pdf
QUEENSCRK,QUEENS COMMERCIAL CORRIDOR AT ROCKAWAY,801,DEPT OF SMALL BUSINESS SERVICES,MISCELLANEOUS,400,QUEENS,ED-Q384,200,0,200,0,0,0,0,0,200,0,200,0,0,0,0,0,200,0,400,0,0,0,0,0,400,PROJECT DELAYED DUE TO CHANGES IN SCOPE/DESIGN,,"QUEENS COMMERCIAL CORRIDOR AT ROCKAWAY--STREETSCAPE IMPROVEMENTS, INCLUDING",cpd11-20qn.pdf
QUEENSCSA,QUEENS COMMERCIAL CORRIDOR AT ST. ALBANS,801,DEPT OF SMALL BUSINESS SERVICES,MISCELLANEOUS,400,QUEENS,ED-Q384,100,0,100,0,0,0,0,0,100,0,100,0,0,0,0,0,100,0,200,0,0,0,0,0,200,PROJECT DELAYED DUE TO CHANGES IN SCOPE/DESIGN,,QUEENS COMMERCIAL CORRIDOR AT ST. ALBANS--TREES AND PLANTINGS AT THE LOT ON 99TH STREET,cpd11-20qn.pdf
QWESTB,Queens West/Hunter's Point South,801,DEPT OF SMALL BUSINESS SERVICES,COMMERCIAL DEVELOPMENT,402,QUEENS,HD-0211 P-D019 SE-0002Q,86494,52124,0,0,0,0,0,9344,61468,52124,0,0,0,0,0,9344,61468,104248,0,0,0,0,0,18688,122936,PROJECT DELAYED DUE TO CHANGES IN SCOPE/DESIGN,,QUEEN'S WEST/HUNTER'S POINT SOUTH,cpd11-20qn.pdf
QWESTC,Hunters Point South Phase II,801,DEPT OF SMALL BUSINESS SERVICES,MISCELLANEOUS,400,QUEENS,HD-0211 ED-0075,99000,90805,0,0,0,9112,1319,5000,106236,90805,0,0,0,9112,1319,5000,106236,181610,0,0,0,18224,2638,10000,212472,PROJECT DELAYED DUE TO CHANGES IN SCOPE/DESIGN,,HUNTERS POINT SOUTH PHASE II,cpd11-20qn.pdf
ROCKBLVD,FA - Rockaway BLVD,801,DEPT OF SMALL BUSINESS SERVICES,NEIGHBORHOOD REVITALIZATION,400 410 412 413,QUEENS,ED-0075 ED-D384,1000,0,0,0,0,4000,0,0,4000,0,0,0,0,4000,0,0,4000,0,0,0,0,8000,0,0,8000,PROJECT DELAYED DUE TO CHANGES IN SCOPE/DESIGN,,ROCKAWAY BLVD,cpd11-20qn.pdf
ROCKBULK,Rockaway Park Bulkhead Rehabilitation,801,DEPT OF SMALL BUSINESS SERVICES,WATERFRONT DEVELOPMENT,400 414,QUEENS,ED-0409,800,6578,0,0,0,0,573,0,7151,6578,0,0,0,0,573,0,7151,13156,0,0,0,0,1146,0,14302,PROJECT DELAYED DUE TO CHANGES IN SCOPE/DESIGN,,BULKHEAD REHAB,cpd11-20qn.pdf
ROCKINFRA,Rockaways Infrastructure Improvements,801,DEPT OF SMALL BUSINESS SERVICES,NEIGHBORHOOD REVITALIZATION,400,QUEENS,ED-0384,91000,0,0,0,14000,0,5000,60000,79000,0,0,0,14000,0,5000,60000,79000,0,0,0,28000,0,10000,120000,158000,PROJECT DELAYED DUE TO CHANGES IN SCOPE/DESIGN,,ROCKAWAYS INFRASTRUCTURE IMPROVEMENTS,cpd11-20qn.pdf
ROCKOUT,"Rockaway Park, Outfall Improvements",801,DEPT OF SMALL BUSINESS SERVICES,MISCELLANEOUS,400 414,QUEENS,SE-0200Q,840,3797,0,0,0,0,0,159,3956,3797,0,0,0,0,0,159,3956,7594,0,0,0,0,0,318,7912,PROJECT DELAYED DUE TO CHANGES IN SCOPE/DESIGN,,"ROCKAWAY PARK, OUTFALL IMPROVEMENTS",cpd11-20qn.pdf
SANDRLHPS,FA Resiliency - Land Hardening Hunters Point South,801,DEPT OF SMALL BUSINESS SERVICES,MISCELLANEOUS,402,QUEENS,FA-0027,1000,25,119,106,0,0,0,0,250,25,119,106,0,0,0,0,250,50,238,212,0,0,0,0,500,PROJECT DELAYED DUE TO CHANGES IN SCOPE/DESIGN,,FA RESILIENCY - LAND HARDENING HUNTS POINTS,cpd11-20qn.pdf
SSFERRY,South Shore Ferry Site Acquisition,801,DEPT OF SMALL BUSINESS SERVICES,WATERFRONT DEVELOPMENT,400,QUEENS,ED-D075,1250,0,0,0,1750,0,0,0,1750,0,0,0,1750,0,0,0,1750,0,0,0,3500,0,0,0,3500,PROJECT DELAYED DUE TO CHANGES IN SCOPE/DESIGN,,SOUTH SHORE FERRY SITE ACQUISITION,cpd11-20qn.pdf
SSYARDS,Sunnyside Yards,801,DEPT OF SMALL BUSINESS SERVICES,MISCELLANEOUS,400,QUEENS,ED-0075,55000,0,0,0,0,40000,0,0,40000,0,0,0,0,40000,0,0,40000,0,0,0,0,80000,0,0,80000,PROJECT DELAYED DUE TO CHANGES IN SCOPE/DESIGN,,SUNNYSIDE YARDS,cpd11-20qn.pdf
SUNNYARCH,Sunnyside Arch Restoration,801,DEPT OF SMALL BUSINESS SERVICES,NEIGHBORHOOD REVITALIZATION,402,QUEENS,ED-Q384 ED-D075,500,543,0,0,0,85,51,0,679,543,0,0,0,85,51,0,679,1086,0,0,0,170,102,0,1358,PROJECT DELAYED DUE TO CHANGES IN SCOPE/DESIGN,,SUNNYSIDE ARCH RESTORATION,cpd11-20qn.pdf
WILLETDEM,Willets Point Above Grade Demolition,801,DEPT OF SMALL BUSINESS SERVICES,MISCELLANEOUS,400,QUEENS,ED-0075,23425,8684,0,0,0,0,1373,0,10057,8684,0,0,0,0,1373,0,10057,17368,0,0,0,0,2746,0,20114,PROJECT DELAYED DUE TO CHANGES IN SCOPE/DESIGN,,WILLETS POINT ABOVE GRADE DEMOLITION,cpd11-20qn.pdf
WILLETINF,Willets Point Redevelopment Infrastructure,801,DEPT OF SMALL BUSINESS SERVICES,COMMERCIAL DEVELOPMENT,400 407,QUEENS,ED-0075 SE-0200Q,166402,60482,0,0,0,39,4891,0,65412,60482,0,0,0,39,4891,0,65412,120964,0,0,0,78,9782,0,130824,PROJECT DELAYED DUE TO CHANGES IN SCOPE/DESIGN,,WILLETS POINT INFRASTRUCTURE,cpd11-20qn.pdf
WILLETSEN,Willets Point Environmental,801,DEPT OF SMALL BUSINESS SERVICES,COMMERCIAL DEVELOPMENT,400 407,QUEENS,ED-0075,6000,6217,0,0,0,1741,0,0,7958,6217,0,0,0,1741,0,0,7958,12434,0,0,0,3482,0,0,15916,PROJECT DELAYED DUE TO CHANGES IN SCOPE/DESIGN,,WILLETS POINT ENVIRONMENTAL,cpd11-20qn.pdf
WILLTFAOF,FA - Willets Point Phase IA Offsite Infrastructure,801,DEPT OF SMALL BUSINESS SERVICES,MISCELLANEOUS,400,QUEENS,ED-0075,104031,0,43362,64119,0,0,0,0,107481,0,43362,64119,0,0,0,0,107481,0,86724,128238,0,0,0,0,214962,,,FA - WILLETS POINT PHASE IA OFFSITE INFRASTRUCTURE,cpd11-20qn.pdf
WILLTFAON,FA - Willet's Point Onsite Infrastructure,801,DEPT OF SMALL BUSINESS SERVICES,MISCELLANEOUS,400,QUEENS,ED-0075 SE-0200Q,75638,0,32638,17000,0,0,26000,0,75638,0,32638,17000,0,0,26000,0,75638,0,65276,34000,0,0,52000,0,151276,,,FA - WILLETS POINT ONSIDE INFRASTRUCUTRE,cpd11-20qn.pdf
HAM01ASCC,ASTORIA HOUSES - COMMUNITY CENTER UPGRADE,806,HOUSING PRESERVATION AND DEVEL,LOW TO MODERATE INCOME PUBLIC HOUSING UPGRADE,401,QUEENS,HA-0001,500,1272,128,0,0,0,0,0,1400,1272,128,0,0,0,0,0,1400,2544,256,0,0,0,0,0,2800,PROJECT DELAYED DUE TO BUDGETARY CONSTRAINTS,,SENIOR CITIZEN CENTER,cpd11-20qn.pdf
HAM15QNGR,QUEENSBRIDGE NORTH PLAY AREA UPGRADE,806,HOUSING PRESERVATION AND DEVEL,LOW TO MODERATE INCOME PUBLIC HOUSING UPGRADE,401,QUEENS,HA-D001,450,343,107,0,0,0,0,0,450,343,107,0,0,0,0,0,450,686,214,0,0,0,0,0,900,PROJECT DELAYED DUE TO BUDGETARY CONSTRAINTS,,PLAY AREA UPGRADE,cpd11-20qn.pdf
HAM15RFGR,REDFERN COMMUNITY CENTER PLAYGROUND,806,HOUSING PRESERVATION AND DEVEL,LOW TO MODERATE INCOME PUBLIC HOUSING UPGRADE,414,QUEENS,HA-D001,150,0,150,0,0,0,0,0,150,0,150,0,0,0,0,0,150,0,300,0,0,0,0,0,300,PROJECT DELAYED DUE TO CHANGES IN SCOPE/DESIGN,,UPGRADE COMMUNITY CENTER PLAYGROUND,cpd11-20qn.pdf
HAM15SJBC,SOUTH JAMAICA HOUSES BASKETBALL COURT UPGRADES,806,HOUSING PRESERVATION AND DEVEL,LOW TO MODERATE INCOME PUBLIC HOUSING UPGRADE,412,QUEENS,HA-D001,50,0,50,0,0,0,0,0,50,0,50,0,0,0,0,0,50,0,100,0,0,0,0,0,100,PROJECT DELAYED DUE TO CHANGES IN SCOPE/DESIGN,,UPGRADE BASKETBALL COURTS,cpd11-20qn.pdf
HAM16CMPL,CARLTON MANOR PLAYGROUND RENOVATIONS BASKETBALL COURTS,806,HOUSING PRESERVATION AND DEVEL,LOW TO MODERATE INCOME PUBLIC HOUSING UPGRADE,414,QUEENS,HA-D001,250,0,250,0,0,0,0,0,250,0,250,0,0,0,0,0,250,0,500,0,0,0,0,0,500,PROJECT DELAYED DUE TO CHANGES IN SCOPE/DESIGN,,"PLAYGROUND RENOVATIONS, INCLUDING BASKETBALL COURTS",cpd11-20qn.pdf
HAM16LVSC,LEAVITT STREET-34TH AVENUE SECURITY CAMERAS,806,HOUSING PRESERVATION AND DEVEL,LOW TO MODERATE INCOME PUBLIC HOUSING UPGRADE,407,QUEENS,HA-D001,50,262,88,0,0,0,0,0,350,262,88,0,0,0,0,0,350,524,176,0,0,0,0,0,700,PROJECT DELAYED DUE TO BUDGETARY CONSTRAINTS,,LEAVITT STREET-34TH AVENUE SECURITY CAMERAS,cpd11-20qn.pdf
HAM17BPSC,BAISLEY PARK INSTALLATION OF SECURITY CAMERAS,806,HOUSING PRESERVATION AND DEVEL,LOW TO MODERATE INCOME PUBLIC HOUSING UPGRADE,400,QUEENS,HA-Q001,500,434,66,0,0,0,0,0,500,434,66,0,0,0,0,0,500,868,132,0,0,0,0,0,1000,PROJECT DELAYED DUE TO CHANGES IN SCOPE/DESIGN,,BAISLEY PARK HOUSES INSTALLATION OF SECURITY CAMERAS,cpd11-20qn.pdf
HAM17ILTV,International Towers - Security Cameras,806,HOUSING PRESERVATION AND DEVEL,LOW TO MODERATE INCOME PUBLIC HOUSING UPGRADE,412,QUEENS,HA-D001,100,162,48,0,0,0,0,0,210,162,48,0,0,0,0,0,210,324,96,0,0,0,0,0,420,PROJECT DELAYED DUE TO CHANGES IN SCOPE/DESIGN,,INSTALLATION OF SECURITY CAMERAS,cpd11-20qn.pdf
HAM17LGPL,LATIMER GARDENS PLAYGROUND UPGRADE,806,HOUSING PRESERVATION AND DEVEL,LOW TO MODERATE INCOME PUBLIC HOUSING UPGRADE,400,QUEENS,HA-Q001,350,313,37,0,0,0,0,0,350,313,37,0,0,0,0,0,350,626,74,0,0,0,0,0,700,PROJECT DELAYED DUE TO CHANGES IN SCOPE/DESIGN,,LATIMER GARDENS PLAYGROUND UPGRADE,cpd11-20qn.pdf
HAM18ASTV,CCTV AT ASTORIA HOUSES,806,HOUSING PRESERVATION AND DEVEL,LOW TO MODERATE INCOME PUBLIC HOUSING UPGRADE,401,QUEENS,HA-D001,459,379,80,0,0,0,0,0,459,379,80,0,0,0,0,0,459,758,160,0,0,0,0,0,918,,,INSTALLATION OF CCTV'S AT ASTORIA HOUSES,cpd11-20qn.pdf
HAM18BLGR,BLAND HOUSES GROUNDS BEAUTIFICATION,806,HOUSING PRESERVATION AND DEVEL,LOW TO MODERATE INCOME PUBLIC HOUSING UPGRADE,407,QUEENS,HA-D001,500,0,500,0,0,0,0,0,500,0,500,0,0,0,0,0,500,0,1000,0,0,0,0,0,1000,PROJECT DELAYED DUE TO CHANGES IN SCOPE/DESIGN,,"BLAND GROUNDS BEAUTIFICATION, INCLUDES BENCHES, SIGNAGE AND GATE AT ENTRANCE",cpd11-20qn.pdf
HAM18COTV,LAYERED SECURITY ACCESS AT CONLON LIFHE,806,HOUSING PRESERVATION AND DEVEL,LOW TO MODERATE INCOME PUBLIC HOUSING UPGRADE,412,QUEENS,HA-D001,220,0,220,0,0,0,0,0,220,0,220,0,0,0,0,0,220,0,440,0,0,0,0,0,440,,,LAYERED SECURITY ACCESS AT CONLON LIFHE,cpd11-20qn.pdf
HAM19AHSC,ASTORIA HOUSES SECURITY CAMERAS,806,HOUSING PRESERVATION AND DEVEL,LOW TO MODERATE INCOME PUBLIC HOUSING UPGRADE,401,QUEENS,HA-D001,100,0,100,0,0,0,0,0,100,0,100,0,0,0,0,0,100,0,200,0,0,0,0,0,200,,,INSTALL SECURITY CAMERAS,cpd11-20qn.pdf
HAM19CLHS,CONLON LIFHE HVAC SYSTEM,806,HOUSING PRESERVATION AND DEVEL,LOW TO MODERATE INCOME PUBLIC HOUSING UPGRADE,412,QUEENS,HA-D001,600,0,600,0,0,0,0,0,600,0,600,0,0,0,0,0,600,0,1200,0,0,0,0,0,1200,,,FUNDING WILL PROVIDE UPGRADES TO THE HVAC SYSTEM,cpd11-20qn.pdf
HAM19WHRB,WOODSIDE HOUSES RENOVATION OF BOYS AND GIRLS BATHROOMS,806,HOUSING PRESERVATION AND DEVEL,LOW TO MODERATE INCOME PUBLIC HOUSING UPGRADE,401,QUEENS,HA-D001,600,0,600,0,0,0,0,0,600,0,600,0,0,0,0,0,600,0,1200,0,0,0,0,0,1200,,,RENOVATION OF BOYS AND GIRLS BATHROOM,cpd11-20qn.pdf
HAM20ASGR,ASTORIA- GARDEN AND GROUNDS BEAUTIFICATION,806,HOUSING PRESERVATION AND DEVEL,LOW TO MODERATE INCOME PUBLIC HOUSING UPGRADE,401,QUEENS,HA-D001,500,0,500,0,0,0,0,0,500,0,500,0,0,0,0,0,500,0,1000,0,0,0,0,0,1000,,,NYCHA GARDEN AND GROUND BEAUTIFICATION -- FUNDS WILL BE USED TO SUPPORT OUTDOOR,cpd11-20qn.pdf
HAM20BHCS,BAISLEY - CCTV CAMERA SYSTEM FOR ALL 27 BUILDINGS,806,HOUSING PRESERVATION AND DEVEL,LOW TO MODERATE INCOME PUBLIC HOUSING UPGRADE,412,QUEENS,HA-D001,1500,0,1500,0,0,0,0,0,1500,0,1500,0,0,0,0,0,1500,0,3000,0,0,0,0,0,3000,,,NYCHA BAISLEY HOUSES CCT CAMERA SYSTEM -- CCT CAMERA SYSTEM FOR ALL 27 BUILDGINGS AT,cpd11-20qn.pdf
HAM20BHLL,BLAND HOUSES- LED LIGHTING,806,HOUSING PRESERVATION AND DEVEL,LOW TO MODERATE INCOME PUBLIC HOUSING UPGRADE,407,QUEENS,HA-D001,300,0,300,0,0,0,0,0,300,0,300,0,0,0,0,0,300,0,600,0,0,0,0,0,600,,,BLAND HOUSES- ADDITIONAL LED LIGHTING THROUGHOUT THE DEVELOPMENT,cpd11-20qn.pdf
HAM20JYCL,S JAMAICA - UPGRADE TO COMPUTER LAB AT YOUTH CENTER,806,HOUSING PRESERVATION AND DEVEL,LOW TO MODERATE INCOME PUBLIC HOUSING UPGRADE,412,QUEENS,HA-D001,1000,0,1000,0,0,0,0,0,1000,0,1000,0,0,0,0,0,1000,0,2000,0,0,0,0,0,2000,PROJECT DELAYED DUE TO CHANGES IN SCOPE/DESIGN,,NYCHA SOUTH JAMAICA HOUSES CORNERSTONE YOUTH CENTER RENOVATION -- UPGRADE TO,cpd11-20qn.pdf
HAM20LCSC,LEWIS H. LATIMER SECURITY CAMERAS AT SENIOR CENTER,806,HOUSING PRESERVATION AND DEVEL,LOW TO MODERATE INCOME PUBLIC HOUSING UPGRADE,407,QUEENS,HA-D001,200,0,200,0,0,0,0,0,200,0,200,0,0,0,0,0,200,0,400,0,0,0,0,0,400,,,LEWIS H. LATIMER SECURITY CAMERAS AT SENIOR CENTER,cpd11-20qn.pdf
HAM20RCCB,RAVENSWOOD COMMUNITY CENTER BATHROOMS,806,HOUSING PRESERVATION AND DEVEL,LOW TO MODERATE INCOME PUBLIC HOUSING UPGRADE,401,QUEENS,HA-D001,600,0,600,0,0,0,0,0,600,0,600,0,0,0,0,0,600,0,1200,0,0,0,0,0,1200,PROJECT DELAYED DUE TO CHANGES IN SCOPE/DESIGN,,RENOVATION OF THE BATHROOMS IN THE RAVENSWOOD HOUSES COMMUNITY CENTER-- RENOVATION,cpd11-20qn.pdf
HAM21BHEL,BEACH 41 STREET- INSTALLATION OF EXTERIOR LIGHTING,806,HOUSING PRESERVATION AND DEVEL,LOW TO MODERATE INCOME PUBLIC HOUSING UPGRADE,414,QUEENS,HA-Q001,0,0,400,0,0,0,0,0,400,0,400,0,0,0,0,0,400,0,800,0,0,0,0,0,800,,,BEACH 41 STREET- INSTALLATION OF EXTERIOR LIGHTING,cpd11-20qn.pdf
HAM21SJWW,DIAGONAL CEMENT WALKWAY AT SOUTH JAMAICA HOUSES II,806,HOUSING PRESERVATION AND DEVEL,LOW TO MODERATE INCOME PUBLIC HOUSING UPGRADE,412,QUEENS,HA-D001,0,0,160,0,0,0,0,0,160,0,160,0,0,0,0,0,160,0,320,0,0,0,0,0,320,,,PB,cpd11-20qn.pdf
HAM21WSCB,BATHROOM RENOVATIONS AT WOODSIDE HOUSES,806,HOUSING PRESERVATION AND DEVEL,LOW TO MODERATE INCOME PUBLIC HOUSING UPGRADE,401,QUEENS,HA-D001,0,0,600,0,0,0,0,0,600,0,600,0,0,0,0,0,600,0,1200,0,0,0,0,0,1200,,,WOODSIDE HOUSES SENIOR CENTER & COMMUNITY CENTER BATHROOM RENOVATIONS-FUNDING FOR,cpd11-20qn.pdf
ACEDOH901,DOHMH - Boiler Controls Upgrade at 3 DOHMH Health Centers,816,DEPARTMENT OF HEALTH AND MENTAL HYGIENE,"BUILDING CONSTRUCTION, RECONSTRUCTION OR RETROFIT",401,QUEENS,PU-0025,200,0,150,0,0,0,0,0,150,0,150,0,0,0,0,0,150,0,300,0,0,0,0,0,300,,,BOILER CONTROLS UPGRADE AT 3 DOHMH HEALTH CENTERS,cpd11-20qn.pdf
CMEQANNEX,OCME - Queens Annex Phase,816,DEPARTMENT OF HEALTH AND MENTAL HYGIENE,OCME,,QUEENS,HL-0083,7773,0,0,0,0,294,0,0,294,0,0,0,0,294,0,0,294,0,0,0,0,588,0,0,588,,,THE OCME ENDEAVORS TO REQUEST THE DESIGN AND CONSTRUCTION OF AN ANNEXFACILITY TO THE,cpd11-20qn.pdf
02201804,LIC OUTFIT OFFICE SPACE,819,HEALTH AND HOSPITALS CORP,ROUTINE RECONSTRUCTION,,QUEENS,HO-0214,2874,2764,0,110,0,0,0,0,2874,2764,0,110,0,0,0,0,2874,5528,0,220,0,0,0,0,5748,PROJECT DELAYED DUE TO CHANGES IN SCOPE/DESIGN,"30-30 47TH AVENUE, LIC, NY 11101","NYC H+H IS OUTFITTING THE NEWLY LEASED SPACE AT 30-30 46TH AVE., LIC,4TH FLOOR, WITH",cpd11-20qn.pdf
33201301,EHC,819,HEALTH AND HOSPITALS CORP,ROUTINE RECONSTRUCTION,404,QUEENS,HO-0214 HO-Q378 HO-D003,20000,2422,4100,15867,10372,0,0,0,32761,2422,4100,15867,10372,0,0,0,32761,4844,8200,31734,20744,0,0,0,65522,PROJECT DELAYED DUE TO CHANGES IN SCOPE/DESIGN,"79-01 BROADWAY, ELMHURST, NY 11373",RENOVATE THE ADULT ER INCLUDING THE CONSTRUCTION OF AN ENCLOSED STRETCHER BAY AREA,cpd11-20qn.pdf
33201602,"EHC PARAPET & CORNER FACADE REHAB A,B,D,E, J AND O&G ANNEX.",819,HEALTH AND HOSPITALS CORP,ROUTINE RECONSTRUCTION,404,QUEENS,HO-0214,2804,152,2060,592,0,0,0,0,2804,152,2060,592,0,0,0,0,2804,304,4120,1184,0,0,0,0,5608,,"79-01 BROADWAY, ELMHURST, N. Y. 11373","THE PURPOSE OF THIS PROJECT IS TO RENOVATE BUILDINGS A, B, C, F AND G AT ELMHURST HOSPITAL",cpd11-20qn.pdf
33201610,RENOVATE JUNCTION BLVD CHILD HEALTH CLINIC,819,HEALTH AND HOSPITALS CORP,ROUTINE RECONSTRUCTION,403,QUEENS,HO-0214,4087,3740,49,292,0,0,0,0,4081,3740,49,292,0,0,0,0,4081,7480,98,584,0,0,0,0,8162,,"34-33 JUNCTION BLVD. CORONA, NY 11372",RENOVATE THE JUNCTION BLVD CHILD HEALTH CLINIC IN ORDER TO EXPAND PRIMARY CARE HEALTH,cpd11-20qn.pdf
33201804,ELMHURST,819,HEALTH AND HOSPITALS CORP,ROUTINE RECONSTRUCTION,,QUEENS,HO-0214,992,586,100,306,0,0,0,0,992,586,100,306,0,0,0,0,992,1172,200,612,0,0,0,0,1984,PROJECT DELAYED DUE TO CHANGES IN SCOPE/DESIGN,"79-01 BROADWAY, QUEENS, NY",REHABILITATE N & S STAIRWELLS IN PARKING GARAGE,cpd11-20qn.pdf
33201901,EHC,819,HEALTH AND HOSPITALS CORP,ROUTINE RECONSTRUCTION,,QUEENS,HO-D003 HO-Q378,4320,0,100,4220,0,0,0,0,4320,0,100,4220,0,0,0,0,4320,0,200,8440,0,0,0,0,8640,,"79-01 BROADWAY, ELMHURST, NEW YORK 11373",CONSTRUCTION OF THE LABOR AND DELIVERY ROOMS AND NURSING STATIONS AT ELMHURST,cpd11-20qn.pdf
33202002,ELMHURST,819,HEALTH AND HOSPITALS CORP,ROUTINE RECONSTRUCTION,,QUEENS,HO-D003 HO-0214,5500,0,607,7192,0,0,0,0,7799,0,607,7192,0,0,0,0,7799,0,1214,14384,0,0,0,0,15598,,"79-01 BROADWAY, ELMHURST, NY 11373",CONSTRUCT AMBULATORY CENTER AT NYC HEALTH + HOSPITALS / ELMHURST,cpd11-20qn.pdf
33202003,ELMHURST,819,HEALTH AND HOSPITALS CORP,ROUTINE RECONSTRUCTION,,QUEENS,HO-0214,5004,327,37,4671,0,0,0,0,5035,327,37,4671,0,0,0,0,5035,654,74,9342,0,0,0,0,10070,,"79-01 BROADWAY, ELMHURST, NY 11373",UPGRADE EMERGENCY ELECTRICAL SYSTEMS - EES TYPE 1,cpd11-20qn.pdf
33202101,Re-lining of Sub-Basement Water Lines,819,HEALTH AND HOSPITALS CORP,ROUTINE RECONSTRUCTION,,QUEENS,HO-0214,760,0,760,0,0,0,0,0,760,0,760,0,0,0,0,0,760,0,1520,0,0,0,0,0,1520,,"79-01 BROADWAY, QUEENS, NY 11373",NA,cpd11-20qn.pdf
33202102,ELMHURST,819,HEALTH AND HOSPITALS CORP,ROUTINE RECONSTRUCTION,,QUEENS,HO-D003,2500,0,2500,0,0,0,0,0,2500,0,2500,0,0,0,0,0,2500,0,5000,0,0,0,0,0,5000,,"79-01 BROADWAY, ELMHURST, NY 11373",CONVERSION OF VACANT PYSCH UNIT,cpd11-20qn.pdf
33202103,CAT LAB ROOF REPLACEMENT,819,HEALTH AND HOSPITALS CORP,ROUTINE RECONSTRUCTION,,QUEENS,HO-0214,242,0,242,0,0,0,0,0,242,0,242,0,0,0,0,0,242,0,484,0,0,0,0,0,484,,"79-01 BROADWAY, QUEENS NY 11373",CAT LAB ROOF REPLACEMENT,cpd11-20qn.pdf
33202104,MODERNIZE FREIGHT ELEVATORS,819,HEALTH AND HOSPITALS CORP,ROUTINE RECONSTRUCTION,,QUEENS,HO-0214,1012,0,1012,0,0,0,0,0,1012,0,1012,0,0,0,0,0,1012,0,2024,0,0,0,0,0,2024,,"79-01 BROADWAY, QUEENS, NY 11373",MODERNIZE FREIGHT ELEVATORS,cpd11-20qn.pdf
33202105,"MODERNIZE ELEVATOR CARS 1-5, O AND G",819,HEALTH AND HOSPITALS CORP,ROUTINE RECONSTRUCTION,,QUEENS,HO-0214,2179,0,2179,0,0,0,0,0,2179,0,2179,0,0,0,0,0,2179,0,4358,0,0,0,0,0,4358,,"79-01 BROADWAY, QUEENS NY 11373",MODERNIZE ELEVATOR,cpd11-20qn.pdf
34201201,QHC,819,HEALTH AND HOSPITALS CORP,ROUTINE RECONSTRUCTION,408,QUEENS,HO-0214,6500,2242,251,0,0,3689,0,0,6182,2242,251,0,0,3689,0,0,6182,4484,502,0,0,7378,0,0,12364,PROJECT DELAYED DUE TO CHANGES IN SCOPE/DESIGN,"82-68 164 STREET, JAMAICA, NY 11432","RELOCATE QUEEN HOSPITAL CENTER'S ""T"" BUILDING PROGRAMS TO MAKE WAY FOR",cpd11-20qn.pdf
34201401,QHC,819,HEALTH AND HOSPITALS CORP,ROUTINE RECONSTRUCTION,400 408,QUEENS,HO-Q003,1200,102,0,1098,0,0,0,0,1200,102,0,1098,0,0,0,0,1200,204,0,2196,0,0,0,0,2400,PROJECT DELAYED DUE TO CHANGES IN SCOPE/DESIGN,"82-68 164TH STREET, JAMAICA, N. Y. 11432",THE PURPOSE OF THIS PROJECT IS TO RENOVATE SPACE TO SUPPORT RELOCATION OF ACUTE,cpd11-20qn.pdf
34201402,QHC,819,HEALTH AND HOSPITALS CORP,ROUTINE RECONSTRUCTION,408,QUEENS,HO-0214 HO-Q003 HO-D003,3480,4990,200,140,0,557,0,0,5887,4990,200,140,0,557,0,0,5887,9980,400,280,0,1114,0,0,11774,PROJECT DELAYED DUE TO CHANGES IN SCOPE/DESIGN,"82-68 164TH STREET, JAMAICA, NY 11432",QUEENS HOSPITAL CENTER PLANS TO EXPAND ITS ED INTO THE VACATED CPEP AND ED,cpd11-20qn.pdf
34201502,QHC,819,HEALTH AND HOSPITALS CORP,ROUTINE RECONSTRUCTION,408,QUEENS,HO-0214,150,0,150,0,0,0,0,0,150,0,150,0,0,0,0,0,150,0,300,0,0,0,0,0,300,PROJECT DELAYED DUE TO CHANGES IN SCOPE/DESIGN,"82-68 164TH STREET, JAMAICA, NY 11432",REPLACE END OF LIFE BOILER CONTROLS AT QUEENS HOSPITAL CENTER.,cpd11-20qn.pdf
34201503,QHC,819,HEALTH AND HOSPITALS CORP,ROUTINE RECONSTRUCTION,408,QUEENS,HO-Q003 HO-D003,3600,0,0,3600,0,0,0,0,3600,0,0,3600,0,0,0,0,3600,0,0,7200,0,0,0,0,7200,PROJECT DELAYED DUE TO CHANGES IN SCOPE/DESIGN,"82-68 164 STREET JAMAICA, NY 11432",QHC,cpd11-20qn.pdf
34202101,CONSTRUCT PARKING GARAGE,819,HEALTH AND HOSPITALS CORP,ROUTINE RECONSTRUCTION,,QUEENS,HO-0214,10000,0,0,10000,0,0,0,0,10000,0,0,10000,0,0,0,0,10000,0,0,20000,0,0,0,0,20000,,"82-70 164TH STREET, JAMAICA, NY, 11432",CONSTRUCT NEW PARKING GARAGE,cpd11-20qn.pdf
34202102,BUILDING S AN F ROOF REPLACEMENT,819,HEALTH AND HOSPITALS CORP,ROUTINE RECONSTRUCTION,,QUEENS,HO-0214,1200,0,0,1200,0,0,0,0,1200,0,0,1200,0,0,0,0,1200,0,0,2400,0,0,0,0,2400,,"82-68 164TH STREET, JAMAICA NY 11432",BUILDING S AN F ROOF REPLACEMENT,cpd11-20qn.pdf
ACEHHC803,NYC Health + Hospitals/Queens Energy Efficiency Upgrade,819,HEALTH AND HOSPITALS CORP,"BUILDING CONSTRUCTION, RECONSTRUCTION OR RETROFIT",401,QUEENS,PU-0025,3197,0,0,3197,0,0,0,0,3197,0,0,3197,0,0,0,0,3197,0,0,6394,0,0,0,0,6394,,,NYC HEALTH + HOSPITALS/QUEENS ENERGY EFFICIENCY UPGRADE,cpd11-20qn.pdf
ACEDEP601,DEP - LED LIGHTING AT CATSKILL DELAWARE UV FACILITY,826,DEPT ENVIRONMENTAL PROTECTION,"BUILDING CONSTRUCTION, RECONSTRUCTION OR RETROFIT",404,QUEENS,PU-0025,960,0,0,873,0,0,0,0,873,0,0,873,0,0,0,0,873,0,0,1746,0,0,0,0,1746,,,UNIT,cpd11-20qn.pdf
BB06-01-A,GI - ON SITE CONSTRUCTION FOR GREEN INFRASTRUCTURE IN BB-006,826,DEPT ENVIRONMENTAL PROTECTION,GREEN INFRASTRUCTURE PROGRAM,400,QUEENS,WP-0169,5000,0,1500,0,0,0,0,0,1500,0,1500,0,0,0,0,0,1500,0,3000,0,0,0,0,0,3000,,,GI - ON SITE CONSTRUCTION FOR GREEN INFRASTRUCTURE IN BB-006,cpd11-20qn.pdf
BB-205-L,RECONS. CBS/PBS SYSTEM AT BOWERY BAY WPCP (TOC JOB),826,DEPT ENVIRONMENTAL PROTECTION,PLANT UPGRADING AND RECONSTRUCTION,400 401,QUEENS,WP-0112,5700,9245,163,0,0,0,0,0,9408,9245,163,0,0,0,0,0,9408,18490,326,0,0,0,0,0,18816,PROJECT DELAYED DUE TO BUDGETARY CONSTRAINTS,"43-01 BERRIAN BLVD., ASTORIA, N.Y. 11105",RECONSTRUCTION OF CBS/PBS SYSTEM AT THE BOWERY BAY WPCP,cpd11-20qn.pdf
BB-216-L,RECONSTRUCTION OF PRIMARY TANKS AT BOWERY BAY WPCP,826,DEPT ENVIRONMENTAL PROTECTION,PLANT UPGRADING AND RECONSTRUCTION,400 401,QUEENS,WP-0112,16726,8383,0,0,0,0,0,44045,52428,8383,0,0,0,0,0,44045,52428,16766,0,0,0,0,0,88090,104856,PROJECT DELAYED DUE TO BUDGETARY CONSTRAINTS,"43-01 BERRIAN BL;VD., ASTORIA, N.Y. 11105",RECONSTRUCTION OF PRIMARY TANKS AT BOWERY BAY WPCP,cpd11-20qn.pdf
BB-220-L,REPLACEMENT OF EXISTING EMERGENCY GENERATORS @ BOWERY BAY,826,DEPT ENVIRONMENTAL PROTECTION,PLANT UPGRADING AND RECONSTRUCTION,400 401,QUEENS,WP-0112,30650,0,0,10000,0,0,0,110000,120000,0,0,10000,0,0,0,110000,120000,0,0,20000,0,0,0,220000,240000,PROJECT DELAYED DUE TO BUDGETARY CONSTRAINTS,"43-01 BERRIAN BLVD., ASTORIA, N.Y. 11105",REPLACEMENT OF EXISTING EMERGENCY GENERATORS AT THE BOWERY BAY WASTEWATER,cpd11-20qn.pdf
BB-239-L,INSTALL NEW WASTE ACTIVATED SLUDGE PUMPS @ BOWERY BAY WWTP,826,DEPT ENVIRONMENTAL PROTECTION,PLANT UPGRADING AND RECONSTRUCTION,400,QUEENS,WP-0112,2500,0,0,2000,0,0,0,0,2000,0,0,2000,0,0,0,0,2000,0,0,4000,0,0,0,0,4000,,"43-01 BERRIAN BLVD. ASTORIA , NEW YORK 11105",INSTALL A NEW WASTE ACTIVATED SLUDGE PUMPS AT THE BOWERY BAY WASTEWATER TREATMENT,cpd11-20qn.pdf
BB-64,MSP Discharge Piping/Controls at Bowery Bay WPCP,826,DEPT ENVIRONMENTAL PROTECTION,PLANT UPGRADING AND RECONSTRUCTION,407,QUEENS,WP-0112,76843,67035,854,0,0,0,0,0,67889,67035,854,0,0,0,0,0,67889,134070,1708,0,0,0,0,0,135778,,,CONTRACT BB-64 IS TO PROVIDE DESIGN SERVICES REQUIRED IN CONNECTION WITH THE NEW MAIN,cpd11-20qn.pdf
C540,Completion of CT3 Stage 2 B/Q Leg & Bklyn Downtake Intercon.,826,DEPT ENVIRONMENTAL PROTECTION,"CITY TUNNEL NO. 3, STAGE 2",413,QUEENS,W-0013,104830,139857,429285,0,0,179576,0,0,748718,139857,429285,0,0,179576,0,0,748718,279714,858570,0,0,359152,0,0,1497436,PROJECT DELAYED DUE TO BUDGETARY CONSTRAINTS,APPROXIMATE LOCATION,"CONSTRUCTION OF SHAFTS 17B AND 18B FOR CITY TUNNEL NO 3, STAGE 2 IN THEBOROUGH OF",cpd11-20qn.pdf
CS-AC-EBP,RESTORATION OF 1.5 ACRE WETLAND IN ALLEY CREEK,826,DEPT ENVIRONMENTAL PROTECTION,WATER QUALITY MANDATES,400 411,QUEENS,WP-0169,1500,1809,349,0,0,0,0,0,2158,1809,349,0,0,0,0,0,2158,3618,698,0,0,0,0,0,4316,,,THIS EBP WILL PROVIDE ECOLOGICAL BENEFIT BY REMOVING ANTHROPOGENIC FILL MATERIAL TO,cpd11-20qn.pdf
CS-FB-BWR,FLUSHING BAY BENDING WEIRS AT REGULATORS,826,DEPT ENVIRONMENTAL PROTECTION,WATER QUALITY MANDATES,400 407,QUEENS,WP-0169,11000,39246,354,0,0,0,0,0,39600,39246,354,0,0,0,0,0,39600,78492,708,0,0,0,0,0,79200,PROJECT DELAYED DUE TO CHANGES IN SCOPE/DESIGN,,FLUSHING BAY BENDING WEIRS AT REGULATORS. FLUSHING BAY WATER QUALITY,cpd11-20qn.pdf
CS-JA-BWR,JAMAICA BAY BENDING WEIRS AT REGULATORS,826,DEPT ENVIRONMENTAL PROTECTION,WATER QUALITY MANDATES,400 410 412 413 414,QUEENS,WP-0169,14366,10055,244,0,0,0,0,0,10299,10055,244,0,0,0,0,0,10299,20110,488,0,0,0,0,0,20598,PROJECT DELAYED DUE TO BUDGETARY CONSTRAINTS,,JAMAICA BAY BENDING WEIRS,cpd11-20qn.pdf
CS-NC-BAP,BORDEN AVENUE PUMP STATION EXPANSION,826,DEPT ENVIRONMENTAL PROTECTION,WATER QUALITY MANDATES,400,QUEENS,WP-0169,74000,0,9000,0,0,0,0,77000,86000,0,9000,0,0,0,0,77000,86000,0,18000,0,0,0,0,154000,172000,,,THE PROJECT WILL CONTROL CSO DISCHARGES TO DUTCH KILLS BY DIVERTING WET WEATHER FLOW,cpd11-20qn.pdf
CS-NC-EKE,"ENGLISH KILLS AERATION, ENHANCED ZONE II",826,DEPT ENVIRONMENTAL PROTECTION,WATER QUALITY MANDATES,400 402 405,QUEENS,WP-0169,97309,24790,33870,0,0,0,0,0,58660,24790,33870,0,0,0,0,0,58660,49580,67740,0,0,0,0,0,117320,PROJECT DELAYED PENDING RESOLUTION OF LEGAL ISSUES,,"ENGLISH KILLS AERATION, ENHANCED ZONE II. WATER QUALITY FACILITY COMBINED SEWER",cpd11-20qn.pdf
CSO-FC-DF,CSO FLUSHING CREEK & TI-011 DISINFECTION,826,DEPT ENVIRONMENTAL PROTECTION,WATER QUALITY MANDATES,400 407,QUEENS,WP-0169,24000,14730,0,0,9500,56500,9000,0,89730,14730,0,0,9500,56500,9000,0,89730,29460,0,0,19000,113000,18000,0,179460,,,CSO FLUSHING CREEK & TI-011 DISINFECTION,cpd11-20qn.pdf
CSO-JA,JAMAICA WATER QUALITY COMBINED SEWER OVERLOW,826,DEPT ENVIRONMENTAL PROTECTION,WATER QUALITY MANDATES,400 410 412 413 414,QUEENS,WP-0169,170508,17640,797,500,0,0,0,0,18937,17640,797,500,0,0,0,0,18937,35280,1594,1000,0,0,0,0,37874,PROJECT DELAYED DUE TO BUDGETARY CONSTRAINTS,,,cpd11-20qn.pdf
DMCCSG,REPLACE SWITCHEARS & MCCS AT DOUGLASTON PS,826,DEPT ENVIRONMENTAL PROTECTION,WATER QUALITY PRESERVATION,400,QUEENS,WM-0105,2500,5592,38,0,0,0,0,0,5630,5592,38,0,0,0,0,0,5630,11184,76,0,0,0,0,0,11260,PROJECT DELAYED DUE TO BUDGETARY CONSTRAINTS,,REPLACE SWITCHEARS & MCCS AT DOUGLASTON PS,cpd11-20qn.pdf
EC-SEQN22,"Reconstruction of Existing Sewers, North Queens",826,DEPT ENVIRONMENTAL PROTECTION,REPLACEMENT OR AUGMENTATION OF EXISTING SYSTEMS,400,QUEENS,EP-0007 SE-0002Q,9352,0,0,8500,0,0,0,0,8500,0,0,8500,0,0,0,0,8500,0,0,17000,0,0,0,0,17000,,,"RECONSTRUCTION OF EXISTING SEWERS, NORTH QUEENS",cpd11-20qn.pdf
FB-001-L,UPGRADE OF FLUSHING BAY CSO FACILITY BAR SCREEN SYSTEM,826,DEPT ENVIRONMENTAL PROTECTION,WATER QUALITY MANDATES,400 407,QUEENS,WP-0169,12900,10850,711,0,0,0,0,0,11561,10850,711,0,0,0,0,0,11561,21700,1422,0,0,0,0,0,23122,PROJECT DELAYED DUE TO UNFORESEEN SITE/FIELD CONDITION,FLUSHING BAY/TALLMAN ISLAND WPCP/QUEENS,RECONSTRUCTION OF SCREENS AT FLUSHING BAY/TALLMAN ISLAND WPCP,cpd11-20qn.pdf
FCWET,CONSTRUCTION OF FLUSHING CREEK WETLAND PROJECT,826,DEPT ENVIRONMENTAL PROTECTION,WATER QUALITY MANDATES,400,QUEENS,WP-0169,8000,0,0,0,8000,0,0,0,8000,0,0,0,8000,0,0,0,8000,0,0,0,16000,0,0,0,16000,,,CONSTRUCTION OF FLUSHING CREEK WETLAND PROJECT,cpd11-20qn.pdf
GCTI10-1C,"CONS OF ROW GI FLUSHING CREEK CSO TRIB AREA TI-10, ST 1 PH C",826,DEPT ENVIRONMENTAL PROTECTION,GREEN INFRASTRUCTURE PROGRAM,400,QUEENS,WP-0169,14000,0,0,0,7637,0,0,0,7637,0,0,0,7637,0,0,0,7637,0,0,0,15274,0,0,0,15274,,,"CONSTRUCTION OF ROW GREEN INFRASTRUCTURE IN FLUSHING CREEK CSO TRIBUTARY AREA TI-10,",cpd11-20qn.pdf
JA-179-L,INSTALLATION OF EMERGENCY GENERATORS AT JAMAICA WPCP,826,DEPT ENVIRONMENTAL PROTECTION,PLANT UPGRADING AND RECONSTRUCTION,400 410,QUEENS,WP-0112,57768,7300,30,0,43200,0,0,0,50530,7300,30,0,43200,0,0,0,50530,14600,60,0,86400,0,0,0,101060,PROJECT DELAYED DUE TO BUDGETARY CONSTRAINTS,"150-2- 134TH STREET, JAMAICA, N.Y. 11430",INSTALLATION OF EMERGENCY GENERATORS AT JAMAICA WPCP,cpd11-20qn.pdf
JA-187,REPLACE MAIN SEWAGE PUMP CONTROLS AT JAMAICA WPCP,826,DEPT ENVIRONMENTAL PROTECTION,PLANT UPGRADING AND RECONSTRUCTION,400,QUEENS,WP-0112,0,0,0,0,5000,0,0,0,5000,0,0,0,5000,0,0,0,5000,0,0,0,10000,0,0,0,10000,,,REPLACE MAIN SEWAGE PUMP CONTROLS AT JAMAICA WPCP,cpd11-20qn.pdf
JA-STAB,STABILIZATION PROGRAM AT JAMAICA WPCP,826,DEPT ENVIRONMENTAL PROTECTION,PLANT COMPONENT STABILIZATION,412,QUEENS,WP-0247,638406,479581,1843,0,0,0,0,0,481424,479581,1843,0,0,0,0,0,481424,959162,3686,0,0,0,0,0,962848,PROJECT DELAYED DUE TO BUDGETARY CONSTRAINTS,QUEENS,FINAL DESIGN TO IMPROVE PROCESS AND TREATMENT OPERATIONS AND TO ALLOWTO ACCEPT FLOW,cpd11-20qn.pdf
JFK-INTER,REROUTING OF INTERCEPTOR AT NEW JFK CARGO BUILDIING,826,DEPT ENVIRONMENTAL PROTECTION,PLANT UPGRADING AND RECONSTRUCTION,400,QUEENS,WP-0269,7000,0,7000,0,0,0,0,0,7000,0,7000,0,0,0,0,0,7000,0,14000,0,0,0,0,0,14000,,,RELOCATION OF INTERCEPTOR AT THE NEW JFK CARGO BUILDING,cpd11-20qn.pdf
MASPETH,"RECONSTRUCTION OF BUILDING, MASPETH, QUEENS",826,DEPT ENVIRONMENTAL PROTECTION,FACILITY PURCHASES AND RECONSTRUCTION,400,QUEENS,EP-0006,67374,5543,0,1000,0,0,0,10000,16543,5543,0,1000,0,0,0,10000,16543,11086,0,2000,0,0,0,20000,33086,PROJECT DELAYED DUE TO CHANGES IN SCOPE/DESIGN,"RECONSTRUCTION OF BUILDING, MASPETH, QUEENS","RECONSTRUCTION OF BUILDING, MASPETH, QUEENS",cpd11-20qn.pdf
PS-277,RECONSTRUCTION AT 108 STREET PUMPING STATION,826,DEPT ENVIRONMENTAL PROTECTION,PLANT UPGRADING AND RECONSTRUCTION,400,QUEENS,WP-0269,10990,500,41763,0,0,0,0,0,42263,500,41763,0,0,0,0,0,42263,1000,83526,0,0,0,0,0,84526,,108 STREET,RECONSTRUCTION OF 108 STREET P.S.,cpd11-20qn.pdf
PS-284,CLEARVIEW PUMPING STATION,826,DEPT ENVIRONMENTAL PROTECTION,PLANT UPGRADING AND RECONSTRUCTION,400 407,QUEENS,WP-0269,25422,1000,4463,18000,0,0,0,0,23463,1000,4463,18000,0,0,0,0,23463,2000,8926,36000,0,0,0,0,46926,,CLEARVIEW PUMPING STATION,CLEARVIEW PUMPING STATION,cpd11-20qn.pdf
PS-285,RIKERS ISLAND NORTH AND SOUTH PUMPING STATION,826,DEPT ENVIRONMENTAL PROTECTION,PLANT UPGRADING AND RECONSTRUCTION,400 401,QUEENS,WP-0269,9000,23533,625,0,0,0,0,0,24158,23533,625,0,0,0,0,0,24158,47066,1250,0,0,0,0,0,48316,,RIKERS ISLAND NORTH,RIKERS ISLAND NORTH & SOUTH PUMPING STATION,cpd11-20qn.pdf
PS-286,ST ALBANS PUMPING STATION,826,DEPT ENVIRONMENTAL PROTECTION,PLANT UPGRADING AND RECONSTRUCTION,400 412,QUEENS,WP-0269,8000,0,0,0,0,25000,0,0,25000,0,0,0,0,25000,0,0,25000,0,0,0,0,50000,0,0,50000,,,ST ALBANS PUMPING STATION,cpd11-20qn.pdf
PS-291,154TH STREET PUMPING STATION,826,DEPT ENVIRONMENTAL PROTECTION,PLANT UPGRADING AND RECONSTRUCTION,400 407,QUEENS,WP-0269,4551,0,0,0,22000,0,0,0,22000,0,0,0,22000,0,0,0,22000,0,0,0,44000,0,0,0,44000,,154TH STREET PUMPING STATION,154TH STREET PUMPING STATION,cpd11-20qn.pdf
PS-292,RECONSTRUCTIONOF LINDEN PLACE PUMPING STATION,826,DEPT ENVIRONMENTAL PROTECTION,PLANT UPGRADING AND RECONSTRUCTION,400 407,QUEENS,WP-0269,6436,0,0,0,0,0,19800,0,19800,0,0,0,0,0,19800,0,19800,0,0,0,0,0,39600,0,39600,,LINDEN PLACE PUMPING STATION,LINDEN PLACE PUMPING STATION,cpd11-20qn.pdf
PS-293,RECONSTRUCTION AT HOWARD BEACH PUMPING STATION,826,DEPT ENVIRONMENTAL PROTECTION,PLANT UPGRADING AND RECONSTRUCTION,400 410,QUEENS,WP-0269,8867,0,0,0,0,0,0,27000,27000,0,0,0,0,0,0,27000,27000,0,0,0,0,0,0,54000,54000,,HOWARD BEACH,RECONSTRUCTION AT HOWARD BEACH PUMPING STATION,cpd11-20qn.pdf
PS-304,RECONSTRUCTION AT GLENDALE PUMPING STATION,826,DEPT ENVIRONMENTAL PROTECTION,PLANT UPGRADING AND RECONSTRUCTION,400 405,QUEENS,WP-0269,6000,0,0,0,0,12000,0,0,12000,0,0,0,0,12000,0,0,12000,0,0,0,0,24000,0,0,24000,,"GLENDALE, QUEENS",RECONSTRUCTION AT GLENDALE PUMPING STATION,cpd11-20qn.pdf
PS-321,"RECONSTRUCTION OF LITTLE NECK PUMPING STATION, QUEENS, N.Y.",826,DEPT ENVIRONMENTAL PROTECTION,PLANT UPGRADING AND RECONSTRUCTION,400 411,QUEENS,WP-0269,7000,0,0,0,0,0,16500,0,16500,0,0,0,0,0,16500,0,16500,0,0,0,0,0,33000,0,33000,PROJECT DELAYED DUE TO CHANGES IN SCOPE/DESIGN,"40TH AVENUE WEST OF 248TH STREET, QUEENS, NEW YORK","RECONSTRUCTION OF LITTLE NECK PUMPING STATION, QUEENS, N.Y.",cpd11-20qn.pdf
PS-326,INSTALLATION OF SE JAMAICA PUMPING STATION,826,DEPT ENVIRONMENTAL PROTECTION,PLANT UPGRADING AND RECONSTRUCTION,400,QUEENS,WP-0269,21000,0,0,0,0,0,0,15000,15000,0,0,0,0,0,0,15000,15000,0,0,0,0,0,0,30000,30000,,"DON AKAMNONU 1943/ 100 MGD 150-20 134TH STREET, JAMAICA QUEENS, N.Y. 11430",INSTALLATION OF SE JAMAICA PUMPING STATION,cpd11-20qn.pdf
PS-335,RECONSTRUCTION OF TALLMAN ISLAND INTERCEPTOR DAMAGE,826,DEPT ENVIRONMENTAL PROTECTION,PLANT UPGRADING AND RECONSTRUCTION,400,QUEENS,WP-0269,7650,0,7000,0,0,0,0,0,7000,0,7000,0,0,0,0,0,7000,0,14000,0,0,0,0,0,14000,,"37TH AVENUE & 114TH STREET, FLUSHING N.Y 11368",RECONSTRUCTION OF TALLMAN ISLAND INTERCEPTOR DUE TO DAMAGE BY CONSTRUCTION COMPANY.,cpd11-20qn.pdf
QED-1053,Trunk Water Main Replacement in Rockaway Blvd,826,DEPT ENVIRONMENTAL PROTECTION,AUGMENTATION OF WATER SUPPLY SYSTEMS,400,QUEENS,WM-0001 WM-0006,27621,0,0,0,0,0,27621,0,27621,0,0,0,0,0,27621,0,27621,0,0,0,0,0,55242,0,55242,,,TRUNK WATER MAIN REPLACEMENT IN ROCKAWAY BLVD,cpd11-20qn.pdf
QED-1054,Dist WM work in Ellwell Crescent from Alderton to Carlton St,826,DEPT ENVIRONMENTAL PROTECTION,AUGMENTATION OF WATER SUPPLY SYSTEMS,400,QUEENS,WM-0001,21962,0,0,0,0,0,19964,0,19964,0,0,0,0,0,19964,0,19964,0,0,0,0,0,39928,0,39928,,,DISTRIBUTION WASTER MAIN WORK IN ELLWEEL CRESCENT FROM ALDERTON STREET TO CARLTON,cpd11-20qn.pdf
QED-1055,"Dist. WM work in Jay Ave btwn Borden Ave & 66th St, QNS",826,DEPT ENVIRONMENTAL PROTECTION,AUGMENTATION OF WATER SUPPLY SYSTEMS,400,QUEENS,WM-0001,9342,0,0,8492,0,0,0,0,8492,0,0,8492,0,0,0,0,8492,0,0,16984,0,0,0,0,16984,,,"DISTRIBUTION WATER MAIN WORK IN JAY AVENUE BETWEEN BORDEN AVENUE & 66TH STREET,",cpd11-20qn.pdf
QED-1056,"Dist WM work in 43rd Ave btwn National St & 104 St, QNS",826,DEPT ENVIRONMENTAL PROTECTION,AUGMENTATION OF WATER SUPPLY SYSTEMS,400,QUEENS,WM-0001,13631,0,0,0,0,0,12391,0,12391,0,0,0,0,0,12391,0,12391,0,0,0,0,0,24782,0,24782,,,"DISTRIBUTION WATER MAIN WORK IN 43RD AVENUE BETWEEN NATIONAL STREET &104TH STREET,",cpd11-20qn.pdf
QNSREPAIR,REHABILITATION OF QUEENS REPAIR FACILITY,826,DEPT ENVIRONMENTAL PROTECTION,FACILITY PURCHASES AND RECONSTRUCTION,400,QUEENS,EP-0006,37750,0,0,0,0,0,4000,49000,53000,0,0,0,0,0,4000,49000,53000,0,0,0,0,0,8000,98000,106000,,,REHABILITATION FO QUEENS REPAIR FACILITY,cpd11-20qn.pdf
R-009-L,RECONSTRUCT FOUR SODIUM HYPOCHLORITE CBS TANKS @ ROCKAWAY,826,DEPT ENVIRONMENTAL PROTECTION,PLANT UPGRADING AND RECONSTRUCTION,400,QUEENS,WP-0112,2480,0,0,2425,0,0,0,0,2425,0,0,2425,0,0,0,0,2425,0,0,4850,0,0,0,0,4850,,"106-21 BEACH CHANNEL DRIVE, ROCKAWAY, N.Y. 11694",RECONSTRUCTION OF FOUR (4) SODIUM HYPOCHLORITE CBS TANKS AT THE ROCKAWAY WASTEWATER,cpd11-20qn.pdf
R-153-L,RECONSTRUCT FINAL SETTLING SYSTEM @ ROCKAWAY WWTP,826,DEPT ENVIRONMENTAL PROTECTION,PLANT UPGRADING AND RECONSTRUCTION,400 414,QUEENS,WP-0112,21358,0,0,0,2106,0,0,23164,25270,0,0,0,2106,0,0,23164,25270,0,0,0,4212,0,0,46328,50540,,"106-21 BECH CHANNEL DRIVE, ROCKAWAY, N.Y. 11694",RECONSTRUCT FINAL SETTLING SYSTEM @ ROCKAWAY WWTP,cpd11-20qn.pdf
RO-2,REPLACE MAIN SEWAGE PUMPS AT ROCKAWAY WPCP,826,DEPT ENVIRONMENTAL PROTECTION,PLANT UPGRADING AND RECONSTRUCTION,400,QUEENS,WP-0112,25000,0,7100,0,0,0,7100,70600,84800,0,7100,0,0,0,7100,70600,84800,0,14200,0,0,0,14200,141200,169600,PROJECT DELAYED DUE TO BUDGETARY CONSTRAINTS,,REPLACE MAIN SEWAGE PUMPS AT ROCKAWAY WPCP,cpd11-20qn.pdf
RO-3,REPLACE MAIN INFLUENT GATES & ACTUATORS AT ROCKAWAY WPCP,826,DEPT ENVIRONMENTAL PROTECTION,PLANT UPGRADING AND RECONSTRUCTION,400,QUEENS,WP-0112,15000,0,0,1500,0,16500,0,0,18000,0,0,1500,0,16500,0,0,18000,0,0,3000,0,33000,0,0,36000,,,REPLACE MAIN INFLUENT GATES & ACTUATORS AT ROCKAWAY WPCP,cpd11-20qn.pdf
RO-ODOR,ODOR CONTROL UPGRADE IN THE THICKENER BLDG AT ROCKAWAY WPCP,826,DEPT ENVIRONMENTAL PROTECTION,PLANT UPGRADING AND RECONSTRUCTION,400,QUEENS,WP-0112,0,0,0,0,6500,0,0,0,6500,0,0,0,6500,0,0,0,6500,0,0,0,13000,0,0,0,13000,,,ODOR CONTROL UPGRADE IN THE THICKENER BLDG AT ROCKAWAY WPCP,cpd11-20qn.pdf
SANDROCK,RECONS OF THE ROCKAWAY WPCP DUE TO HURRICANE SANDY,826,DEPT ENVIRONMENTAL PROTECTION,PLANT UPGRADING AND RECONSTRUCTION,400 414,QUEENS,WP-0112,2100,0,734,0,6602,0,0,0,7336,0,734,0,6602,0,0,0,7336,0,1468,0,13204,0,0,0,14672,PROJECT DELAYED DUE TO BUDGETARY CONSTRAINTS,,RECONSTRUCTION OF THE ROCKAWAY WATER POLLUTION CONTROL PLANT DUE TO HURRICANE,cpd11-20qn.pdf
SE-861A,"HLSS; Strm, san & comb swers & WM, Borden Ave, Phase 2, Qns",826,DEPT ENVIRONMENTAL PROTECTION,REPLACEMENT OF CHRONICALLY FAILING COMPONENTS,402,QUEENS,SE-0004 SE-0200Q SE-9336 SE-0002Q WM-0001,27575,0,0,0,0,0,95000,0,95000,0,0,0,0,0,95000,0,95000,0,0,0,0,0,190000,0,190000,PROJECT DELAYED DUE TO BUDGETARY CONSTRAINTS,,"NEW HLSS; STRM, SAN & COMB SWERS & WM BORDEN AVE B/T JACKSON AVE & E RIVER, PHASE 2, QNS",cpd11-20qn.pdf
SE-CD32,Drainage Improvements in City Council District 32,826,DEPT ENVIRONMENTAL PROTECTION,REPLACEMENT OR AUGMENTATION OF EXISTING SYSTEMS,409 410 414,QUEENS,SE-D200Q,1500,0,1500,0,0,0,0,0,1500,0,1500,0,0,0,0,0,1500,0,3000,0,0,0,0,0,3000,,,DRAINAGE IMPROVEMENTS IN CITY COUNCIL DISTRICT 32,cpd11-20qn.pdf
SEQ002715,Replmnt & repair of combined SE outfall north 81st &19 Ave,826,DEPT ENVIRONMENTAL PROTECTION,REPLACEMENT OR AUGMENTATION OF EXISTING SYSTEMS,400,QUEENS,SE-0002Q,5328,0,0,4632,0,0,0,0,4632,0,0,4632,0,0,0,0,4632,0,0,9264,0,0,0,0,9264,,,REPLACEMENT AND REPAIR OF COMBINED SEWER OUTFALL LOCATED NORTH OF 81 STREET AND 19,cpd11-20qn.pdf
SEQ200592,Southeast Queens - Rosedale South,826,DEPT ENVIRONMENTAL PROTECTION,EXTENSIONS TO ACCOMMODATE NEW DEVELOPMENT,413,QUEENS,WM-0001 SE-0200Q SE-0002Q,53282,0,0,0,38332,0,0,0,38332,0,0,0,38332,0,0,0,38332,0,0,0,76664,0,0,0,76664,,,INSTALLATION OF STORM AND SANITARY SEWERS AND WATER MAINS IN THE ROSEDALE AREA OF,cpd11-20qn.pdf
SEQ200604,St. SE Ext in College Pl btwn 5th ave to US Bulkhead Line QN,826,DEPT ENVIRONMENTAL PROTECTION,REPLACEMENT OR AUGMENTATION OF EXISTING SYSTEMS,407,QUEENS,SE-0200Q,6054,0,0,0,5504,0,0,0,5504,0,0,0,5504,0,0,0,5504,0,0,0,11008,0,0,0,11008,,,STORM SEWER EXTENSION IN COLLEGE POINT BETWEEN 5TH AVENUE (POPPENHUSEN AVENUE) AND,cpd11-20qn.pdf
SEQ-B67,BEACH 67TH STREET MEDIAN GREEN INFRASTRUCTURE,826,DEPT ENVIRONMENTAL PROTECTION,BLUEBELT PROGRAM,412 413,QUEENS,SE-0005,500,0,750,0,0,0,0,0,750,0,750,0,0,0,0,0,750,0,1500,0,0,0,0,0,1500,,,"INSTALLATION OF FLOOD CONTROL BIOSWALES, NEW STORMWATER RUNOFF INLETS, AND PIPES TO",cpd11-20qn.pdf
SEQ-DKWPK,CONSTRUCTION FOR DETECTIVE KEITH WILLIAMS PARK,826,DEPT ENVIRONMENTAL PROTECTION,BLUEBELT PROGRAM,412 413,QUEENS,SE-0005,1250,0,1250,0,0,0,0,0,1250,0,1250,0,0,0,0,0,1250,0,2500,0,0,0,0,0,2500,,,CONSTRUCTION FOR DETECTIVE KEITH WILLIAMS PARK,cpd11-20qn.pdf
SEQGI-01,SEQ - CONSTRUCTION OF GREEN INFRASTRUCTURE SOUTHEAST QUEENS,826,DEPT ENVIRONMENTAL PROTECTION,BLUEBELT PROGRAM,412 413,QUEENS,SE-0005,7957,8596,3540,0,17300,0,0,0,29436,8596,3540,0,17300,0,0,0,29436,17192,7080,0,34600,0,0,0,58872,PROJECT DELAYED DUE TO CHANGES IN SCOPE/DESIGN,,"CONSTRUCTION OG RIGHT OF WAY BIOSWALES, RIGHT OF WAY GREENSTRIPS, STORMWATER",cpd11-20qn.pdf
SEQ-RAILP,CONSTRUCTION FOR RAILROAD PARK,826,DEPT ENVIRONMENTAL PROTECTION,BLUEBELT PROGRAM,412 413,QUEENS,SE-0005,2250,0,2250,0,0,0,0,0,2250,0,2250,0,0,0,0,0,2250,0,4500,0,0,0,0,0,4500,,,CONSTRUCTION OF RAILROAD PARK,cpd11-20qn.pdf
SEQ-SJH,CONSTRUCTION FOR CLOUDBURST PROJECT AT SOUTH JAMAICA HOUSES,826,DEPT ENVIRONMENTAL PROTECTION,BLUEBELT PROGRAM,412 413,QUEENS,SE-0005,5000,0,0,5000,0,0,0,0,5000,0,0,5000,0,0,0,0,5000,0,0,10000,0,0,0,0,10000,,,CONSTRUCTION FOR CLOUDBURST PROJECT AT SOUTH JAMAICA HOUSES,cpd11-20qn.pdf
SEQ-STA,CONSTRUCTION FOR CLOUDBURST PROJECT AT ST ALBANS,826,DEPT ENVIRONMENTAL PROTECTION,BLUEBELT PROGRAM,412 413,QUEENS,SE-0005,2800,0,0,2800,0,0,0,0,2800,0,0,2800,0,0,0,0,2800,0,0,5600,0,0,0,0,5600,,,CONSTRUCTION FOR CLOUDBURST PROJECT AT ST ALBANS,cpd11-20qn.pdf
SF-BNR-RK,STEP FEED BNR AT ROCKAWAY,826,DEPT ENVIRONMENTAL PROTECTION,BIOLOGICAL NUTRIENT REMOVAL,400 414,QUEENS,WP-0285,27250,19676,114,0,0,0,0,0,19790,19676,114,0,0,0,0,0,19790,39352,228,0,0,0,0,0,39580,PROJECT DELAYED PENDING RESOLUTION OF LEGAL ISSUES,,THIS PROJECT IS TO RETROFIT THE EXISTING ROCKAWAY WWTP FOR THE STEP FEED BNR PROCESS.,cpd11-20qn.pdf
STA24TNKS,STATION 24 GROUNDWATER TANKS DEMOLITION,826,DEPT ENVIRONMENTAL PROTECTION,FACILITY PURCHASES AND RECONSTRUCTION,400,QUEENS,EP-0006,2500,0,0,0,0,100,0,0,100,0,0,0,0,100,0,0,100,0,0,0,0,200,0,0,200,PROJECT DELAYED DUE TO BUDGETARY CONSTRAINTS,,"DEMOLITION, REMOVAL AND DISPOSAL OF TWO (2) ON-GROUND WATER TANKS AT STATION 24, BWSO",cpd11-20qn.pdf
TI-167-L,RECONSTRUCTION OF SEAWALL/DOCK @ TALLMAN ISLAND WPCP,826,DEPT ENVIRONMENTAL PROTECTION,PLANT UPGRADING AND RECONSTRUCTION,400 407,QUEENS,WP-0112,14041,2596,476,0,0,15000,0,0,18072,2596,476,0,0,15000,0,0,18072,5192,952,0,0,30000,0,0,36144,,"127 STREET AND EAST RIVER, COLLEGE POINT, N.Y. 11356",RECONSTRUCTION OF SEAWALL/DOCK AT THE TALLMAN ISLAND WPCP,cpd11-20qn.pdf
TI-168-L,HEADWORKS IMPROVEMENTS AT THE TALLMAN ISLAND WPCP,826,DEPT ENVIRONMENTAL PROTECTION,PLANT UPGRADING AND RECONSTRUCTION,400 407,QUEENS,WP-0112,11273,5294,569,0,40000,0,0,0,45863,5294,569,0,40000,0,0,0,45863,10588,1138,0,80000,0,0,0,91726,,"127 STREET AND EAST RIVER, COLLEGE POINT, N.Y. 11356",HEADWORKS IMPROVEMENTS AT THE TALLMAN ISLAND WPCP,cpd11-20qn.pdf
TI-169-L,RECONSTRUCT OF THE POWER DISTRIBUTION AT TALLMAN ISLAND WPCP,826,DEPT ENVIRONMENTAL PROTECTION,PLANT UPGRADING AND RECONSTRUCTION,400 407,QUEENS,WP-0112,7269,7448,858,0,50000,0,0,0,58306,7448,858,0,50000,0,0,0,58306,14896,1716,0,100000,0,0,0,116612,,"127TH STREET & EAST RIVER, COLLEGE POINT, N.Y. 11356",RECONSTRUCTION OF THE POWER DISTRIBUTION AT TALLMAN ISLAND WPCP,cpd11-20qn.pdf
TI-174,TRC- Installation of new outfall at Tallman Island WWTP,826,DEPT ENVIRONMENTAL PROTECTION,CONSENT DECREE UPGRADING AND CONSTRUCTION,400,QUEENS,WP-0282,65078,0,0,0,0,0,42198,0,42198,0,0,0,0,0,42198,0,42198,0,0,0,0,0,84396,0,84396,,,"A NEW 96"" OUTFALL APPROXIMATELY 1000 FEET LONG, A NEW JUNCTION CHAMBER TO TIE THE NEW",cpd11-20qn.pdf
TI-177-L,INSTALL ACCESS CONTROL SYSTEM @ TALLMAN ISLAND WWTP,826,DEPT ENVIRONMENTAL PROTECTION,PLANT UPGRADING AND RECONSTRUCTION,400 407,QUEENS,WP-0112,0,0,0,0,0,0,0,2500,2500,0,0,0,0,0,0,2500,2500,0,0,0,0,0,0,5000,5000,,,INSTALL ACCESS CONTROL SYSTEM @ TALLMAN ISLAND WWTP,cpd11-20qn.pdf
TI-5,TALLMAN ISLAND LANDSCAPING UPGRADE & MISC. SITE IMPROVEMENTS,826,DEPT ENVIRONMENTAL PROTECTION,PLANT UPGRADING AND RECONSTRUCTION,407,QUEENS,WP-0249,6000,540,10874,0,0,0,0,0,11414,540,10874,0,0,0,0,0,11414,1080,21748,0,0,0,0,0,22828,,,"NATIVE VEGETATION, INCREASED PARKING CAPACITY, INCORPORATION OF INTERIORLY LOCATED",cpd11-20qn.pdf
TI-STAB,STABILIZATION OF THE TALLMANS' ISLAND WPCP,826,DEPT ENVIRONMENTAL PROTECTION,PLANT COMPONENT STABILIZATION,407,QUEENS,WP-0249,496967,514329,384,0,0,0,0,0,514713,514329,384,0,0,0,0,0,514713,1028658,768,0,0,0,0,0,1029426,PROJECT DELAYED DUE TO BUDGETARY CONSTRAINTS,QUEENS,THE DESIGN FOR THE STABILIZATION OF THE TALLMAN'S ISLAND WPCP,cpd11-20qn.pdf
S136-251E,QUEENS CRS AIR COMPRESSORS REPLACEMENT,827,DEPARTMENT OF SANITATION,GARAGES AND FACILITIES,403,QUEENS,S-0136,130,0,506,0,0,0,0,0,506,0,506,0,0,0,0,0,506,0,1012,0,0,0,0,0,1012,,,AIR COMPRESSORS RUN VARIOUS TYPES OF EQUIPMENT AND FILL TIRES,cpd11-20qn.pdf
S136-251F,QUEENS CRS FIFTH FLOOR SLAB SECTIONS REPLACEMENT,827,DEPARTMENT OF SANITATION,GARAGES AND FACILITIES,403,QUEENS,S-0136,1650,14256,13156,0,0,0,0,0,27412,14256,13156,0,0,0,0,0,27412,28512,26312,0,0,0,0,0,54824,,,REPLACE SECTIONS OF SLAB,cpd11-20qn.pdf
S136-251G,QUEENS CRS Dynamometer Test Cell HVAC Replacement,827,DEPARTMENT OF SANITATION,GARAGES AND FACILITIES,402,QUEENS,S-0136,558,910,49,0,0,0,0,0,959,910,49,0,0,0,0,0,959,1820,98,0,0,0,0,0,1918,,,DYNAMOMETER TEST CELL HVAC,cpd11-20qn.pdf
S136-251H,CRS Water Tank Rehabilitation,827,DEPARTMENT OF SANITATION,GARAGES AND FACILITIES,402,QUEENS,S-0136,282,0,282,0,0,0,0,0,282,0,282,0,0,0,0,0,282,0,564,0,0,0,0,0,564,,,REPLACE LINER OF WATER TANK TO REHABILITATE TANK,cpd11-20qn.pdf
S136-251K,Queens CRS Server Room Air Conditioning,827,DEPARTMENT OF SANITATION,GARAGES AND FACILITIES,400,QUEENS,S-0136,581,75,870,0,0,0,0,0,945,75,870,0,0,0,0,0,945,150,1740,0,0,0,0,0,1890,,,QUEENS CRS SERVER ROOM AIR CONDITIONING,cpd11-20qn.pdf
S136-251V,QUEENS CRS Elevator Reconstruction,827,DEPARTMENT OF SANITATION,GARAGES AND FACILITIES,402,QUEENS,S-0136,2000,4525,184,0,0,0,0,0,4709,4525,184,0,0,0,0,0,4709,9050,368,0,0,0,0,0,9418,PROJECT DELAYED DUE TO BUDGETARY CONSTRAINTS,,RECONSTRUCTION OF ELEVATORS,cpd11-20qn.pdf
S136-264Q,Queens 6 Betts Ave Garage Roof Replacement,827,DEPARTMENT OF SANITATION,GARAGES AND FACILITIES,406,QUEENS,S-0136,1226,2391,115,0,0,0,0,0,2506,2391,115,0,0,0,0,0,2506,4782,230,0,0,0,0,0,5012,PROJECT DELAYED DUE TO UNFORESEEN SITE/FIELD CONDITION,,REPLACE ROOF,cpd11-20qn.pdf
S136-332N,QUEENS 8/10/12 GARAGE REHAB,827,DEPARTMENT OF SANITATION,GARAGES AND FACILITIES,408 410 412,QUEENS,S-0136,23690,1827,112,2123,21169,0,0,0,25231,1827,112,2123,21169,0,0,0,25231,3654,224,4246,42338,0,0,0,50462,,,QUEENS 8/10/12 REHAB,cpd11-20qn.pdf
S136-380F,Queens 1 Garage Boilers Rehabilitation,827,DEPARTMENT OF SANITATION,GARAGES AND FACILITIES,401,QUEENS,S-0136,459,0,459,0,0,0,0,0,459,0,459,0,0,0,0,0,459,0,918,0,0,0,0,0,918,,,BOILERS REHAB,cpd11-20qn.pdf
S136-431,QUEENS 1 GARAGE,827,DEPARTMENT OF SANITATION,GARAGES AND FACILITIES,401,QUEENS,S-0136,150650,0,0,9671,132969,0,0,0,142640,0,0,9671,132969,0,0,0,142640,0,0,19342,265938,0,0,0,285280,PROJECT DELAYED DUE TO UNFORESEEN SITE/FIELD CONDITION,,GARAGE CONSTRUCTION,cpd11-20qn.pdf
S136-431A,Queens 1 Garage Rehabilitation,827,DEPARTMENT OF SANITATION,GARAGES AND FACILITIES,401,QUEENS,S-0136,751,0,1293,0,0,0,0,0,1293,0,1293,0,0,0,0,0,1293,0,2586,0,0,0,0,0,2586,,,STRUCTURAL REHABILITATION TO EXTEND USEFUL LIFE,cpd11-20qn.pdf
S136-442,Queens Northborough Repair Shop Fire Alarm System Replacemen,827,DEPARTMENT OF SANITATION,GARAGES AND FACILITIES,400,QUEENS,S-0136,808,1218,148,0,0,0,0,0,1366,1218,148,0,0,0,0,0,1366,2436,296,0,0,0,0,0,2732,,,REPLACE FIRE ALARM SYSTEM,cpd11-20qn.pdf
S136-445,Queens 6 Betts Ave Garage Rehab,827,DEPARTMENT OF SANITATION,GARAGES AND FACILITIES,406,QUEENS,S-0136,26495,0,175,1801,2828,8336,13355,0,26495,0,175,1801,2828,8336,13355,0,26495,0,350,3602,5656,16672,26710,0,52990,,,REHAB,cpd11-20qn.pdf
S136-449B,Queens 5/5A Site Drainage Rehabilitation,827,DEPARTMENT OF SANITATION,GARAGES AND FACILITIES,405,QUEENS,S-0136,1500,0,277,4407,0,0,0,0,4684,0,277,4407,0,0,0,0,4684,0,554,8814,0,0,0,0,9368,,,"DRAINS, PIPES AND OIL WATER SEPARATOR REPLACEMENT",cpd11-20qn.pdf
S136-464H,Queens Flushing Ave Enforcement Garage Roof Replacement,827,DEPARTMENT OF SANITATION,GARAGES AND FACILITIES,400,QUEENS,S-0136,1848,241,1016,0,0,0,0,0,1257,241,1016,0,0,0,0,0,1257,482,2032,0,0,0,0,0,2514,,,ROOF REPL,cpd11-20qn.pdf
S216-402A,NORTH SHORE MARINE TRANSFER STATION REHABILITATION,827,DEPARTMENT OF SANITATION,SOLID WASTE MANAGEMENT,400 407,QUEENS,S-0216,5462,5137,285,0,0,0,0,0,5422,5137,285,0,0,0,0,0,5422,10274,570,0,0,0,0,0,10844,,,"REHABILITATION OF MTS INCLUDING SLAB, WALL AND FUELING SYSTEM",cpd11-20qn.pdf
S216-402F,NORTH SHORE MTS FUELING SYSTEM,827,DEPARTMENT OF SANITATION,SOLID WASTE MANAGEMENT,400 407,QUEENS,S-0216,909,0,174,735,0,0,0,0,909,0,174,735,0,0,0,0,909,0,348,1470,0,0,0,0,1818,,,INSTALLATION OF FUELING SYSTEM,cpd11-20qn.pdf
SANDQ14EL,Hurricane Sandy Queens 14 Electrical Replacement,827,DEPARTMENT OF SANITATION,GARAGES AND FACILITIES,414,QUEENS,S-0136,3797,1882,56,0,0,0,0,0,1938,1882,56,0,0,0,0,0,1938,3764,112,0,0,0,0,0,3876,,,"REPLACEMENT OF CONDUIT, RAISING OF EQUIPMENT ABOVE FLOOD PLAIN",cpd11-20qn.pdf
HB1070NB,Protective Coating of N blvd Bridges over Flushing River,841,DEPARTMENT OF TRANSPORTATION,Bridge Painting,400,QUEENS,HB-1070,18100,0,0,18100,0,0,0,0,18100,0,0,18100,0,0,0,0,18100,0,0,36200,0,0,0,0,36200,PROJECT DELAYED DUE TO BUDGETARY CONSTRAINTS,PROTECTIVE COATING OF NORTHERN BLVD BRIDGES OVER FLUSHING RIVER,PROTECTIVE COATING OF NORTHERN BLVD BRIDGES OVER FLUSHING RIVER,cpd11-20qn.pdf
HB1070QN,Protective Coating of Various Bridges in Queens,841,DEPARTMENT OF TRANSPORTATION,Bridge Painting,400,QUEENS,HB-1070,11900,0,0,11900,0,0,0,0,11900,0,0,11900,0,0,0,0,11900,0,0,23800,0,0,0,0,23800,PROJECT DELAYED DUE TO BUDGETARY CONSTRAINTS,PROTECTIVE COATING OF VARIOUS BRIDGES IN QUEENS,PROTECTIVE COATING OF VARIOUS BRIDGES IN QUEENS,cpd11-20qn.pdf
HBGATES,Barrier Gates,841,DEPARTMENT OF TRANSPORTATION,Bridge Painting,400,QUEENS,HB-1070,2000,0,0,2400,0,0,0,0,2400,0,0,2400,0,0,0,0,2400,0,0,4800,0,0,0,0,4800,PROJECT DELAYED DUE TO BUDGETARY CONSTRAINTS,BARRIER GATES,BARRIER GATES,cpd11-20qn.pdf
HBQ1114,HEMPSTEAD AVE BR/CIP 2231780,841,DEPARTMENT OF TRANSPORTATION,FAIR BRIDGES,413,QUEENS,HB-1114,24716,576,0,2104,0,0,6740,41531,50951,576,0,2104,0,0,6740,41531,50951,1152,0,4208,0,0,13480,83062,101902,PROJECT DELAYED DUE TO BUDGETARY CONSTRAINTS,NA,,cpd11-20qn.pdf
HBQ1115,UNION TURNPIKE / CROSS ISLAND PKWY 2-23185-0,841,DEPARTMENT OF TRANSPORTATION,BRIDGE LIFE EXTENSION AND MISCELLANEOUS WORK,413,QUEENS,HB-1012 HB-1115,9031,3926,0,867,0,7019,53990,0,65802,3926,0,867,0,7019,53990,0,65802,7852,0,1734,0,14038,107980,0,131604,PROJECT DELAYED DUE TO BUDGETARY CONSTRAINTS,NA,,cpd11-20qn.pdf
HBQ1137,RECON ELLIOT AVE BRIDGE OVER QUEENS BLVD 2-24816-0,841,DEPARTMENT OF TRANSPORTATION,BRIDGE LIFE EXTENSION AND MISCELLANEOUS WORK,406,QUEENS,HB-1137,11529,1558,0,0,0,0,0,23163,24721,1558,0,0,0,0,0,23163,24721,3116,0,0,0,0,0,46326,49442,PROJECT DELAYED DUE TO BUDGETARY CONSTRAINTS,N/A,,cpd11-20qn.pdf
HBQ1203,RECON ROOSEVELT AVE BR OVER VAN WYCK EXPWY QUEENS 2-240507,841,DEPARTMENT OF TRANSPORTATION,FAIR BRIDGES,407,QUEENS,HB-1203 TF-0002,71248,47108,9757,2027,0,0,0,0,58892,47108,9757,2027,0,0,0,0,58892,94216,19514,4054,0,0,0,0,117784,PROJECT DELAYED DUE TO BUDGETARY CONSTRAINTS,"RECONS ROOSEVELT AVE BR OVER VAN WYCK EXPWY, QUEENS","RECONS ROOSEVELT AVE BR OVER VAN WYCK EXPWY, QUEENS",cpd11-20qn.pdf
HBQ231710,Merrick Blvd over BLP NB BIN 2231710,841,DEPARTMENT OF TRANSPORTATION,FAIR BRIDGES,400,QUEENS,HB-0215,24556,0,0,0,3206,0,2669,18681,24556,0,0,0,3206,0,2669,18681,24556,0,0,0,6412,0,5338,37362,49112,PROJECT DELAYED DUE TO BUDGETARY CONSTRAINTS,MERRICK BLVD OVER BLP NB BIN 2231710,MERRICK BLVD OVER BLP NB BIN 2231710,cpd11-20qn.pdf
HBQ231720,Merrick Blvd over BLP SB BIN 2231720,841,DEPARTMENT OF TRANSPORTATION,FAIR BRIDGES,400,QUEENS,HB-0215,23324,0,0,0,3206,0,2515,17603,23324,0,0,0,3206,0,2515,17603,23324,0,0,0,6412,0,5030,35206,46648,PROJECT DELAYED DUE TO BUDGETARY CONSTRAINTS,MERRICK BLVD OVER BLP SB BIN 2231720,MERRICK BLVD OVER BLP SB BIN 2231720,cpd11-20qn.pdf
HBQ49AV,"49TH AVE OVER LIRR, AMT, CON NE (BIN2247290)",841,DEPARTMENT OF TRANSPORTATION,FAIR BRIDGES,400 402,QUEENS,HB-1012 HB-0431,30460,11958,0,405,0,105511,0,0,117874,11958,0,405,0,105511,0,0,117874,23916,0,810,0,211022,0,0,235748,PROJECT DELAYED DUE TO BUDGETARY CONSTRAINTS,"49TH AVE OVER LIRR, AMT, CON NE (BIN2247290)","49TH AVE OVER LIRR, AMT, CON NE (BIN2247290)",cpd11-20qn.pdf
HBQ8019,WOODHAVEN BLVD OVER ATLANTIC AVE,841,DEPARTMENT OF TRANSPORTATION,BRIDGE LIFE EXTENSION AND MISCELLANEOUS WORK,400 405 406 409,QUEENS,HB-1070,37644,0,0,5293,0,0,7589,53695,66577,0,0,5293,0,0,7589,53695,66577,0,0,10586,0,0,15178,107390,133154,PROJECT DELAYED DUE TO BUDGETARY CONSTRAINTS,,REBAH WOODHAVEN BLVD BIN 2248019,cpd11-20qn.pdf
HBQA23081,ASTORIA BLVD EB/ 278I( BQE WEST LEG) BIN# 2230810,841,DEPARTMENT OF TRANSPORTATION,FAIR BRIDGES,400,QUEENS,HB-1012 HB-0215,29201,1764,0,1791,0,26955,0,0,30510,1764,0,1791,0,26955,0,0,30510,3528,0,3582,0,53910,0,0,61020,PROJECT DELAYED DUE TO BUDGETARY CONSTRAINTS,,ASTORIA BLVD EB/ 278I( BQE WEST LEG) BIN# 2230810,cpd11-20qn.pdf
HBQA23176,BCIP OVER DUTCH BROADWAY-115 AVE BIN 2231760,841,DEPARTMENT OF TRANSPORTATION,FAIR BRIDGES,400,QUEENS,HB-1173,24984,900,0,1756,23062,0,0,0,25718,900,0,1756,23062,0,0,0,25718,1800,0,3512,46124,0,0,0,51436,,BCIP OVER DUTCH BROADWAY-115 AVE BIN 2231760,BCIP OVER DUTCH BROADWAY-115 AVE BIN 2231760,cpd11-20qn.pdf
HBQA24750,METROPOLITAN AVE OVER CSX TRANSPORT,841,DEPARTMENT OF TRANSPORTATION,FAIR BRIDGES,400,QUEENS,HB-1141,67102,8166,0,924,63211,0,0,0,72301,8166,0,924,63211,0,0,0,72301,16332,0,1848,126422,0,0,0,144602,,METROPOLITAN AVE OVER CSX TRANSPORT,METROPOLITAN AVE OVER CSX TRANSPORT,cpd11-20qn.pdf
HBQA24815,WOODHAVEN BLVD/ QUEENS BLVD BIN# 2248159,841,DEPARTMENT OF TRANSPORTATION,FAIR BRIDGES,400,QUEENS,HB-1012 HB-0215,40560,2013,0,2028,37032,0,0,0,41073,2013,0,2028,37032,0,0,0,41073,4026,0,4056,74064,0,0,0,82146,,,WOODHAVEN BLVD/ QUEENS BLVD BIN# 2248159,cpd11-20qn.pdf
HBQA26614,HEMPSTEAD AVE OVER BCIP RAMP NB BIN 2266149,841,DEPARTMENT OF TRANSPORTATION,FAIR BRIDGES,400,QUEENS,HB-1012 HB-0215,30911,0,0,2010,0,0,3751,26260,32021,0,0,2010,0,0,3751,26260,32021,0,0,4020,0,0,7502,52520,64042,PROJECT DELAYED DUE TO BUDGETARY CONSTRAINTS,HEMPSTEAD AVE OVER BCIP RAMP NB BIN 2266149,HEMPSTEAD AVE OVER BCIP RAMP NB BIN 2266149,cpd11-20qn.pdf
HBQC064,678I SB TO BCIP EB/ACCESS RD FROM 678I 2-26616-0,841,DEPARTMENT OF TRANSPORTATION,BRIDGE LIFE EXTENSION AND MISCELLANEOUS WORK,400 407,QUEENS,HB-6622,2201,13760,1500,464,0,0,0,0,15724,13760,1500,464,0,0,0,0,15724,27520,3000,928,0,0,0,0,31448,PROJECT DELAYED DUE TO BUDGETARY CONSTRAINTS,ACCESS RD,ACCESS RD FROM 6781,cpd11-20qn.pdf
HBQENB012,Emergency Fender System Northern Blvd WB/EB,841,DEPARTMENT OF TRANSPORTATION,FAIR BRIDGES,400,QUEENS,HB-0215,18100,2105,16284,0,0,0,0,0,18389,2105,16284,0,0,0,0,0,18389,4210,32568,0,0,0,0,0,36778,,EMERGENCY FENDER SYSTEM NORTHERN BLVD WB/EB,EMERGENCY FENDER SYSTEM NORTHERN BLVD WB/EB,cpd11-20qn.pdf
HWCOINFAC,METER PROCESSING FACILITY REHABILITATION,841,DEPARTMENT OF TRANSPORTATION,FACILITY RECONSTRUCTION,400,QUEENS,HW-0003,5750,63,0,0,0,0,6119,612,6794,63,0,0,0,0,6119,612,6794,126,0,0,0,0,12238,1224,13588,PROJECT DELAYED DUE TO BUDGETARY CONSTRAINTS,COIN COLLECTION FACILITY REHABILITATION,COIN COLLECTION FACILITY REHABILITATION,cpd11-20qn.pdf
HWD103100,RECON OF MYRTLE AVE / UNION TURNPIKE ENTRANCE TO FOREST PK,841,DEPARTMENT OF TRANSPORTATION,PRIMARY STREET RECONSTRUCTION,405,QUEENS,HW-D103,120,0,0,0,0,0,120,0,120,0,0,0,0,0,120,0,120,0,0,0,0,0,240,0,240,PROJECT DELAYED DUE TO BUDGETARY CONSTRAINTS,,RECON OF MYRTLE AVE / UNION TURNPIKE ENTRANCE TO FOREST PK,cpd11-20qn.pdf
HWD10312,Safety Improvements at St. Margaret's School,841,DEPARTMENT OF TRANSPORTATION,PRIMARY STREET RECONSTRUCTION,400 405,QUEENS,HW-D103,300,0,0,0,0,0,300,0,300,0,0,0,0,0,300,0,300,0,0,0,0,0,600,0,600,PROJECT DELAYED DUE TO BUDGETARY CONSTRAINTS,SAFETY IMPROVEMENTS AT ST. MARGARET'S SCHOOL,SAFETY IMPROVEMENTS AT ST. MARGARET'S SCHOOL,cpd11-20qn.pdf
HWD10323,Upgrades within the Bayside BID,841,DEPARTMENT OF TRANSPORTATION,INSTALLATION OF LAMPPOSTS AND LUMINAIRES,400,QUEENS,TF-Q503 TF-D503,350,382,0,0,320,68,0,0,770,382,0,0,320,68,0,0,770,764,0,0,640,136,0,0,1540,PROJECT DELAYED DUE TO BUDGETARY CONSTRAINTS,UPGRADES WITHIN THE BAYSIDE BID,UPGRADES WITHIN THE BAYSIDE BID,cpd11-20qn.pdf
HWD10324,Parsons Blvd & 84th Ave & Hoover Ave Ped Safety Improvements,841,DEPARTMENT OF TRANSPORTATION,PRIMARY STREET RECONSTRUCTION,400,QUEENS,HW-D103 HW-Q001,300,0,0,0,0,300,0,0,300,0,0,0,0,300,0,0,300,0,0,0,0,600,0,0,600,PROJECT DELAYED DUE TO BUDGETARY CONSTRAINTS,PARSONS BLVD & 84TH AVE & HOOVER AVE PEDESTRIAN SAFETY IMPROVEMENTS,PARSONS BLVD & 84TH AVE & HOOVER AVE PEDESTRIAN SAFETY IMPROVEMENTS,cpd11-20qn.pdf
HWD10326,Long Island City Bikeway Improvements,841,DEPARTMENT OF TRANSPORTATION,PRIMARY STREET RECONSTRUCTION,400,QUEENS,HW-D103,500,0,0,0,0,0,500,0,500,0,0,0,0,0,500,0,500,0,0,0,0,0,1000,0,1000,PROJECT DELAYED DUE TO BUDGETARY CONSTRAINTS,LONG ISLAND CITY BIKEWAY IMPROVEMENTS,LONG ISLAND CITY BIKEWAY IMPROVEMENTS,cpd11-20qn.pdf
HWD10327,Dutch Kills Pedestrian Safety Project,841,DEPARTMENT OF TRANSPORTATION,PRIMARY STREET RECONSTRUCTION,400,QUEENS,HW-0001Q,2300,0,0,0,0,0,2000,0,2000,0,0,0,0,0,2000,0,2000,0,0,0,0,0,4000,0,4000,PROJECT DELAYED DUE TO BUDGETARY CONSTRAINTS,DUTCH KILLS PEDESTRIAN SAFETY PROJECT,DUTCH KILLS PEDESTRIAN SAFETY PROJECT,cpd11-20qn.pdf
HWD10328,A Safer Intersection at 71st Avenue and Austin Street,841,DEPARTMENT OF TRANSPORTATION,PRIMARY STREET RECONSTRUCTION,400,QUEENS,HW-D103,400,0,0,0,0,0,400,0,400,0,0,0,0,0,400,0,400,0,0,0,0,0,800,0,800,PROJECT DELAYED DUE TO BUDGETARY CONSTRAINTS,A SAFER INTERSECTION AT 71ST AVENUE AND AUSTIN STREET,A SAFER INTERSECTION AT 71ST AVENUE AND AUSTIN STREET,cpd11-20qn.pdf
HWD10330,Median and Street Reconstruction in Broad Channel,841,DEPARTMENT OF TRANSPORTATION,PRIMARY STREET RECONSTRUCTION,400,QUEENS,HW-0001Q,4050,0,0,0,0,0,3750,0,3750,0,0,0,0,0,3750,0,3750,0,0,0,0,0,7500,0,7500,PROJECT DELAYED DUE TO BUDGETARY CONSTRAINTS,MEDIAN AND STREET RECONSTRUCTION IN BROAD CHANNEL,MEDIAN AND STREET RECONSTRUCTION IN BROAD CHANNEL,cpd11-20qn.pdf
HWD10332,Reconstruct Curbs along median of Rockaway Freeway,841,DEPARTMENT OF TRANSPORTATION,PRIMARY STREET RECONSTRUCTION,400,QUEENS,HW-D103,1000,0,0,0,0,0,1000,0,1000,0,0,0,0,0,1000,0,1000,0,0,0,0,0,2000,0,2000,PROJECT DELAYED DUE TO BUDGETARY CONSTRAINTS,RECONSTRUCT CURBS ALONG MEDIAN OF ROCKAWAY FREEWAY.,RECONSTRUCT CURBS ALONG MEDIAN OF ROCKAWAY FREEWAY,cpd11-20qn.pdf
HWDMM011,Union Street Beautification,841,DEPARTMENT OF TRANSPORTATION,PRIMARY STREET RECONSTRUCTION,400 407,QUEENS,HW-D103,500,0,0,0,0,0,500,0,500,0,0,0,0,0,500,0,500,0,0,0,0,0,1000,0,1000,PROJECT DELAYED DUE TO BUDGETARY CONSTRAINTS,UNION STREET BEATIFICATION,UNION STREET BEATIFICATION,cpd11-20qn.pdf
HWHARPADM,Harper Street Administration Building Reconstruction,841,DEPARTMENT OF TRANSPORTATION,FACILITY RECONSTRUCTION,400,QUEENS,HW-0003,40000,0,0,3600,0,121880,0,0,125480,0,0,3600,0,121880,0,0,125480,0,0,7200,0,243760,0,0,250960,PROJECT DELAYED DUE TO BUDGETARY CONSTRAINTS,,HARPER STREET ADMINISTRATION BUILDING RECONSTRUCTION,cpd11-20qn.pdf
HWPEDSF4B,Multi-Site Pedestrian Safety - Phase 4B -- Hoyt Avenue,841,DEPARTMENT OF TRANSPORTATION,PRIMARY STREET RECONSTRUCTION,400,QUEENS,HW-0001Q,1152,0,1461,0,0,0,0,0,1461,0,1461,0,0,0,0,0,1461,0,2922,0,0,0,0,0,2922,PROJECT DELAYED DUE TO BUDGETARY CONSTRAINTS,,MULTI-SITE PEDESTRIAN SAFETY - PHASE 4B -- HOYT AVENUE,cpd11-20qn.pdf
HWQ005-01,Median Updates at Junction/82nd & Ditmars/78-82,841,DEPARTMENT OF TRANSPORTATION,PRIMARY STREET RECONSTRUCTION,400,QUEENS,HW-Q005,4000,0,0,4000,0,0,0,0,4000,0,0,4000,0,0,0,0,4000,0,0,8000,0,0,0,0,8000,PROJECT DELAYED DUE TO BUDGETARY CONSTRAINTS,MEDIAN UPDATES AT JUNCTION/82ND & DITMARS/78-82,MEDIAN UPDATES AT JUNCTION/82ND & DITMARS/78-82,cpd11-20qn.pdf
HWQ100SBS,Woodhaven Blvd SBS,841,DEPARTMENT OF TRANSPORTATION,TRAFFIC WORK IN CONJUNCTION WITH HIGHWAY RECONSTRUCTION,400 405 406 409,QUEENS,HW-D103 HW-Q001 HW-1684 HW-0001Q,3000,374,0,0,0,1888,0,9084,11346,374,0,0,0,1888,0,9084,11346,748,0,0,0,3776,0,18168,22692,PROJECT DELAYED DUE TO BUDGETARY CONSTRAINTS,WOODHAVEN BLVD QUEENS,WOODHAVEN BLVD SBS,cpd11-20qn.pdf
HWQ1190,Reconstruction of Queens Blvd,841,DEPARTMENT OF TRANSPORTATION,PRIMARY STREET RECONSTRUCTION,400,QUEENS,HW-0001Q,98781,2066,0,0,0,0,0,18963,21029,2066,0,0,0,0,0,18963,21029,4132,0,0,0,0,0,37926,42058,PROJECT DELAYED DUE TO BUDGETARY CONSTRAINTS,RECONSTRUCTION OF QUEENS BLVD,RECONSTRUCTION OF QUEENS BLVD,cpd11-20qn.pdf
HWQ1192,Jewel Ave,841,DEPARTMENT OF TRANSPORTATION,PRIMARY STREET RECONSTRUCTION,400,QUEENS,HW-0001Q,1500,0,0,0,0,0,0,1500,1500,0,0,0,0,0,0,1500,1500,0,0,0,0,0,0,3000,3000,PROJECT DELAYED DUE TO BUDGETARY CONSTRAINTS,JEWEL AVE,JEWEL AVE,cpd11-20qn.pdf
HWQ1196,Cloudburst Project - St Albans,841,DEPARTMENT OF TRANSPORTATION,PRIMARY STREET RECONSTRUCTION,400,QUEENS,HW-0001Q,31758,0,0,0,0,0,0,31758,31758,0,0,0,0,0,0,31758,31758,0,0,0,0,0,0,63516,63516,PROJECT DELAYED DUE TO BUDGETARY CONSTRAINTS,,CLOUDBURST PROJECT - ST ALBANS,cpd11-20qn.pdf
HWQ1197,Astoria Boulevard Safety Improvements,841,DEPARTMENT OF TRANSPORTATION,PRIMARY STREET RECONSTRUCTION,400,QUEENS,HW-0001Q HW-D105,11733,0,0,0,0,11733,0,0,11733,0,0,0,0,11733,0,0,11733,0,0,0,0,23466,0,0,23466,PROJECT DELAYED DUE TO BUDGETARY CONSTRAINTS,ASTORIA BOULEVARD SAFETY IMPROVEMENTS,ASTORIA BOULEVARD SAFETY IMPROVEMENTS,cpd11-20qn.pdf
HWQ1198,Reconstruction of Beach Channel Drive -- Phase B Non Sandy,841,DEPARTMENT OF TRANSPORTATION,PRIMARY STREET RECONSTRUCTION,400,QUEENS,HW-0001Q,37214,0,0,0,0,37214,0,0,37214,0,0,0,0,37214,0,0,37214,0,0,0,0,74428,0,0,74428,PROJECT DELAYED DUE TO BUDGETARY CONSTRAINTS,RECONSTRUCTION OF BEACH CHANNEL DRIVE -- PHASE B NON SANDY,RECONSTRUCTION OF BEACH CHANNEL DRIVE -- PHASE B NON SANDY,cpd11-20qn.pdf
HWQ1199,Beach 84th Street End,841,DEPARTMENT OF TRANSPORTATION,PRIMARY STREET RECONSTRUCTION,400,QUEENS,HW-0001Q,5289,0,0,0,0,0,5289,0,5289,0,0,0,0,0,5289,0,5289,0,0,0,0,0,10578,0,10578,PROJECT DELAYED DUE TO BUDGETARY CONSTRAINTS,BEACH 84TH STREET,IMPROVEMENT OF THE STREET END ON BEACH 84TH STREET,cpd11-20qn.pdf
HWQ1200,Vision Zero Great Streets Northern Boulevard Phase 1,841,DEPARTMENT OF TRANSPORTATION,PRIMARY STREET RECONSTRUCTION,400,QUEENS,HW-D103 HW-0001Q,78750,0,300,0,0,0,0,78750,79050,0,300,0,0,0,0,78750,79050,0,600,0,0,0,0,157500,158100,PROJECT DELAYED DUE TO BUDGETARY CONSTRAINTS,VISION ZERO GREAT STREETS NORTHERN BOULEVARD PHASE 1,VISION ZERO GREAT STREETS NORTHERN BOULEVARD PHASE 1,cpd11-20qn.pdf
HWQ1201,34TH AVE MALLS IMPROVEMENTS,841,DEPARTMENT OF TRANSPORTATION,PRIMARY STREET RECONSTRUCTION,400,QUEENS,HW-D103,750,0,0,0,0,750,0,0,750,0,0,0,0,750,0,0,750,0,0,0,0,1500,0,0,1500,,34TH AVE MALLS IMPROVEMENTS,34TH AVE MALLS IMPROVEMENTS,cpd11-20qn.pdf
HWQ788,LIC/Hunters Point Area-wide Reconstruction,841,DEPARTMENT OF TRANSPORTATION,PRIMARY STREET RECONSTRUCTION,402,QUEENS,TF-0502 TF-0002 HW-0200 HW-0788,35743,134,0,0,0,0,14506,30247,44887,134,0,0,0,0,14506,30247,44887,268,0,0,0,0,29012,60494,89774,PROJECT DELAYED DUE TO BUDGETARY CONSTRAINTS,"AREA BOUNDED BY 44TH DRIVE, JACKSON AVENUE, BORDEN AVENUE, AND U S PIERHEAD                            LINE",21 & 11 STS,cpd11-20qn.pdf
HWQ789,THOMSON AVE. SAFETY IMPROVEMENTS -- LAGUARDIA COMM. COLLEGE,841,DEPARTMENT OF TRANSPORTATION,PRIMARY STREET RECONSTRUCTION,400,QUEENS,HW-0001Q,17000,0,164,0,0,0,21983,0,22147,0,164,0,0,0,21983,0,22147,0,328,0,0,0,43966,0,44294,PROJECT DELAYED DUE TO BUDGETARY CONSTRAINTS,THOMSON AVE. SAFETY IMPROVEMENTS -- LAGUARDIA COMMUNITY COLLEGE,THOMSON AVE. SAFETY IMPROVEMENTS -- LAGUARDIA COMMUNITY COLLEGE,cpd11-20qn.pdf
HWQ985A,Shore Road Embankment Repair,841,DEPARTMENT OF TRANSPORTATION,PRIMARY STREET RECONSTRUCTION,400,QUEENS,HW-0988,4000,0,0,0,0,0,4000,0,4000,0,0,0,0,0,4000,0,4000,0,0,0,0,0,8000,0,8000,PROJECT DELAYED DUE TO BUDGETARY CONSTRAINTS,SHORE ROAD EMBANKMENT REPAIR,SHORE ROAD EMBANKMENT REPAIR,cpd11-20qn.pdf
HWQF031C,Glendale Yard Pre-Engineered Shed,841,DEPARTMENT OF TRANSPORTATION,FACILITY RECONSTRUCTION,,QUEENS,HW-0003,348,98,0,0,0,0,0,250,348,98,0,0,0,0,0,250,348,196,0,0,0,0,0,500,696,PROJECT DELAYED DUE TO BUDGETARY CONSTRAINTS,"GLENDALE YARD, QUEENS",REBUILD EXISTING GARAGE SPACE,cpd11-20qn.pdf
HWQF041,QUEENS SAFETY CITY CONSTRUCTION 2,841,DEPARTMENT OF TRANSPORTATION,FACILITY RECONSTRUCTION,400,QUEENS,HW-0003,7638,0,0,0,0,0,0,7796,7796,0,0,0,0,0,0,7796,7796,0,0,0,0,0,0,15592,15592,PROJECT DELAYED DUE TO BUDGETARY CONSTRAINTS,QUEENS SAFTERY CITY CONSTRUCTION 2,QUEENS SAFETY CITY CONSTRUCTION 2,cpd11-20qn.pdf
HWQF12ST,38-21 12th Street Rehabilitation,841,DEPARTMENT OF TRANSPORTATION,FACILITY RECONSTRUCTION,400,QUEENS,HW-0003,2500,0,0,0,0,0,0,2500,2500,0,0,0,0,0,0,2500,2500,0,0,0,0,0,0,5000,5000,PROJECT DELAYED DUE TO BUDGETARY CONSTRAINTS,,38-21 12TH STREET REHABILITATION,cpd11-20qn.pdf
HWQF2002V,GLENDALE YARD TRAILERS,841,DEPARTMENT OF TRANSPORTATION,FACILITY RECONSTRUCTION,400 406,QUEENS,HW-0003,5049,1343,228,2258,0,0,0,0,3829,1343,228,2258,0,0,0,0,3829,2686,456,4516,0,0,0,0,7658,PROJECT DELAYED DUE TO BUDGETARY CONSTRAINTS,SYBILLA STREET FACILITY RENOVATION,SYBILLA STREET FACILITY RENOVATION,cpd11-20qn.pdf
HWQF4200V,Installation of Sewer & Water Services for 4200 Vernon Blvd.,841,DEPARTMENT OF TRANSPORTATION,FACILITY RECONSTRUCTION,400,QUEENS,HW-0003,168,0,168,0,0,0,0,0,168,0,168,0,0,0,0,0,168,0,336,0,0,0,0,0,336,PROJECT DELAYED DUE TO BUDGETARY CONSTRAINTS,INSTALLATION OF SEWER & WATER SERVICES FOR 4200 VERNON BLVD.,INSTALLATION OF SEWER & WATER SERVICES FOR 4200 VERNON BLVD.,cpd11-20qn.pdf
HWQFSW033,33-00 Northern Blvd Swing Space,841,DEPARTMENT OF TRANSPORTATION,FACILITY RECONSTRUCTION,400,QUEENS,HW-0003,6619,0,1500,5119,0,0,0,0,6619,0,1500,5119,0,0,0,0,6619,0,3000,10238,0,0,0,0,13238,PROJECT DELAYED DUE TO BUDGETARY CONSTRAINTS,3300 NORTHERN BLVD QUEENS,SWING SPACE FOR THE REHAB OF 28-11 QPN.,cpd11-20qn.pdf
HWQMASPET,Maspeth Climate Control and Air Quality Improvements,841,DEPARTMENT OF TRANSPORTATION,FACILITY RECONSTRUCTION,400 402,QUEENS,HW-0003,5301,0,0,8106,0,85894,0,0,94000,0,0,8106,0,85894,0,0,94000,0,0,16212,0,171788,0,0,188000,PROJECT DELAYED DUE TO BUDGETARY CONSTRAINTS,58-50 57TH ROAD,MASPETH CLIMATE CONTROL AND AIR QUALITY IMPROVEMENTS,cpd11-20qn.pdf
HWQSE877,Woodhaven Blvd SBS SE-877,841,DEPARTMENT OF TRANSPORTATION,PRIMARY STREET RECONSTRUCTION,400,QUEENS,HW-0988,22292,0,0,0,0,0,0,32925,32925,0,0,0,0,0,0,32925,32925,0,0,0,0,0,0,65850,65850,PROJECT DELAYED DUE TO BUDGETARY CONSTRAINTS,WOODHAVEN BLVD SBS SE-877,WOODHAVEN BLVD SBS SE-877,cpd11-20qn.pdf
HWQWILLPT,Willets Point Engineered Resurfacing,841,DEPARTMENT OF TRANSPORTATION,PRIMARY STREET RECONSTRUCTION,400,QUEENS,HW-0988,17670,0,0,0,0,0,0,17670,17670,0,0,0,0,0,0,17670,17670,0,0,0,0,0,0,35340,35340,PROJECT DELAYED DUE TO BUDGETARY CONSTRAINTS,WILLETS POINT ENGINEERED RESURFACING,WILLETS POINT ENGINEERED RESURFACING,cpd11-20qn.pdf
HWS2021Q1,PRIOR NOTICE SIDEWALK - QUEENS,841,DEPARTMENT OF TRANSPORTATION,SIDEWALK RECONSTRUCTION,400,QUEENS,HW-0200 P-1331,14645,0,12731,0,0,0,0,0,12731,0,12731,0,0,0,0,0,12731,0,25462,0,0,0,0,0,25462,,PRIOR NOTICE SIDEWALKS - QUEENS,PRIOR NOTICE SIDEWALKS - QUEENS,cpd11-20qn.pdf
HWS2021Q2,PRIOR NOTICE SIDEWALK - QUEENS,841,DEPARTMENT OF TRANSPORTATION,SIDEWALK RECONSTRUCTION,400,QUEENS,P-1331,727,0,727,0,0,0,0,0,727,0,727,0,0,0,0,0,727,0,1454,0,0,0,0,0,1454,,PRIOR NOTICE SIDEWALKS - QUEENS,PRIOR NOTICE SIDEWALKS - QUEENS,cpd11-20qn.pdf
HWWATER37,37TH AVE DOT MOVE DUE TO DEP WATER TUN 3,841,DEPARTMENT OF TRANSPORTATION,FACILITY RECONSTRUCTION,400,QUEENS,W-0013,3873,739,3133,0,0,0,0,0,3872,739,3133,0,0,0,0,0,3872,1478,6266,0,0,0,0,0,7744,PROJECT DELAYED DUE TO BUDGETARY CONSTRAINTS,37TH AVE DOT MOVE DUE TO DEP WATER TUN 3,37TH AVE DOT MOVE DUE TO DEP WATER TUN 3,cpd11-20qn.pdf
JAMASTPLZ,Greater Jamaica Dev Corp Station Plaza Acquisition,841,DEPARTMENT OF TRANSPORTATION,COMMERCIAL DEVELOPMENT,400 412,QUEENS,ED-0075,5820,3353,311,0,0,0,0,0,3664,3353,311,0,0,0,0,0,3664,6706,622,0,0,0,0,0,7328,PROJECT DELAYED DUE TO BUDGETARY CONSTRAINTS,,GJDC STATION PLAZA ACQUISITION,cpd11-20qn.pdf
QUEENSCWH,QUEENS COMMERCIAL CORRIDOR AT WOODHAVEN,841,DEPARTMENT OF TRANSPORTATION,MISCELLANEOUS,400,QUEENS,ED-Q384,75,0,75,0,0,0,0,0,75,0,75,0,0,0,0,0,75,0,150,0,0,0,0,0,150,PROJECT DELAYED DUE TO BUDGETARY CONSTRAINTS,,QUEENS COMMERCIAL CORRIDOR AT WOODHAVEN--GREEN STREET WITH TREES AND PLANTINGS AT,cpd11-20qn.pdf
SANDHW11B,Reconstruction of Beach Channel Drive -- Phase B,841,DEPARTMENT OF TRANSPORTATION,PRIMARY STREET RECONSTRUCTION,400,QUEENS,HW-0001Q,36343,0,142,0,947,142,0,0,1231,0,142,0,947,142,0,0,1231,0,284,0,1894,284,0,0,2462,PROJECT DELAYED DUE TO BUDGETARY CONSTRAINTS,RECONSTRUCTION OF BEACH CHANNEL DRIVE -- PHASE B,RECONSTRUCTION OF BEACH CHANNEL DRIVE -- PHASE B,cpd11-20qn.pdf
SEQPGRD4,Southeast Queens Priority Grids 31-40,841,DEPARTMENT OF TRANSPORTATION,PRIMARY STREET RECONSTRUCTION,400,QUEENS,HW-0001Q,17695,0,0,0,0,0,0,17695,17695,0,0,0,0,0,0,17695,17695,0,0,0,0,0,0,35390,35390,PROJECT DELAYED DUE TO BUDGETARY CONSTRAINTS,,SOUTHEAST QUEENS PRIORITY GRIDS 31-40,cpd11-20qn.pdf
SEQPGRD5,Southeast Queens Priority Grids 41-50,841,DEPARTMENT OF TRANSPORTATION,PRIMARY STREET RECONSTRUCTION,400,QUEENS,HW-0001Q,17784,0,0,0,0,0,0,17784,17784,0,0,0,0,0,0,17784,17784,0,0,0,0,0,0,35568,35568,PROJECT DELAYED DUE TO BUDGETARY CONSTRAINTS,,SOUTHEAST QUEENS PRIORITY GRIDS 41-50,cpd11-20qn.pdf
TF072017,Extension of lighting project Woodhaven,841,DEPARTMENT OF TRANSPORTATION,INSTALLATION OF LAMPPOSTS AND LUMINAIRES,400,QUEENS,TF-Q503,500,0,0,0,500,0,0,0,500,0,0,0,500,0,0,0,500,0,0,0,1000,0,0,0,1000,,,EXTENSION OF EXISTNG LIGHTING PROJECT (841 QUEENSCJW) TO INCLUDE JAMAICA AVENUE FROM,cpd11-20qn.pdf
TF18-2020,STEINWAY #1&2 MUNICIPAL PARKING FIELDS,841,DEPARTMENT OF TRANSPORTATION,"Parking Meters, Lots, and Garages",400 401,QUEENS,TF-0018,950,0,0,0,0,0,0,182,182,0,0,0,0,0,0,182,182,0,0,0,0,0,0,364,364,PROJECT DELAYED DUE TO BUDGETARY CONSTRAINTS,,RECON OF PARKING FIELDS,cpd11-20qn.pdf
TF50308,St lg Poles,841,DEPARTMENT OF TRANSPORTATION,INSTALLATION OF LAMPPOSTS AND LUMINAIRES,400,QUEENS,TF-0503,685,0,0,0,0,0,0,0,0,0,0,0,0,0,0,0,0,0,0,0,0,0,0,0,0,PROJECT DELAYED DUE TO BUDGETARY CONSTRAINTS,,REPLACE/INSTALL STREET LIGHTING POLES,cpd11-20qn.pdf
TF50310,"Rlp lg brackets 102nd St and 159 Ave, -XMA123.30A",841,DEPARTMENT OF TRANSPORTATION,INSTALLATION OF LAMPPOSTS AND LUMINAIRES,400,QUEENS,TF-0503,36,0,0,0,0,0,0,0,0,0,0,0,0,0,0,0,0,0,0,0,0,0,0,0,0,PROJECT DELAYED DUE TO BUDGETARY CONSTRAINTS,,102ND STREET (FROM 160TH TO 159TH AVENUE) AND 159TH AVENUE (FROM 102ND TO 103RD STREET),cpd11-20qn.pdf
TF50312,St lg repl Union Turnpike,841,DEPARTMENT OF TRANSPORTATION,INSTALLATION OF LAMPPOSTS AND LUMINAIRES,400,QUEENS,TF-0503,660,0,0,0,0,0,0,0,0,0,0,0,0,0,0,0,0,0,0,0,0,0,0,0,0,PROJECT DELAYED DUE TO BUDGETARY CONSTRAINTS,,STREET LIGHTING REPLACEMENT,cpd11-20qn.pdf
TFD503-04,ROOSEVELT AVENUE STREET LIGHTING,841,DEPARTMENT OF TRANSPORTATION,INSTALLATION OF LAMPPOSTS AND LUMINAIRES,,QUEENS,TF-D503,500,529,0,0,0,56,0,0,585,529,0,0,0,56,0,0,585,1058,0,0,0,112,0,0,1170,PROJECT DELAYED DUE TO BUDGETARY CONSTRAINTS,ROOSEVELT AVENUE STREET LIGHTING,ROOSEVELT AVENUE STREET LIGHTING,cpd11-20qn.pdf
TFD503Q32,MYRTLE AVE DECORATIVE LIGHTING QUEENS,841,DEPARTMENT OF TRANSPORTATION,INSTALLATION OF LAMPPOSTS AND LUMINAIRES,400,QUEENS,TF-D503,725,434,0,0,0,301,0,0,735,434,0,0,0,301,0,0,735,868,0,0,0,602,0,0,1470,PROJECT DELAYED DUE TO BUDGETARY CONSTRAINTS,,MYRTLE AVE DECRATIVE LIGHTING QUEENS,cpd11-20qn.pdf
TFWHSBSRT,SBS - Real Time Totem System,841,DEPARTMENT OF TRANSPORTATION,SIGNAL INSTALLATION AND COMPUTERIZATION,400,QUEENS,TF-0001,517,1521,0,186,0,0,0,0,1707,1521,0,186,0,0,0,0,1707,3042,0,372,0,0,0,0,3414,,WOODHAVEN SBS - REAL TIME TOTEM SIGNS,WOODHAVEN SBS - REAL TIME TOTEM SIGNS,cpd11-20qn.pdf
WHAMBEACH,HAMILTON BEACH BULKHEADS AND ROADWAYS,841,DEPARTMENT OF TRANSPORTATION,PRIMARY STREET RECONSTRUCTION,410,QUEENS,HW-D103,597,0,0,0,0,0,0,597,597,0,0,0,0,0,0,597,597,0,0,0,0,0,0,1194,1194,PROJECT DELAYED DUE TO BUDGETARY CONSTRAINTS,HAMILTON BEACH AREA BULKHEADS AND ROADWAYS,HAMILTON BEACH AREA BULKHEADS AND ROADWAYS,cpd11-20qn.pdf
GQGIKISE,GI - CONS OF PARKLAND RETROFITS IN KISSENA PK,846,DEPT OF PARKS AND RECREATION,GREEN INFRASTRUCTURE PROGRAM,400,QUEENS,WP-0169 P-0822,1906,219,36,457,0,0,0,0,712,219,36,457,0,0,0,0,712,438,72,914,0,0,0,0,1424,PROJECT DELAYED DUE TO CHANGES IN SCOPE/DESIGN,"KISSENA PK AND KISSENA CORRIDOR, QUEENS",GI - CONS OF PARKLAND RETROFITS IN KISSENA PK AND KISSENA CORRIDOR,cpd11-20qn.pdf
GQQNGI-01,GI - DSGN & CONS OF PARKLAND RETROFITS IN QUEENS,846,DEPT OF PARKS AND RECREATION,GREEN INFRASTRUCTURE PROGRAM,400,QUEENS,WP-0169,1861,258,0,4091,0,0,0,0,4349,258,0,4091,0,0,0,0,4349,516,0,8182,0,0,0,0,8698,,,GI - DSGN & CONS OF PARKLAND RETROFITS IN QUEENS,cpd11-20qn.pdf
LIC-CTSQP,LIC- Court Square Park - Q267-120M,846,DEPT OF PARKS AND RECREATION,NEIGHBORHOOD PARKS AND PLAYGROUNDS,400 402,QUEENS,ED-0075,4364,100,800,3200,0,0,0,0,4100,100,800,3200,0,0,0,0,4100,200,1600,6400,0,0,0,0,8200,,"JACKSON AVENUE, BETWEEN COURT SQUARE AND THOMSON AVENUE",COURT SQUARE PARK,cpd11-20qn.pdf
LIC-QNBBP,LIC-Queensbridge Baby Park Q104,846,DEPT OF PARKS AND RECREATION,MAJOR RECREATIONAL FACILITIES AND FACILITY RECONSTRUCTION,400,QUEENS,ED-0075,11000,50,2200,0,8800,0,0,0,11050,50,2200,0,8800,0,0,0,11050,100,4400,0,17600,0,0,0,22100,,"QUEENSBORO BRIDGE, 41 ROAD, 40 AVENUE, BETWEEN THE EAST RIVER VERNON BLVD AND 21 STREET",QUEENSBRIDGE BABY PARK,cpd11-20qn.pdf
NDF-NMKE1,Nameoke Avenue Park- Site Work-Q509-220M,846,DEPT OF PARKS AND RECREATION,"LARGE, MAJOR AND REGIONAL PARK RECONSTRUCTION",400,QUEENS,ED-0384,5826,125,5826,0,0,0,0,0,5951,125,5826,0,0,0,0,0,5951,250,11652,0,0,0,0,0,11902,,NAMEOKE AVENUE,SITE WORK AT NAMEOKE AVENUE PARK,cpd11-20qn.pdf
NDF-NMKE2,Nameoke Avenue Park- Comfort Station,846,DEPT OF PARKS AND RECREATION,"LARGE, MAJOR AND REGIONAL PARK RECONSTRUCTION",400,QUEENS,ED-0384,3720,50,3720,0,0,0,0,0,3770,50,3720,0,0,0,0,0,3770,100,7440,0,0,0,0,0,7540,,NAMEOKE AVENUE,COMFORT STATION AT NAMEOKE AVENUE PARK,cpd11-20qn.pdf
NDF-RDFR,NDF - Redfern Playground,846,DEPT OF PARKS AND RECREATION,NEIGHBORHOOD PARKS AND PLAYGROUNDS,400,QUEENS,ED-0384,9300,402,9300,0,0,0,0,0,9702,402,9300,0,0,0,0,0,9702,804,18600,0,0,0,0,0,19404,,,"NEIGHBORHOOD DEVELOPMENT FUND - REDFERN PLAYGROUND, BOROUGH OF QUEENS",cpd11-20qn.pdf
P-205D17H,HIGHLAND PK BF - RENOV. BASEBALL FLD 1&2 Q020-111M,846,DEPT OF PARKS AND RECREATION,"LARGE, MAJOR AND REGIONAL PARK RECONSTRUCTION",405,QUEENS,P-D019,2000,3306,189,0,0,0,0,0,3495,3306,189,0,0,0,0,0,3495,6612,378,0,0,0,0,0,6990,PROJECT DELAYED DUE TO UNFORESEEN SITE/FIELD CONDITION,"BOROUGH OF BROOKLYN - INTERBOROUGH PKWY, JAMAICA AVENUE, BULVER PLACE",RENOVATIONS OF OF BASEBALL FIELDS 1 AND 2,cpd11-20qn.pdf
P-218MPNC,MARINE PARK- SALT MARSH CTR B057-115M,846,DEPT OF PARKS AND RECREATION,"LARGE, MAJOR AND REGIONAL PARK RECONSTRUCTION",400,QUEENS,P-1018 P-0506,777,353,0,1961,0,0,0,0,2314,353,0,1961,0,0,0,0,2314,706,0,3922,0,0,0,0,4628,,BROOKLYN,MARINE PARK- SALT MARSH CTR,cpd11-20qn.pdf
P-400LNCP,Challenge Playground R/C Q346-118M,846,DEPT OF PARKS AND RECREATION,NEIGHBORHOOD PARKS AND PLAYGROUNDS,400 411,QUEENS,P-Q245 P-D019,4165,321,212,2770,0,0,0,0,3303,321,212,2770,0,0,0,0,3303,642,424,5540,0,0,0,0,6606,PROJECT DELAYED DUE TO BUDGETARY CONSTRAINTS,CHALLENGE PLAYGROUND,CHALLENGE PLAYGROUND,cpd11-20qn.pdf
P-400MEAD,FMCP - MEADOW LAKE Q099-511M,846,DEPT OF PARKS AND RECREATION,"LARGE, MAJOR AND REGIONAL PARK RECONSTRUCTION",400 403 404 406 407 408,QUEENS,P-D019,1142,1882,90,0,0,0,0,0,1972,1882,90,0,0,0,0,0,1972,3764,180,0,0,0,0,0,3944,PROJECT DELAYED DUE TO UNFORESEEN SITE/FIELD CONDITION,FLUSHING MEADOW CORONA PARK,RECON,cpd11-20qn.pdf
P-400QZOO,QUEENS ZOO - AVIARY WALKWAY,846,DEPT OF PARKS AND RECREATION,ZOOS,400,QUEENS,P-Q245,640,374,266,0,0,0,0,0,640,374,266,0,0,0,0,0,640,748,532,0,0,0,0,0,1280,,,QUEENS ZOO RC WOODEN PLATFORMS & RAILINGS Q099-,cpd11-20qn.pdf
P-400SITE,EDERLE SITE Q099-599/899,846,DEPT OF PARKS AND RECREATION,"LARGE, MAJOR AND REGIONAL PARK RECONSTRUCTION",400,QUEENS,P-Q001,13078,13043,35,0,0,0,0,0,13078,13043,35,0,0,0,0,0,13078,26086,70,0,0,0,0,0,26156,PROJECT DELAYED PENDING APPROVAL OF NECESSARY PERMITS,FLUSHING MEADOW PARK,RECON,cpd11-20qn.pdf
P-400ZO17,Queens Zoo - Aviary Mesh Replacement,846,DEPT OF PARKS AND RECREATION,ZOOS,400,QUEENS,P-D019,400,0,0,0,400,0,0,0,400,0,0,0,400,0,0,0,400,0,0,0,800,0,0,0,800,,,QUEENS ZOO,cpd11-20qn.pdf
P-400ZO18,Wildlife Conservation Society Farm Fence,846,DEPT OF PARKS AND RECREATION,ZOOS,400,QUEENS,P-D019 P-0887,600,598,256,0,0,0,0,0,854,598,256,0,0,0,0,0,854,1196,512,0,0,0,0,0,1708,,,WILDLIFE CONSERVATION SOCIETY FARM FENCE AND SHED REPLACEMENT,cpd11-20qn.pdf
P-400ZO20,Queens Zoo - Concessions Roof Replacement,846,DEPT OF PARKS AND RECREATION,ZOOS,400,QUEENS,P-0887,540,0,540,0,0,0,0,0,540,0,540,0,0,0,0,0,540,0,1080,0,0,0,0,0,1080,,QUEENS ZOO - CONCESSIONS ROOF REPLACEMENT,QUEENS ZOO - CONCESSIONS ROOF REPLACEMENT,cpd11-20qn.pdf
P-400ZO22,Queens Zoo - Bear ExhibitGuest Railing/Bench replacement,846,DEPT OF PARKS AND RECREATION,ZOOS,400,QUEENS,P-0887,83,0,0,0,0,83,0,0,83,0,0,0,0,83,0,0,83,0,0,0,0,166,0,0,166,,QUEENS ZOO - BEAR EXHIBITGUEST RAILING/BENCH REPLACEMENT,QUEENS ZOO - BEAR EXHIBITGUEST RAILING/BENCH REPLACEMENT,cpd11-20qn.pdf
P-400ZO23,Queens Zoo - sh/Eagle Boardwalk/Dance Floor Replacement,846,DEPT OF PARKS AND RECREATION,ZOOS,400,QUEENS,P-0887,200,0,200,0,0,0,0,0,200,0,200,0,0,0,0,0,200,0,400,0,0,0,0,0,400,,QUEENS ZOO - SH/EAGLE BOARDWALK/DANCE FLOOR REPLACEMENT,QUEENS ZOO - SH/EAGLE BOARDWALK/DANCE FLOOR REPLACEMENT,cpd11-20qn.pdf
P-400ZOO4,Queens Zoo - Admnistration Building - roof replacement,846,DEPT OF PARKS AND RECREATION,ZOOS,400,QUEENS,P-0887,110,0,0,110,0,0,0,0,110,0,0,110,0,0,0,0,110,0,0,220,0,0,0,0,220,PROJECT DELAYED DUE TO UNFORESEEN SITE/FIELD CONDITION,QUEENS ZOO,REPLACEMENT OF THE ROOF AT THE QUEENS ZOO ADMINISTRATION BUILDING,cpd11-20qn.pdf
P-400ZOO8,Queens Zoo - Education Classroom initiative,846,DEPT OF PARKS AND RECREATION,ZOOS,400,QUEENS,P-D019 P-0887,4308,382,1167,3370,0,0,0,0,4919,382,1167,3370,0,0,0,0,4919,764,2334,6740,0,0,0,0,9838,,QUEENS ZOO,QUEENS ZOO EDUCATION CLASSROOM INITIATIVE -DESIGN,cpd11-20qn.pdf
P-401APFS,Astoria Pool Filtration System,846,DEPT OF PARKS AND RECREATION,NEIGHBORHOOD PARKS AND PLAYGROUNDS,400,QUEENS,P-0990 P-1018,18262,1278,1,700,0,0,16983,0,18962,1278,1,700,0,0,16983,0,18962,2556,2,1400,0,0,33966,0,37924,,ASTORIA POOL FILTRATION SYSTEM,ASTORIA POOL FILTRATION SYSTEM,cpd11-20qn.pdf
P-401APPS,ASTORIA PK POOL RC Q004-113MA,846,DEPT OF PARKS AND RECREATION,"LARGE, MAJOR AND REGIONAL PARK RECONSTRUCTION",400 401,QUEENS,P-0245Q,4300,6084,113,36,0,0,0,0,6233,6084,113,36,0,0,0,0,6233,12168,226,72,0,0,0,0,12466,PROJECT DELAYED DUE TO CHANGES IN SCOPE/DESIGN,,ASTORIA POOL RC AMPHITHEATER AND BATHHOUSE,cpd11-20qn.pdf
P-401ASQP,ATHENS SQUARE PK RC OF PLGDS IN PS17 Q436-107M,846,DEPT OF PARKS AND RECREATION,NEIGHBORHOOD PARKS AND PLAYGROUNDS,400 401,QUEENS,P-D019,1500,1637,0,0,80,0,0,0,1717,1637,0,0,80,0,0,0,1717,3274,0,0,160,0,0,0,3434,PROJECT DELAYED DUE TO UNFORESEEN SITE/FIELD CONDITION,,"REDESIGN EXISTING PLAYGROUND, INSTALL NEW EQUIPMENT, FENCING AND LOCKING PARK",cpd11-20qn.pdf
P-401BSNS,ASTORIA PK- DRAINAGE AT THE TENNIS COURT Q004-102MA1,846,DEPT OF PARKS AND RECREATION,"LARGE, MAJOR AND REGIONAL PARK RECONSTRUCTION",401,QUEENS,P-D019,666,550,0,0,89,0,0,0,639,550,0,0,89,0,0,0,639,1100,0,0,178,0,0,0,1278,PROJECT DELAYED DUE TO CHANGES IN SCOPE/DESIGN,QUEENS,REPAIR CATCH BASINS AT FOUR TENNIS COURTS IN ASTORIA PARK,cpd11-20qn.pdf
P-401DKLL,Dutch Kills Playground R/C Q218-116M,846,DEPT OF PARKS AND RECREATION,"LARGE, MAJOR AND REGIONAL PARK RECONSTRUCTION",400 401,QUEENS,P-0245Q P-D019,3750,3762,0,181,0,0,0,0,3943,3762,0,181,0,0,0,0,3943,7524,0,362,0,0,0,0,7886,,,DUTCH KILLS PLAYGROUND RECONSTRUCTION,cpd11-20qn.pdf
P-401HCSW,Hallets Cove Seawall Q226-118M,846,DEPT OF PARKS AND RECREATION,NEIGHBORHOOD PARKS AND PLAYGROUNDS,400,QUEENS,P-0245Q,3491,4252,788,0,0,0,0,0,5040,4252,788,0,0,0,0,0,5040,8504,1576,0,0,0,0,0,10080,,,HALLETS COVE SEAWALL,cpd11-20qn.pdf
P-401JOEM,Joe Michael's Mile Path and Lighting Q135-214M,846,DEPT OF PARKS AND RECREATION,"LARGE, MAJOR AND REGIONAL PARK RECONSTRUCTION",400 411,QUEENS,P-Q245,2040,1552,46,257,0,0,0,0,1855,1552,46,257,0,0,0,0,1855,3104,92,514,0,0,0,0,3710,PROJECT DELAYED DUE TO CHANGES IN SCOPE/DESIGN,,JOE MICHAELS MILE PATHS AND LIGHTING,cpd11-20qn.pdf
P-401QBHB,Queensbridge Baby Park Handball Courts Q104-119M,846,DEPT OF PARKS AND RECREATION,NEIGHBORHOOD PARKS AND PLAYGROUNDS,400,QUEENS,P-D019,1422,162,0,0,1118,0,0,0,1280,162,0,0,1118,0,0,0,1280,324,0,0,2236,0,0,0,2560,,,"QUEENSBRIDGE BABY PARK UPGRADE 6 HANDBALL COURT WALLS, BOROUGH OF QUEENS",cpd11-20qn.pdf
P-401QSE2,QUEENSBRIDGE PARK FIELDHOUSE CONS. Q104-114M,846,DEPT OF PARKS AND RECREATION,"LARGE, MAJOR AND REGIONAL PARK RECONSTRUCTION",400 401,QUEENS,P-0245Q,2954,6217,137,650,0,0,0,0,7004,6217,137,650,0,0,0,0,7004,12434,274,1300,0,0,0,0,14008,PROJECT DELAYED DUE TO CHANGES IN SCOPE/DESIGN,,DEMOLISH OLD C/S AND CONSTRUCT NEW STATION/FIELDHOUSE,cpd11-20qn.pdf
P-401RAV2,Ravenswood Playground R/C Q333-118M,846,DEPT OF PARKS AND RECREATION,NEIGHBORHOOD PARKS AND PLAYGROUNDS,400,QUEENS,P-Q245 P-0935 P-D019,2760,593,0,6851,0,0,0,0,7444,593,0,6851,0,0,0,0,7444,1186,0,13702,0,0,0,0,14888,,,RAVENSWOOD PLAYGROUND AND PLAY AREA IMPROVEMENTS,cpd11-20qn.pdf
P-401SHOR,Ralph Demarco Park Shoreline Reconstruction Q004-213M,846,DEPT OF PARKS AND RECREATION,NEIGHBORHOOD PARKS AND PLAYGROUNDS,400,QUEENS,P-0245Q,0,0,0,76,0,0,0,0,76,0,0,76,0,0,0,0,76,0,0,152,0,0,0,0,152,,,RALPH DEMARCO PARK SHORELINE RECONSTRUCTION,cpd11-20qn.pdf
P-401SMST,St. Michael's Playground Synthetic Turf Field R/C Q174A-119M,846,DEPT OF PARKS AND RECREATION,NEIGHBORHOOD PARKS AND PLAYGROUNDS,400 401,QUEENS,P-0510,5825,448,333,198,4384,0,0,0,5363,448,333,198,4384,0,0,0,5363,896,666,396,8768,0,0,0,10726,,,"ST. MICHAEL'S PLAYGROUND SYNTHETIC TURF FIELD RECONSTRUCTION, BOROUGHOF QUEENS",cpd11-20qn.pdf
P-401SOC2,Socrates Sculpture Park Building Expansion,846,DEPT OF PARKS AND RECREATION,NEIGHBORHOOD PARKS AND PLAYGROUNDS,400 401,QUEENS,P-Q245 P-D019,720,282,0,4235,0,0,0,0,4517,282,0,4235,0,0,0,0,4517,564,0,8470,0,0,0,0,9034,,,SOCRATES SCULPTURE PARK BUILDING EXPANSION,cpd11-20qn.pdf
P-401SOC3,SOCRATES SCULPTURE PARK -REPAIR TO SEAWALL,846,DEPT OF PARKS AND RECREATION,NEIGHBORHOOD PARKS AND PLAYGROUNDS,400,QUEENS,P-Q245,750,68,69,558,55,0,0,0,750,68,69,558,55,0,0,0,750,136,138,1116,110,0,0,0,1500,,,SOCRATES SCULPTURE PARK -REPAIR TO SEAWALL,cpd11-20qn.pdf
P-401SXOG,Sixteen Oaks Grove Renovations,846,DEPT OF PARKS AND RECREATION,NEIGHBORHOOD PARKS AND PLAYGROUNDS,400,QUEENS,P-D019,1654,89,118,1182,0,0,0,0,1389,89,118,1182,0,0,0,0,1389,178,236,2364,0,0,0,0,2778,,,"SIXTEEN OAKS GROVE RENOVATIONS, BOROUGH OF QUEENS",cpd11-20qn.pdf
P-401TBDR,Triborough Bridge Plgd C Dog Run & Bball Court Q066-116M,846,DEPT OF PARKS AND RECREATION,NEIGHBORHOOD PARKS AND PLAYGROUNDS,400 401,QUEENS,P-D019,1000,1285,0,92,0,0,0,0,1377,1285,0,92,0,0,0,0,1377,2570,0,184,0,0,0,0,2754,PROJECT DELAYED DUE TO CHANGES IN SCOPE/DESIGN,,CONSTRUCTION/RENOVATION OF DOG RUN AND RECONSTRUCTION OF A BASKETBALLCOURT,cpd11-20qn.pdf
P-401WFF,Whitey Ford Field,846,DEPT OF PARKS AND RECREATION,NEIGHBORHOOD PARKS AND PLAYGROUNDS,400,QUEENS,P-0501 PU-0200,1054,96,0,225,737,0,0,0,1058,96,0,225,737,0,0,0,1058,192,0,450,1474,0,0,0,2116,,,WHITEY FORD FIELD,cpd11-20qn.pdf
P-401WFF1,WHITEY FORD FIELD,846,DEPT OF PARKS AND RECREATION,NEIGHBORHOOD PARKS AND PLAYGROUNDS,400 401,QUEENS,P-0245Q,3228,2363,439,0,0,0,0,0,2802,2363,439,0,0,0,0,0,2802,4726,878,0,0,0,0,0,5604,,WHITEY FORD FIELD,WHITEY FORD FIELD,cpd11-20qn.pdf
P-402DBOY,Doughboy Plaza Park Seating Area R/C Q031A-118M,846,DEPT OF PARKS AND RECREATION,NEIGHBORHOOD PARKS AND PLAYGROUNDS,400,QUEENS,P-D019,1996,2003,171,0,0,0,0,0,2174,2003,171,0,0,0,0,0,2174,4006,342,0,0,0,0,0,4348,,,"RECONSTRUCTION OF THE SEATING AREA ADJACENT TO DOUGHBOY MONUMENT, AT DOUGHBOY",cpd11-20qn.pdf
P-402HART,Hart Playground R/C Q067-117MA,846,DEPT OF PARKS AND RECREATION,NEIGHBORHOOD PARKS AND PLAYGROUNDS,400 407,QUEENS,P-Q245,600,3268,281,95,0,0,0,0,3644,3268,281,95,0,0,0,0,3644,6536,562,190,0,0,0,0,7288,PROJECT DELAYED DUE TO CHANGES IN SCOPE/DESIGN,,HART PLGD PLAY EQUIPMENT AND SPRAY SHOWER,cpd11-20qn.pdf
P-402SOHN,Carl R. Sohncke Square Renovations with Flagpole,846,DEPT OF PARKS AND RECREATION,NEIGHBORHOOD PARKS AND PLAYGROUNDS,400 402,QUEENS,P-D019 P-Q245,3410,100,0,0,2250,0,0,0,2350,100,0,0,2250,0,0,0,2350,200,0,0,4500,0,0,0,4700,,"ROOSEVELT, WOODSIDE AVENUES, 58TH STREET","CARL R. SOHNCKE SQUARE RENOVATIONS INCLUDING ADDING A FLAGPOLE BASE AND FLAGPOLE,",cpd11-20qn.pdf
P-402WIN2,WINDMULLER PK RC SEATING AREA AND SLOPE RETENTION Q031-109M,846,DEPT OF PARKS AND RECREATION,NEIGHBORHOOD PARKS AND PLAYGROUNDS,402,QUEENS,P-D019,500,1438,0,53,0,0,0,0,1491,1438,0,53,0,0,0,0,1491,2876,0,106,0,0,0,0,2982,PROJECT DELAYED DUE TO UNFORESEEN SITE/FIELD CONDITION,QUEENS,WINDMULLER PK,cpd11-20qn.pdf
P-4031272,P. S. 127 EAST ELMHURST PLGD PHASE II Q373-112MA2,846,DEPT OF PARKS AND RECREATION,NEIGHBORHOOD PARKS AND PLAYGROUNDS,499,QUEENS,P-D019 P-0245Q,1300,2441,74,0,0,0,0,0,2515,2441,74,0,0,0,0,0,2515,4882,148,0,0,0,0,0,5030,PROJECT DELAYED DUE TO CHANGES IN SCOPE/DESIGN,QUEENS,2/14/18 CP 65757 CL=$1690K...FY19 EXEC ROLL $1289K PD019 & $390K P0245Q TO FY19...FY'19 TRF $249K (,cpd11-20qn.pdf
P-403GOR2,Gorman Playground Upgrades-Q085-120M,846,DEPT OF PARKS AND RECREATION,NEIGHBORHOOD PARKS AND PLAYGROUNDS,400,QUEENS,P-D019,4900,150,0,418,4182,0,0,0,4750,150,0,418,4182,0,0,0,4750,300,0,836,8364,0,0,0,9500,,,"GORMAN PLAYGROUND UPGRADES, BOROUGH OF QUEENS",cpd11-20qn.pdf
P-403GORP,Gorman Park ImprovementS,846,DEPT OF PARKS AND RECREATION,NEIGHBORHOOD PARKS AND PLAYGROUNDS,400,QUEENS,P-D019,1800,0,0,0,1650,0,0,0,1650,0,0,0,1650,0,0,0,1650,0,0,0,3300,0,0,0,3300,,,GORMAN PARK IMPROVEMENT,cpd11-20qn.pdf
P-403NORT,Northern Playground Synthetic Field Upgrade Q363-118M,846,DEPT OF PARKS AND RECREATION,NEIGHBORHOOD PARKS AND PLAYGROUNDS,400,QUEENS,P-D019,2328,119,1750,0,0,0,0,0,1869,119,1750,0,0,0,0,0,1869,238,3500,0,0,0,0,0,3738,,,UPGRADE AND RENOVATE SYNTHETIC FIELD AT NORTHERN PLAYGROUND,cpd11-20qn.pdf
P-403TPP4,Travers Park and Staunton Play Field R/C QG-714M,846,DEPT OF PARKS AND RECREATION,NEIGHBORHOOD PARKS AND PLAYGROUNDS,400 403,QUEENS,HW-1684,3664,7926,496,0,0,0,0,0,8422,7926,496,0,0,0,0,0,8422,15852,992,0,0,0,0,0,16844,PROJECT DELAYED DUE TO CHANGES IN SCOPE/DESIGN,QUEENS,MULTI USE ASPHALT PLAY FIELD RC AND REDESIGN.,cpd11-20qn.pdf
P-403TTOT,Travers Park Tot Lot R/C Q303-117M,846,DEPT OF PARKS AND RECREATION,NEIGHBORHOOD PARKS AND PLAYGROUNDS,400,QUEENS,P-Q245,2000,2277,233,0,0,0,0,0,2510,2277,233,0,0,0,0,0,2510,4554,466,0,0,0,0,0,5020,,,RECONSTRUCTION OF TRAVERS PARK TOT LOT,cpd11-20qn.pdf
P-404CCPS,Moore Homestead Playground R/C Q361-115M,846,DEPT OF PARKS AND RECREATION,NEIGHBORHOOD PARKS AND PLAYGROUNDS,400 404,QUEENS,P-D019 P-1018,2160,5497,83,0,0,0,0,0,5580,5497,83,0,0,0,0,0,5580,10994,166,0,0,0,0,0,11160,PROJECT DELAYED DUE TO CHANGES IN SCOPE/DESIGN,,"C.C, MOORE PLGD & PRE-SCHOOL RC",cpd11-20qn.pdf
P-404CROW,Crowley Playground R/C,846,DEPT OF PARKS AND RECREATION,NEIGHBORHOOD PARKS AND PLAYGROUNDS,400 404,QUEENS,P-Q245 P-D019,300,75,100,600,250,2820,0,0,3845,75,100,600,250,2820,0,0,3845,150,200,1200,500,5640,0,0,7690,PROJECT DELAYED DUE TO CHANGES IN SCOPE/DESIGN,,CROWLEY PLAYGROUND RECONSTRUCTION,cpd11-20qn.pdf
P-404JCPI,Josephine Caminiti Playground Improvements,846,DEPT OF PARKS AND RECREATION,NEIGHBORHOOD PARKS AND PLAYGROUNDS,400,QUEENS,P-D019,3225,0,100,0,2900,0,0,0,3000,0,100,0,2900,0,0,0,3000,0,200,0,5800,0,0,0,6000,,,JOSEPHINE CAMINITI PLAYGROUND,cpd11-20qn.pdf
P-404NTPG,Newtown Playground Paths & Plantings R/C Q041-116M,846,DEPT OF PARKS AND RECREATION,NEIGHBORHOOD PARKS AND PLAYGROUNDS,400 404,QUEENS,P-D019 P-0245Q,1400,1756,132,0,0,0,0,0,1888,1756,132,0,0,0,0,0,1888,3512,264,0,0,0,0,0,3776,PROJECT DELAYED DUE TO CHANGES IN SCOPE/DESIGN,,"ENHANCEMENT OF PASSIVE LAWN AREA, INSTALLATION OF NEW WALKWAYS, DECORATIVE PAVERS,",cpd11-20qn.pdf
P-404PATF,Park of the Americas Renovation- Q026-119M,846,DEPT OF PARKS AND RECREATION,NEIGHBORHOOD PARKS AND PLAYGROUNDS,400,QUEENS,P-D019,1200,164,0,1200,0,0,0,0,1364,164,0,1200,0,0,0,0,1364,328,0,2400,0,0,0,0,2728,,,"PARK OF THE AMERICAS (LINDEN PARK) RENOVATION, BOROUGH OF QUEENS",cpd11-20qn.pdf
P-404PKAM,PARK OF THE AMERICAS BATHROOM IMPROVEMENTS RC Q026,846,DEPT OF PARKS AND RECREATION,NEIGHBORHOOD PARKS AND PLAYGROUNDS,400,QUEENS,P-D019,500,0,0,0,0,500,0,0,500,0,0,0,0,500,0,0,500,0,0,0,0,1000,0,0,1000,,,PARK OF THE AMERICAS BATHROOM IMPROVEMENTS RC,cpd11-20qn.pdf
P-404WFMP,William F. Moore Park Renovation Q029-119M,846,DEPT OF PARKS AND RECREATION,NEIGHBORHOOD PARKS AND PLAYGROUNDS,400,QUEENS,P-D019,700,110,0,700,0,0,0,0,810,110,0,700,0,0,0,0,810,220,0,1400,0,0,0,0,1620,,,"WILLIAM F. MOORE PARK RENOVATION OF PARK, BOROUGH OF QUEENS",cpd11-20qn.pdf
P-404WMPG,William F Moore Park RECONSTRUCTION,846,DEPT OF PARKS AND RECREATION,NEIGHBORHOOD PARKS AND PLAYGROUNDS,400,QUEENS,P-Q245 P-D019,2200,0,850,400,750,0,0,0,2000,0,850,400,750,0,0,0,2000,0,1700,800,1500,0,0,0,4000,,,WILLIAM F MOORE PARK RECONSTRUCTION,cpd11-20qn.pdf
P-405EGPK,EVERGREEN PARK (TOT PLGD RC) Q302-112M,846,DEPT OF PARKS AND RECREATION,NEIGHBORHOOD PARKS AND PLAYGROUNDS,400 405,QUEENS,P-D019,1000,1396,0,62,0,0,0,0,1458,1396,0,62,0,0,0,0,1458,2792,0,124,0,0,0,0,2916,PROJECT DELAYED DUE TO CHANGES IN SCOPE/DESIGN,QUEENS,EVERGREEN PARK (TOT PLGD RC),cpd11-20qn.pdf
P-405EVE2,Evergreen Park R/C Phase II,846,DEPT OF PARKS AND RECREATION,NEIGHBORHOOD PARKS AND PLAYGROUNDS,405,QUEENS,P-D019 P-0938,2100,463,37,0,2000,2100,0,0,4600,463,37,0,2000,2100,0,0,4600,926,74,0,4000,4200,0,0,9200,PROJECT DELAYED DUE TO CHANGES IN SCOPE/DESIGN,,"PHASE II OF THE RECONSTRUCTION OF EVERGREEN PARK, BOROUGH OF QUEENS",cpd11-20qn.pdf
P-405FPCS,FRONTERA PK C/S Q360-104MA2/404M,846,DEPT OF PARKS AND RECREATION,NEIGHBORHOOD PARKS AND PLAYGROUNDS,405,QUEENS,P-D019,716,781,0,0,85,0,0,0,866,781,0,0,85,0,0,0,866,1562,0,0,170,0,0,0,1732,PROJECT DELAYED DUE TO UNFORESEEN SITE/FIELD CONDITION,"LONG ISLAND EXPRESSWAY, 69TH ST., 58TH AVENUE, QUEENS",FRONTERA PARK COMFORT STATION,cpd11-20qn.pdf
P-405HPRR,Highland Park Ridgewood Reservoir Site Restoration,846,DEPT OF PARKS AND RECREATION,NEIGHBORHOOD PARKS AND PLAYGROUNDS,400,QUEENS,P-0896,4771,100,0,0,0,1219,0,0,1319,100,0,0,0,1219,0,0,1319,200,0,0,0,2438,0,0,2638,PROJECT DELAYED DUE TO CHANGES IN SCOPE/DESIGN,,SITE RESTORATION AND IMPROVEMENTS AT THE RIDGEWOOD RESERVOIR IN HIGHLAND PARK,cpd11-20qn.pdf
P-405JP75,JUNIPER PARK - 75TH STREET PLGD Q102-108M,846,DEPT OF PARKS AND RECREATION,NEIGHBORHOOD PARKS AND PLAYGROUNDS,405,QUEENS,P-D019,750,936,0,0,36,0,0,0,972,936,0,0,36,0,0,0,972,1872,0,0,72,0,0,0,1944,PROJECT DELAYED DUE TO UNFORESEEN SITE/FIELD CONDITION,QUEENS,JUNIPER PARK 75TH ST. PLGD,cpd11-20qn.pdf
P-405JPSS,Juniper Valley Park Spray Shower R/C Q102-117M,846,DEPT OF PARKS AND RECREATION,NEIGHBORHOOD PARKS AND PLAYGROUNDS,405,QUEENS,P-Q245,2000,1675,3,532,0,0,0,0,2210,1675,3,532,0,0,0,0,2210,3350,6,1064,0,0,0,0,4420,PROJECT DELAYED DUE TO CHANGES IN SCOPE/DESIGN,,JUNIPER VALLEY PARK,cpd11-20qn.pdf
P-405JPTK,Juniper Valley Park Track & Syn. Turf Field R/C Q102-118M,846,DEPT OF PARKS AND RECREATION,"LARGE, MAJOR AND REGIONAL PARK RECONSTRUCTION",400,QUEENS,P-D019,2500,4359,541,0,0,0,0,0,4900,4359,541,0,0,0,0,0,4900,8718,1082,0,0,0,0,0,9800,PROJECT DELAYED DUE TO UNFORESEEN SITE/FIELD CONDITION,,JUNIPER VALLEY PARK TRACK,cpd11-20qn.pdf
P-405JVBB,Juniper Valley Park Baseball Fields,846,DEPT OF PARKS AND RECREATION,NEIGHBORHOOD PARKS AND PLAYGROUNDS,400,QUEENS,P-D019,2864,100,0,0,2000,2250,0,0,4350,100,0,0,2000,2250,0,0,4350,200,0,0,4000,4500,0,0,8700,,,"JUNIPER VALLEY PARK BASEBALL FIELDS, BOROUGH OF QUEENS",cpd11-20qn.pdf
P-405JVBC,JUNIPER BOCCI COURT Q102-111M,846,DEPT OF PARKS AND RECREATION,"LARGE, MAJOR AND REGIONAL PARK RECONSTRUCTION",400 405,QUEENS,P-D019 P-Q245,50,1042,26,0,27,0,0,0,1095,1042,26,0,27,0,0,0,1095,2084,52,0,54,0,0,0,2190,PROJECT DELAYED DUE TO UNFORESEEN SITE/FIELD CONDITION,,BOCCI COURT,cpd11-20qn.pdf
P-405MPST,Frank Principe Park (Maurice Pk) Synthetic Fields Q131-115M,846,DEPT OF PARKS AND RECREATION,"LARGE, MAJOR AND REGIONAL PARK RECONSTRUCTION",405,QUEENS,P-D019,2050,5469,0,1505,0,0,0,0,6974,5469,0,1505,0,0,0,0,6974,10938,0,3010,0,0,0,0,13948,PROJECT DELAYED DUE TO UNFORESEEN SITE/FIELD CONDITION,"MAURICE AVENUE, QUEENS",MAURICE PARK SYNTHETIC FIELD Q131,cpd11-20qn.pdf
P-405RRGH,Ridgewood Reservoir Gatehouse Rehab,846,DEPT OF PARKS AND RECREATION,NEIGHBORHOOD PARKS AND PLAYGROUNDS,400,QUEENS,P-0896,7228,230,0,0,5300,0,0,0,5530,230,0,0,5300,0,0,0,5530,460,0,0,10600,0,0,0,11060,PROJECT DELAYED DUE TO CHANGES IN SCOPE/DESIGN,,"GATEHOUSE REHAB AT RIDGEWOOD RESERVOIR, IN HIGHLAND PARK, BOROUGH OF QUEENS",cpd11-20qn.pdf
P-405RRIV,Ridgewood Reservoir Invasive Removals,846,DEPT OF PARKS AND RECREATION,NEIGHBORHOOD PARKS AND PLAYGROUNDS,400,QUEENS,P-0896,3250,160,284,2706,260,0,0,0,3410,160,284,2706,260,0,0,0,3410,320,568,5412,520,0,0,0,6820,,,"INVASIVE REMOVALS AT RIDGEWOOD RESERVOIR, IN HIGHLAND PARK, BOROUGH OF QUEENS",cpd11-20qn.pdf
P-405STR2,Starr Playground R/C Phase II Q291-120M,846,DEPT OF PARKS AND RECREATION,NEIGHBORHOOD PARKS AND PLAYGROUNDS,405,QUEENS,P-D019 P-0245Q,1000,150,500,800,0,1000,0,0,2450,150,500,800,0,1000,0,0,2450,300,1000,1600,0,2000,0,0,4900,PROJECT DELAYED DUE TO CHANGES IN SCOPE/DESIGN,,"PHASE II OF THE RECONSTRUCTION OF STARR PLAYGROUND, BOROUGH OF QUEENS",cpd11-20qn.pdf
P-405STRR,Starr Playground MPPA R/C Q291-118M,846,DEPT OF PARKS AND RECREATION,NEIGHBORHOOD PARKS AND PLAYGROUNDS,400,QUEENS,P-D019 P-Q245,2500,339,0,2263,0,0,0,0,2602,339,0,2263,0,0,0,0,2602,678,0,4526,0,0,0,0,5204,,,STARR PLAYGROUND - UPGRADES,cpd11-20qn.pdf
P-406HHPR,HORACE HARDING PLGD RENOVATIONS,846,DEPT OF PARKS AND RECREATION,NEIGHBORHOOD PARKS AND PLAYGROUNDS,400,QUEENS,P-D019,3200,0,100,0,2900,0,0,0,3000,0,100,0,2900,0,0,0,3000,0,200,0,5800,0,0,0,6000,,,HORACE HARDING PLGD RENOVATIONS,cpd11-20qn.pdf
P-406LBA2,LOST BATTALION HALL GYM FLOOR Q401,846,DEPT OF PARKS AND RECREATION,NEIGHBORHOOD PARKS AND PLAYGROUNDS,400 406,QUEENS,P-Q245,1020,0,0,850,0,0,0,0,850,0,0,850,0,0,0,0,850,0,0,1700,0,0,0,0,1700,PROJECT DELAYED DUE TO BUDGETARY CONSTRAINTS,,LOST BATTALION HALL GYM FLOOR Q401,cpd11-20qn.pdf
P-406LBAT,LOST BATTALION HALL RECR CTR - PHASE I & PHASE IV,846,DEPT OF PARKS AND RECREATION,MAJOR RECREATIONAL FACILITIES AND FACILITY RECONSTRUCTION,400,QUEENS,P-Q245,500,657,77,0,0,0,0,0,734,657,77,0,0,0,0,0,734,1314,154,0,0,0,0,0,1468,,"QUEENS BLVD BETWEEN 62ND AVENUE AND 62ND ROAD IN REGO PARK, QUEENS","PHASE I - ADA COMPLIANCY AND HVAC WORK, PHASE IV - UPGRADE LIGHTS ANDELECTRICAL SYSTEMS",cpd11-20qn.pdf
P-406MCDO,GERALD MACDONALD PARK RECONSTRUCTION Q207-103M,846,DEPT OF PARKS AND RECREATION,NEIGHBORHOOD PARKS AND PLAYGROUNDS,406,QUEENS,P-D019,915,812,67,0,0,0,0,0,879,812,67,0,0,0,0,0,879,1624,134,0,0,0,0,0,1758,,"SOUTH OF QUEENS BLVD BET. YELLOWSTONE BLVD AND 70 RD.,QUEENS",RECONSTRUCTION OF GERALD MACDONALD PARK,cpd11-20qn.pdf
P-406PG62,Playground Sixty Two R/C,846,DEPT OF PARKS AND RECREATION,NEIGHBORHOOD PARKS AND PLAYGROUNDS,400 406,QUEENS,P-Q245 P-D019,504,0,100,600,2100,920,0,0,3720,0,100,600,2100,920,0,0,3720,0,200,1200,4200,1840,0,0,7440,PROJECT DELAYED DUE TO CHANGES IN SCOPE/DESIGN,,PLAYGROUND SIXTY TWO,cpd11-20qn.pdf
P-406YPFN,Yellowstone Park Fencing Pt. 1 R/C 68th Avenue Q425-118M,846,DEPT OF PARKS AND RECREATION,NEIGHBORHOOD PARKS AND PLAYGROUNDS,400 406,QUEENS,P-D019,550,75,165,385,0,0,0,0,625,75,165,385,0,0,0,0,625,150,330,770,0,0,0,0,1250,,,"RECONSTRUCTION OF FENCING AT YELLOWSTONE PARK, BOROUGH OF QUEENS",cpd11-20qn.pdf
P-407BAYM,Bayside Marina Electrical Update Q135-115M,846,DEPT OF PARKS AND RECREATION,"LARGE, MAJOR AND REGIONAL PARK RECONSTRUCTION",400,QUEENS,P-1018 P-1245,185,137,48,6,0,0,0,0,191,137,48,6,0,0,0,0,191,274,96,12,0,0,0,0,382,,BAYSIDE MARINA ELECTRICAL UPDATE,BAYSIDE MARINA ELECTRICAL UPDATE,cpd11-20qn.pdf
P-407BLND,Bland Playground Lighting (Q326-120M),846,DEPT OF PARKS AND RECREATION,NEIGHBORHOOD PARKS AND PLAYGROUNDS,400,QUEENS,P-D019 P-Q245,682,607,656,0,4287,500,0,0,6050,607,656,0,4287,500,0,0,6050,1214,1312,0,8574,1000,0,0,12100,PROJECT DELAYED DUE TO CHANGES IN SCOPE/DESIGN,,ADDITION OF LIGHTING AT BLAND PLAYGROUND,cpd11-20qn.pdf
P-407BPFF,BOWNE PK POND R/C Q006-215MA,846,DEPT OF PARKS AND RECREATION,"LARGE, MAJOR AND REGIONAL PARK RECONSTRUCTION",400,QUEENS,P-D019 P-0245Q,1150,399,1794,0,0,0,0,0,2193,399,1794,0,0,0,0,0,2193,798,3588,0,0,0,0,0,4386,PROJECT DELAYED DUE TO CHANGES IN SCOPE/DESIGN,,BOWNE PK FOUNTAINS AND FILTRATION SYSTEMS UPGRADE,cpd11-20qn.pdf
P-407BTPL,Bay Terrace Playground R/C Q399-118M,846,DEPT OF PARKS AND RECREATION,NEIGHBORHOOD PARKS AND PLAYGROUNDS,400,QUEENS,P-Q245 P-D019,1033,450,45,2864,0,0,0,0,3359,450,45,2864,0,0,0,0,3359,900,90,5728,0,0,0,0,6718,,"BAY TERRACE PLAYGROUND, QUEENS",REPAVING OF BASKETBALL AND HANDBALL COURTS,cpd11-20qn.pdf
P-407BWPK,Bowne Park Bocce Court Renovations,846,DEPT OF PARKS AND RECREATION,NEIGHBORHOOD PARKS AND PLAYGROUNDS,400,QUEENS,P-D019,1272,143,0,920,80,115,0,0,1258,143,0,920,80,115,0,0,1258,286,0,1840,160,230,0,0,2516,,,"BOWNE PARK UPGRADE PLAZA ADJACENT TO BOCCE AREA, PROVIDE PASSING SITTING AREA,",cpd11-20qn.pdf
P-407CPSC,College Point Fields Cons. of a Football Field Q476-117M,846,DEPT OF PARKS AND RECREATION,"LARGE, MAJOR AND REGIONAL PARK RECONSTRUCTION",400 407,QUEENS,P-0935 P-D019 P-0245Q,500,1328,0,6122,0,0,0,0,7450,1328,0,6122,0,0,0,0,7450,2656,0,12244,0,0,0,0,14900,PROJECT DELAYED DUE TO CHANGES IN SCOPE/DESIGN,,"CONSTRUCT NEW SYSTHETIC FOOTBALL FIELD, MONDO RUNNING TRACK, PARKING AREA, LIGHTING",cpd11-20qn.pdf
P-407FGP2,Frank Golden Pk - R/C of Athletic Fields Phase II Q445-118M,846,DEPT OF PARKS AND RECREATION,NEIGHBORHOOD PARKS AND PLAYGROUNDS,407,QUEENS,P-Q126,1580,4398,373,0,0,0,0,0,4771,4398,373,0,0,0,0,0,4771,8796,746,0,0,0,0,0,9542,PROJECT DELAYED DUE TO CHANGES IN SCOPE/DESIGN,,FRANK GOLDEN PK -SHANNON GAELS,cpd11-20qn.pdf
P-407FLPT,Francis Lewis Park Pathway and Entrance Way Improvements,846,DEPT OF PARKS AND RECREATION,NEIGHBORHOOD PARKS AND PLAYGROUNDS,400,QUEENS,P-D019,2000,137,0,0,2000,0,0,0,2137,137,0,0,2000,0,0,0,2137,274,0,0,4000,0,0,0,4274,,,"FRANCIS LEWIS PARK PATHWAY AND ENTRANCE WAY REPAVING AND IMPROVEMENTS, BOROUGH OF",cpd11-20qn.pdf
P-407MAPL,Maple Playground R/C Q211-117M,846,DEPT OF PARKS AND RECREATION,NEIGHBORHOOD PARKS AND PLAYGROUNDS,400 407,QUEENS,P-D019 P-Q245,1200,652,0,1,6045,0,0,0,6698,652,0,1,6045,0,0,0,6698,1304,0,2,12090,0,0,0,13396,PROJECT DELAYED DUE TO CHANGES IN SCOPE/DESIGN,,"INSTALL NEW EQUIPMENT, ENTRANCE PAVEMENT, AND SEATING IN MAPLE PLAYGROUND",cpd11-20qn.pdf
P-407MCN4,Herman MacNeil Park Entrance and Pathways,846,DEPT OF PARKS AND RECREATION,NEIGHBORHOOD PARKS AND PLAYGROUNDS,400 407,QUEENS,P-1018,575,39,0,0,0,0,0,0,39,39,0,0,0,0,0,0,39,78,0,0,0,0,0,0,78,,,"IMPOVEMENTS TO THE HERMAN MACNEIL PARK, INCLUDING THE ENTRANCE AND PATHWAYS,",cpd11-20qn.pdf
P-407MCNS,MacNeil Park Steps Construction,846,DEPT OF PARKS AND RECREATION,NEIGHBORHOOD PARKS AND PLAYGROUNDS,400,QUEENS,P-D019 P-Q245,595,128,250,345,0,0,0,0,723,128,250,345,0,0,0,0,723,256,500,690,0,0,0,0,1446,,,"MACNEIL PARK CONSTRUCTION OF GRANITE STEPS, BOROUGH OF QUEENS",cpd11-20qn.pdf
P-407MFL2,Olde Towne of Flushing Burial Ground Monument Cons Q017-118M,846,DEPT OF PARKS AND RECREATION,NEIGHBORHOOD PARKS AND PLAYGROUNDS,400 407,QUEENS,P-0935 P-0245Q,129,1760,294,0,0,0,0,0,2054,1760,294,0,0,0,0,0,2054,3520,588,0,0,0,0,0,4108,PROJECT DELAYED DUE TO CHANGES IN SCOPE/DESIGN,MARTINS FIELD,"THE OLDE TOWNE OF FLUSHING BURIAL GROUND MONUMENT CONSTRUCTION, BOROUGH OF QUEENS",cpd11-20qn.pdf
P-407MNPW,MACNEIL PARK WATERFRONT REPAIRS,846,DEPT OF PARKS AND RECREATION,NEIGHBORHOOD PARKS AND PLAYGROUNDS,400,QUEENS,P-D019,5200,0,100,0,4900,0,0,0,5000,0,100,0,4900,0,0,0,5000,0,200,0,9800,0,0,0,10000,,,MACNEIL PARK WATERFRONT REPAIRS,cpd11-20qn.pdf
P-407MPSW,MACNEIL PARK SEAWALL Q009-114MA,846,DEPT OF PARKS AND RECREATION,NEIGHBORHOOD PARKS AND PLAYGROUNDS,400 407,QUEENS,P-Q245 P-1018,1400,5335,0,641,0,0,0,0,5976,5335,0,641,0,0,0,0,5976,10670,0,1282,0,0,0,0,11952,PROJECT DELAYED DUE TO UNFORESEEN SITE/FIELD CONDITION,,MACNEIL PK SEAWALL,cpd11-20qn.pdf
P-407PWLL,Powells Cove Park - Restoration,846,DEPT OF PARKS AND RECREATION,LAND ACQUISITION AND TREE PLANTING,400 407,QUEENS,P-D019 P-Q245,0,0,0,1600,0,0,0,0,1600,0,0,1600,0,0,0,0,1600,0,0,3200,0,0,0,0,3200,,"BOUROUGH OF QUEENS, - 11TH AVENUE BETWEEN 130 STREET AND POWELLS COVEBLVD & 138 PLACE",POWELLS COVE PARK RESTORATION,cpd11-20qn.pdf
P-407VELO,KISENNA VALLEY PK RC VELODROME,846,DEPT OF PARKS AND RECREATION,NEIGHBORHOOD PARKS AND PLAYGROUNDS,400,QUEENS,P-D019,500,0,0,0,0,500,0,0,500,0,0,0,0,500,0,0,500,0,0,0,0,1000,0,0,1000,PROJECT DELAYED DUE TO CHANGES IN SCOPE/DESIGN,KISENNA VALLEY PK RC VELODROME,KISENNA VALLEY PK RC VELODROME,cpd11-20qn.pdf
P-408BRIA,Briarwood Plgd and Phil Rizzuto Park R/C QG-116MA,846,DEPT OF PARKS AND RECREATION,NEIGHBORHOOD PARKS AND PLAYGROUNDS,400,QUEENS,P-1018,700,1931,150,0,0,0,0,0,2081,1931,150,0,0,0,0,0,2081,3862,300,0,0,0,0,0,4162,PROJECT DELAYED DUE TO CHANGES IN SCOPE/DESIGN,,"BRIARWOOD PLAYGROUND AND PHIL ""SCOOTER"" RIZZUTO PARK RECONSTRUCTION",cpd11-20qn.pdf
P-408CPB2,CUNNINGHAM PARK BALLFIELDS 2-4 UPGRADES Q021-109MA,846,DEPT OF PARKS AND RECREATION,"LARGE, MAJOR AND REGIONAL PARK RECONSTRUCTION",408,QUEENS,P-Q245,2100,1716,160,0,0,0,0,0,1876,1716,160,0,0,0,0,0,1876,3432,320,0,0,0,0,0,3752,PROJECT DELAYED PENDING APPROVAL OF NECESSARY PERMITS,,CUNNINGHAM PARK BALLFIELDS 2-4 UPGRADES Q021-,cpd11-20qn.pdf
P-408CPBF,CUNNINGHAM PARK BALLFIELDS (#1 & #5) Q021-108M,846,DEPT OF PARKS AND RECREATION,NEIGHBORHOOD PARKS AND PLAYGROUNDS,408,QUEENS,P-Q245,1000,1137,74,0,0,0,0,0,1211,1137,74,0,0,0,0,0,1211,2274,148,0,0,0,0,0,2422,PROJECT DELAYED DUE TO UNFORESEEN SITE/FIELD CONDITION,QUEENS,"RC CORE BALL FIELDS TO INCLUDE SYNTHETIC COMPLEX, MUTI-USE SYTHETIC FOOTBALL/SOCCER",cpd11-20qn.pdf
P-408CPGA,Cunningham Park Garage Space Conversion,846,DEPT OF PARKS AND RECREATION,NEIGHBORHOOD PARKS AND PLAYGROUNDS,400,QUEENS,P-0704 P-1018,5670,1983,0,0,0,1061,20199,0,23243,1983,0,0,0,1061,20199,0,23243,3966,0,0,0,2122,40398,0,46486,,,CONVERT A PORTION OF CUNNINGHAM PARK GARAGE SPACE INTO A HUB SPACE FOR MNO STAFF,cpd11-20qn.pdf
P-408CSTA,CUNNINGHAM PARK TENNIS HOUSE RC Q021-102M/402M,846,DEPT OF PARKS AND RECREATION,"LARGE, MAJOR AND REGIONAL PARK RECONSTRUCTION",408,QUEENS,P-D019,2348,2170,148,0,0,0,0,0,2318,2170,148,0,0,0,0,0,2318,4340,296,0,0,0,0,0,4636,,"SOUTH OF UNION TURNPIKE, OPPOSITE 195 ST. AND ADJACENT LANDSCAPE IN CUNNINGHAM PK",RC OF THE TENNIS HOUSE IN CUNNINGHAM PARK,cpd11-20qn.pdf
P-408HOV2,Hoover Playground,846,DEPT OF PARKS AND RECREATION,NEIGHBORHOOD PARKS AND PLAYGROUNDS,400 408,QUEENS,P-D019 P-Q245,960,75,100,295,2300,1500,0,0,4270,75,100,295,2300,1500,0,0,4270,150,200,590,4600,3000,0,0,8540,PROJECT DELAYED DUE TO CHANGES IN SCOPE/DESIGN,,HOOVER PLAYGROUND,cpd11-20qn.pdf
P-408MLDY,Site for Mother Language Day in Captain Tilly Park,846,DEPT OF PARKS AND RECREATION,NEIGHBORHOOD PARKS AND PLAYGROUNDS,400,QUEENS,P-Q245,500,0,0,0,0,1500,0,0,1500,0,0,0,0,1500,0,0,1500,0,0,0,0,3000,0,0,3000,PROJECT DELAYED DUE TO CHANGES IN SCOPE/DESIGN,,COMMEMORATIVE SITE FOR MOTHER LANGUAGE DAY IN CAPTAIN TILLY PARK,cpd11-20qn.pdf
P-408TILL,CAPTAIN TILLEY PK-RENOVATIONS OF LANDSCAPE Q052-112M,846,DEPT OF PARKS AND RECREATION,NEIGHBORHOOD PARKS AND PLAYGROUNDS,400 408,QUEENS,P-D019,1000,1182,185,0,0,0,0,0,1367,1182,185,0,0,0,0,0,1367,2364,370,0,0,0,0,0,2734,PROJECT DELAYED DUE TO SCHEDULING OF UTILITY WORK,,CAPTAIN TILLY PK RENOVATIONS,cpd11-20qn.pdf
P-408VAN2,Vanderbilt Motor Parkway Repaving Phase II QG-719M,846,DEPT OF PARKS AND RECREATION,"LARGE, MAJOR AND REGIONAL PARK RECONSTRUCTION",400,QUEENS,P-0245Q,4000,500,0,0,4000,0,0,0,4500,500,0,0,4000,0,0,0,4500,1000,0,0,8000,0,0,0,9000,,,"PHSE II OF THE REPAVING OF VANDERBILT MOTOR PARKWAY, LOCATED IN CUNNINGHAM PARK,",cpd11-20qn.pdf
P-408VAND,Vanderbilt Motor Parkway Repaving QG-718M,846,DEPT OF PARKS AND RECREATION,"LARGE, MAJOR AND REGIONAL PARK RECONSTRUCTION",400,QUEENS,P-C021 P-D019,1664,1378,140,104,0,0,0,0,1622,1378,140,104,0,0,0,0,1622,2756,280,208,0,0,0,0,3244,,,"REPAVING OF VANDERBILT MOTOR PARKWAY, LOCATED IN CUNNINGHAM PARK",cpd11-20qn.pdf
P-409DEMO,Forest Park Towers Demolition,846,DEPT OF PARKS AND RECREATION,NEIGHBORHOOD PARKS AND PLAYGROUNDS,400,QUEENS,P-1018,1300,0,1000,0,0,0,0,0,1000,0,1000,0,0,0,0,0,1000,0,2000,0,0,0,0,0,2000,,,FOREST PARK TOWERS DEMOLITION,cpd11-20qn.pdf
P-409EQTY,Equity Park Playground Upgrades,846,DEPT OF PARKS AND RECREATION,NEIGHBORHOOD PARKS AND PLAYGROUNDS,400,QUEENS,P-D019,682,0,0,0,0,500,0,0,500,0,0,0,0,500,0,0,500,0,0,0,0,1000,0,0,1000,PROJECT DELAYED DUE TO CHANGES IN SCOPE/DESIGN,,PLAYGROUND EQUIPMENT UPGRADE AT EQUITY PARK,cpd11-20qn.pdf
P-409FPAP,Forest Park Asphalt Pathways Improvements,846,DEPT OF PARKS AND RECREATION,"LARGE, MAJOR AND REGIONAL PARK RECONSTRUCTION",400,QUEENS,P-D019,755,0,100,600,0,0,0,0,700,0,100,600,0,0,0,0,700,0,200,1200,0,0,0,0,1400,,,FOREST PARK ASPHALT PATHWAYS IMPROVEMENTS,cpd11-20qn.pdf
P-409FPG3,FOREST PARK GREENHOUSES Q015-215M,846,DEPT OF PARKS AND RECREATION,"LARGE, MAJOR AND REGIONAL PARK RECONSTRUCTION",400 405 406 409,QUEENS,P-Q245 P-D019 P-0935,1000,320,600,1241,0,0,0,0,2161,320,600,1241,0,0,0,0,2161,640,1200,2482,0,0,0,0,4322,,,FOREST PARK GREENHOUSES Q015,cpd11-20qn.pdf
P-409FPP2,Forest Park Pathways,846,DEPT OF PARKS AND RECREATION,"LARGE, MAJOR AND REGIONAL PARK RECONSTRUCTION",400 409,QUEENS,P-D019,600,73,500,0,0,0,0,0,573,73,500,0,0,0,0,0,573,146,1000,0,0,0,0,0,1146,,,FOREST PARK PATHWAYS,cpd11-20qn.pdf
P-409MARD,Glendale Entrance to Forest Park Q015-217MA,846,DEPT OF PARKS AND RECREATION,"LARGE, MAJOR AND REGIONAL PARK RECONSTRUCTION",400,QUEENS,P-D019 P-C018 P-0245Q P-1018 P-Q771 P-Q245,1100,423,0,3674,0,0,0,0,4097,423,0,3674,0,0,0,0,4097,846,0,7348,0,0,0,0,8194,PROJECT DELAYED DUE TO CHANGES IN SCOPE/DESIGN,,MYRTLE AVENUE ROAD IN FOREST PARK,cpd11-20qn.pdf
P-409SOB2,SOBELSOHN C/S,846,DEPT OF PARKS AND RECREATION,NEIGHBORHOOD PARKS AND PLAYGROUNDS,400,QUEENS,P-D019,550,0,50,0,0,0,0,0,50,0,50,0,0,0,0,0,50,0,100,0,0,0,0,0,100,PROJECT DELAYED DUE TO BUDGETARY CONSTRAINTS,SOBELSOHN C/S,SOBELSOHN C/S,cpd11-20qn.pdf
P-410ALST,Al Stabile Playground Renovation,846,DEPT OF PARKS AND RECREATION,NEIGHBORHOOD PARKS AND PLAYGROUNDS,400,QUEENS,P-D019,1988,179,0,0,1750,0,0,0,1929,179,0,0,1750,0,0,0,1929,358,0,0,3500,0,0,0,3858,,,"AL STABILE PLAYGROUND RENOVATION, BOROUGH OF QUEENS",cpd11-20qn.pdf
P-410BYRN,Edward Byrne Park Playground C/S X092-118M,846,DEPT OF PARKS AND RECREATION,NEIGHBORHOOD PARKS AND PLAYGROUNDS,400,QUEENS,P-Q245,3537,315,1,0,2957,0,0,0,3273,315,1,0,2957,0,0,0,3273,630,2,0,5914,0,0,0,6546,,,CONSTRUCTION OF A COMFORT STATION AT EDWARD BYRNE PARK PLAYGROUND,cpd11-20qn.pdf
P-410PEBP,Recon of Police Officer Edward O'Byrne Park Q092-119M,846,DEPT OF PARKS AND RECREATION,NEIGHBORHOOD PARKS AND PLAYGROUNDS,400,QUEENS,P-0245Q,2650,100,0,0,2650,0,0,0,2750,100,0,0,2650,0,0,0,2750,200,0,0,5300,0,0,0,5500,PROJECT DELAYED DUE TO CHANGES IN SCOPE/DESIGN,,POLICE OFFICER EDWARD O'BYRNE PARK - QUEENS,cpd11-20qn.pdf
P-410PONI,P.O. NICHOLAS DEMUTIS PLGD RC Q118-114M,846,DEPT OF PARKS AND RECREATION,NEIGHBORHOOD PARKS AND PLAYGROUNDS,400 410,QUEENS,P-Q245,1800,2333,114,0,0,0,0,0,2447,2333,114,0,0,0,0,0,2447,4666,228,0,0,0,0,0,4894,PROJECT DELAYED DUE TO CHANGES IN SCOPE/DESIGN,,P.O. NICHOLAS DEMUTIS PLGD RC,cpd11-20qn.pdf
P-410SCN2,Harold Schneiderman Playground Upgrades,846,DEPT OF PARKS AND RECREATION,NEIGHBORHOOD PARKS AND PLAYGROUNDS,400,QUEENS,P-Q245 P-D019,1022,50,0,0,1250,2250,0,0,3550,50,0,0,1250,2250,0,0,3550,100,0,0,2500,4500,0,0,7100,PROJECT DELAYED DUE TO CHANGES IN SCOPE/DESIGN,,UPGRADE PLAY EQUIPMENT AT HAROLD SCHNEIDERMAN PLAYGROUND,cpd11-20qn.pdf
P-410SFLD,SOUTHERN FIELDS AT N. CONDUIT AND 118 ST. Q096-108M,846,DEPT OF PARKS AND RECREATION,NEIGHBORHOOD PARKS AND PLAYGROUNDS,400,QUEENS,P-Q245,2000,1239,130,0,0,0,0,0,1369,1239,130,0,0,0,0,0,1369,2478,260,0,0,0,0,0,2738,PROJECT DELAYED PENDING APPROVAL OF NECESSARY PERMITS,QUEENS,SOUTHERN FIELDS AT N. CONDUIT AND 118 ST.,cpd11-20qn.pdf
P-411APE2,ALLEY POND ENVIRONMENTAL CENTER & CONS. OF ANNEX Q001-110M,846,DEPT OF PARKS AND RECREATION,"LARGE, MAJOR AND REGIONAL PARK RECONSTRUCTION",411,QUEENS,P-Q002 P-0506,1060,25197,106,1665,0,0,0,0,26968,25197,106,1665,0,0,0,0,26968,50394,212,3330,0,0,0,0,53936,PROJECT DELAYED DUE TO UNFORESEEN SITE/FIELD CONDITION,,CONSTRUCTION OF AN ANNEX AND RC OF APEC,cpd11-20qn.pdf
P-411APLS,Alley Pond Park Living Shoreline Construction Q135-119M,846,DEPT OF PARKS AND RECREATION,"LARGE, MAJOR AND REGIONAL PARK RECONSTRUCTION",400,QUEENS,P-1018,320,0,0,0,0,0,0,0,0,0,0,0,0,0,0,0,0,0,0,0,0,0,0,0,0,,,"CONSTRUCTION OF A LIVING SHORELINE AT ALLEY POND PARK, BOROUGH OF QUEENS",cpd11-20qn.pdf
P-411AURO,AURORA POND - RESTORATION Q452-100MA,846,DEPT OF PARKS AND RECREATION,"LARGE, MAJOR AND REGIONAL PARK RECONSTRUCTION",411,QUEENS,P-D019,1403,981,0,0,200,0,0,0,1181,981,0,0,200,0,0,0,1181,1962,0,0,400,0,0,0,2362,PROJECT DELAYED DUE TO BUDGETARY CONSTRAINTS,"UDALLS PARK NORTHERN BLVD, 244-247 STS, DOUGLAS RD",RESTORAATION,cpd11-20qn.pdf
P-411CDTR,Captain Dermody Triangle- Reconstruction of the triangle,846,DEPT OF PARKS AND RECREATION,NEIGHBORHOOD PARKS AND PLAYGROUNDS,400,QUEENS,P-1018,500,34,0,0,0,0,0,0,34,34,0,0,0,0,0,0,34,68,0,0,0,0,0,0,68,,"216 ST., 48 AVE. QUEENS",RECONSTRUCTION OF CAPTAIN DERMODY TRIANGLE,cpd11-20qn.pdf
P-411OKPT,Oakland Lake Pathways Reconstruction,846,DEPT OF PARKS AND RECREATION,"LARGE, MAJOR AND REGIONAL PARK RECONSTRUCTION",400,QUEENS,P-D019 P-Q245 P-1018,106,20,276,0,0,26,0,0,322,20,276,0,0,26,0,0,322,40,552,0,0,52,0,0,644,PROJECT DELAYED DUE TO CHANGES IN SCOPE/DESIGN,ALLEY POND PARK,OAKLAND LAKE PATHWAYS RECONSTRUCTION,cpd11-20qn.pdf
P-411SWP2,Saul Weprin Playground R/C Q293-118M,846,DEPT OF PARKS AND RECREATION,NEIGHBORHOOD PARKS AND PLAYGROUNDS,400,QUEENS,P-D019,1364,1211,155,0,0,0,0,0,1366,1211,155,0,0,0,0,0,1366,2422,310,0,0,0,0,0,2732,,,SAUL WEPRIN PLAYGROUND RENOVATION,cpd11-20qn.pdf
P-412BAI2,"Baisley Pond Park Track & Field, Syn. Turf R/C Q005-119M",846,DEPT OF PARKS AND RECREATION,NEIGHBORHOOD PARKS AND PLAYGROUNDS,400,QUEENS,P-0245Q,10275,765,19,808,0,8358,0,0,9950,765,19,808,0,8358,0,0,9950,1530,38,1616,0,16716,0,0,19900,,,BAISLEY POND PARK - QUEENS,cpd11-20qn.pdf
P-412BPP3,BAISLEY POND PARK PHASE III Q005-113M,846,DEPT OF PARKS AND RECREATION,"LARGE, MAJOR AND REGIONAL PARK RECONSTRUCTION",400 412,QUEENS,P-D019,1300,1771,0,610,0,0,0,0,2381,1771,0,610,0,0,0,0,2381,3542,0,1220,0,0,0,0,4762,PROJECT DELAYED PENDING RESOLUTION OF LEGAL ISSUES,,UPGRADE ASPHALT PARK SYSTEM ADJACENT TO THE LAKE OF ROCKAWAY BLVD AND150 ST. INSTALL,cpd11-20qn.pdf
P-412BPP4,Athletic Courts Multi-Site QG-216M,846,DEPT OF PARKS AND RECREATION,"LARGE, MAJOR AND REGIONAL PARK RECONSTRUCTION",400,QUEENS,P-D019 P-1018 P-Q708,1000,2118,0,1046,0,0,0,0,3164,2118,0,1046,0,0,0,0,3164,4236,0,2092,0,0,0,0,6328,PROJECT DELAYED DUE TO CHANGES IN SCOPE/DESIGN,,BAISLEY POND PK ATHLETIC CTS,cpd11-20qn.pdf
P-412DKWP,Detective Keith L Williams Park (Liberty) Basketball Cts,846,DEPT OF PARKS AND RECREATION,NEIGHBORHOOD PARKS AND PLAYGROUNDS,400,QUEENS,P-0245Q,700,67,164,536,0,0,0,0,767,67,164,536,0,0,0,0,767,134,328,1072,0,0,0,0,1534,,,"DETECTIVE KEITH L WILLIAMS PARK (LIBERTY PARK) RENOVATE TWO BASKETBALL COURTS, BOROUGH",cpd11-20qn.pdf
P-412DOP2,DANIEL O'CONNELL PLAYGD. C/S Q106-113M,846,DEPT OF PARKS AND RECREATION,NEIGHBORHOOD PARKS AND PLAYGROUNDS,400 412,QUEENS,P-1018 P-0882,1700,2535,52,0,0,0,0,0,2587,2535,52,0,0,0,0,0,2587,5070,104,0,0,0,0,0,5174,PROJECT DELAYED DUE TO UNFORESEEN SITE/FIELD CONDITION,,DANIEL O'CONNOR C/S,cpd11-20qn.pdf
P-412DOP3,Daniel M. O'Connell Playground Renovation Q106-120M,846,DEPT OF PARKS AND RECREATION,NEIGHBORHOOD PARKS AND PLAYGROUNDS,400,QUEENS,P-D019 P-0245Q,4500,402,40,0,4058,0,0,0,4500,402,40,0,4058,0,0,0,4500,804,80,0,8116,0,0,0,9000,,,"DANIEL M. O'CONNELL PLAYGROUND FULL RENOVATION, BOROUGH OF QUEENS",cpd11-20qn.pdf
P-412HOPG,J.H.S. 192 PLAYGROUND RC Q405-104M,846,DEPT OF PARKS AND RECREATION,NEIGHBORHOOD PARKS AND PLAYGROUNDS,412,QUEENS,P-D019,1367,1183,79,0,0,0,0,0,1262,1183,79,0,0,0,0,0,1262,2366,158,0,0,0,0,0,2524,,"111 AVE, 203 ST, 204 ST",HOLLIS PLAYGROUND REHAB,cpd11-20qn.pdf
P-412HVDP,HOWARD VON DOHLEN PLAYGROUND-RENOVATIONS Q105-112M,846,DEPT OF PARKS AND RECREATION,NEIGHBORHOOD PARKS AND PLAYGROUNDS,400 409,QUEENS,P-Q245,1927,1508,62,0,0,0,0,0,1570,1508,62,0,0,0,0,0,1570,3016,124,0,0,0,0,0,3140,PROJECT DELAYED DUE TO UNFORESEEN SITE/FIELD CONDITION,QUEENS,HOWARD VON DOHLEN PLAYGROUND-RENOVATIONS Q105,cpd11-20qn.pdf
P-412JAMP,Jamaica Playground -- Renovate MPPA,846,DEPT OF PARKS AND RECREATION,NEIGHBORHOOD PARKS AND PLAYGROUNDS,400,QUEENS,P-D019,5280,0,100,0,4700,0,0,0,4800,0,100,0,4700,0,0,0,4800,0,200,0,9400,0,0,0,9600,,,JAMAICA PLAYGROUND -- RENOVATE MPPA,cpd11-20qn.pdf
P-412JMIC,Jamaica Playground R/C Q301-119M,846,DEPT OF PARKS AND RECREATION,NEIGHBORHOOD PARKS AND PLAYGROUNDS,400,QUEENS,P-0245Q,4650,495,653,0,3832,0,0,0,4980,495,653,0,3832,0,0,0,4980,990,1306,0,7664,0,0,0,9960,,,JAMAICA PLAYGROUND - QUEENS,cpd11-20qn.pdf
P-412KLWP,Detective Keith Williams Park--Renovate The Synthetic Turf,846,DEPT OF PARKS AND RECREATION,NEIGHBORHOOD PARKS AND PLAYGROUNDS,400,QUEENS,P-D019 P-Q245 P-0245Q,20615,0,100,0,7000,8315,5000,0,20415,0,100,0,7000,8315,5000,0,20415,0,200,0,14000,16630,10000,0,40830,,,DETECTIVE KEITH WILLIAMS PARK--RENOVATE THE SYNTHETIC TURF FIELD AND MONDO TRACK,cpd11-20qn.pdf
P-412MBPF,Montebellier Park Field - Playing Field Upgrades,846,DEPT OF PARKS AND RECREATION,NEIGHBORHOOD PARKS AND PLAYGROUNDS,400,QUEENS,P-D019,550,0,500,0,0,0,0,0,500,0,500,0,0,0,0,0,500,0,1000,0,0,0,0,0,1000,,,MONTEBELLIER PARK FIELD - PLAYING FIELD UPGRADES,cpd11-20qn.pdf
P-412NAUT,Nautilus Playground R/C Q448-119M,846,DEPT OF PARKS AND RECREATION,NEIGHBORHOOD PARKS AND PLAYGROUNDS,400 412,QUEENS,P-D019 P-Q245,600,405,476,0,5227,0,0,0,6108,405,476,0,5227,0,0,0,6108,810,952,0,10454,0,0,0,12216,PROJECT DELAYED DUE TO CHANGES IN SCOPE/DESIGN,,NAUTILUS PLAYGROUND,cpd11-20qn.pdf
P-412NOR2,Norelli-Hargreaves Playground MPPA R/C Q220B-118M,846,DEPT OF PARKS AND RECREATION,NEIGHBORHOOD PARKS AND PLAYGROUNDS,400,QUEENS,P-Q245,3326,1971,972,0,0,0,0,0,2943,1971,972,0,0,0,0,0,2943,3942,1944,0,0,0,0,0,5886,,,NORELLI HARGREAVES PLAYGROUND - RENOVATION TO BASKETBALL COURTS AND MULTI PURPOSE,cpd11-20qn.pdf
P-412NORI,Norelli-Hargreaves Playground R/C Q220-116M,846,DEPT OF PARKS AND RECREATION,NEIGHBORHOOD PARKS AND PLAYGROUNDS,400 412,QUEENS,P-1018,2000,2968,0,250,0,0,0,0,3218,2968,0,250,0,0,0,0,3218,5936,0,500,0,0,0,0,6436,PROJECT DELAYED DUE TO CHANGES IN SCOPE/DESIGN,,NORELLI-HARGREAVES PARK IMPROVEMENTS,cpd11-20qn.pdf
P-412RK01,Rufus King Park Cons. of Entrance & R/C of Fence Q023-216MA,846,DEPT OF PARKS AND RECREATION,NEIGHBORHOOD PARKS AND PLAYGROUNDS,400 412,QUEENS,P-0245Q,1700,3125,261,0,0,0,0,0,3386,3125,261,0,0,0,0,0,3386,6250,522,0,0,0,0,0,6772,PROJECT DELAYED DUE TO CHANGES IN SCOPE/DESIGN,"JAMAICA AVE, QUEENS",CONSTRUCTION OF PARK ENTRANCES & RECONSTRUCTION OF THE PERIMETER FENCE AT RUFUS KING,cpd11-20qn.pdf
P-412RKGZ,RUFUS KING PARK GAZEBO RC Q023-112M,846,DEPT OF PARKS AND RECREATION,NEIGHBORHOOD PARKS AND PLAYGROUNDS,400 412,QUEENS,P-Q245,550,2214,241,0,0,0,0,0,2455,2214,241,0,0,0,0,0,2455,4428,482,0,0,0,0,0,4910,PROJECT DELAYED PENDING RESOLUTION OF LEGAL ISSUES,,RENOVATE AND REDESIGN EXISTING PATHS. RESTORE LAWN AREAS AND INSTALL PROTECTIVE,cpd11-20qn.pdf
P-412RKM2,RUFUS KING MANOR MUSEUM -HVAC Q23-116M,846,DEPT OF PARKS AND RECREATION,NEIGHBORHOOD PARKS AND PLAYGROUNDS,400 412,QUEENS,P-D019 P-0245Q P-Q245,400,722,163,0,0,0,0,0,885,722,163,0,0,0,0,0,885,1444,326,0,0,0,0,0,1770,PROJECT DELAYED DUE TO CHANGES IN SCOPE/DESIGN,,RUFUS KING MANOR MUSEUM,cpd11-20qn.pdf
P-412RWFA,Roy Wilkens Rec. Center,846,DEPT OF PARKS AND RECREATION,NEIGHBORHOOD PARKS AND PLAYGROUNDS,412,QUEENS,P-0506,768,0,1042,0,0,0,0,0,1042,0,1042,0,0,0,0,0,1042,0,2084,0,0,0,0,0,2084,,"177TH STREET & BAISLEY BOULEVARD, JAMAICA, NY 11434, QUEENS.",FIRE ALARM RECONSTRUCTION AT ROY WILKENS REC CENTER.,cpd11-20qn.pdf
P-412RWIL,ROY WILKINS REC CTR ROOF & SITE Q448-112M,846,DEPT OF PARKS AND RECREATION,"LARGE, MAJOR AND REGIONAL PARK RECONSTRUCTION",412,QUEENS,P-Q245 P-0245Q,4318,5462,4,1047,0,0,0,0,6513,5462,4,1047,0,0,0,0,6513,10924,8,2094,0,0,0,0,13026,PROJECT DELAYED DUE TO CHANGES IN SCOPE/DESIGN,QUEENS,"RC ROOF ROY WILKINS REC CTR, ROOFTOP GYM AC, SITE /GARDEN DRAINAGE",cpd11-20qn.pdf
P-412RWP3,ROY WILKINS PARK RECREATION CTR RC Q448-115M,846,DEPT OF PARKS AND RECREATION,NEIGHBORHOOD PARKS AND PLAYGROUNDS,400 412,QUEENS,P-Q245 P-0506,1440,1705,1203,0,0,0,0,0,2908,1705,1203,0,0,0,0,0,2908,3410,2406,0,0,0,0,0,5816,PROJECT DELAYED DUE TO CHANGES IN SCOPE/DESIGN,,ROY WILKINS PARK RECREATION CTR,cpd11-20qn.pdf
P-412RWTK,ROY WILKINS PARK TRACK Q448-104M,846,DEPT OF PARKS AND RECREATION,"LARGE, MAJOR AND REGIONAL PARK RECONSTRUCTION",412,QUEENS,P-D019,1342,1180,53,0,0,0,0,0,1233,1180,53,0,0,0,0,0,1233,2360,106,0,0,0,0,0,2466,PROJECT DELAYED DUE TO UNFORESEEN SITE/FIELD CONDITION,BETWEEN 116TH AVENUE AND 118 ROAD,CONSTRUCTION OF A SYNTHETIC TURF ATHLETIC FIELD LOCATED WITHIN THE RUNNING TRACK IN ROY,cpd11-20qn.pdf
P-412RWTT,Roy Wilkins Park Turf and Track Upgrades Q448-116M,846,DEPT OF PARKS AND RECREATION,"LARGE, MAJOR AND REGIONAL PARK RECONSTRUCTION",400 412,QUEENS,P-D019,5160,3679,0,1148,0,0,0,0,4827,3679,0,1148,0,0,0,0,4827,7358,0,2296,0,0,0,0,9654,PROJECT DELAYED DUE TO CHANGES IN SCOPE/DESIGN,,ROY WILKINS PARK TURF AND TRACK UPGRADES,cpd11-20qn.pdf
P-412SRPC,SOUTH ROCHDALE PLGD- RENO OF PLGD & CS,846,DEPT OF PARKS AND RECREATION,NEIGHBORHOOD PARKS AND PLAYGROUNDS,400,QUEENS,P-D019,0,0,100,0,5900,0,0,0,6000,0,100,0,5900,0,0,0,6000,0,200,0,11800,0,0,0,12000,,,SOUTH ROCHDALE PLGD- RENO OF PLGD & CS,cpd11-20qn.pdf
P-413BRO3,Brookville Park Entrance R/C Q008-117M,846,DEPT OF PARKS AND RECREATION,"LARGE, MAJOR AND REGIONAL PARK RECONSTRUCTION",400,QUEENS,P-D019,2132,1513,808,0,0,0,0,0,2321,1513,808,0,0,0,0,0,2321,3026,1616,0,0,0,0,0,4642,,,BROOKVILLE PARK UPGRADES,cpd11-20qn.pdf
P-413BRO4,Brookville Park Dog Run,846,DEPT OF PARKS AND RECREATION,NEIGHBORHOOD PARKS AND PLAYGROUNDS,400,QUEENS,P-D019,2000,0,82,930,88,0,0,0,1100,0,82,930,88,0,0,0,1100,0,164,1860,176,0,0,0,2200,,,"BROOKVILLE PARK DOG RUN, BOROUGH OF QUEENS",cpd11-20qn.pdf
P-413BRSY,Brookville Park Synthetic Turf Field R/C Q008-119M,846,DEPT OF PARKS AND RECREATION,NEIGHBORHOOD PARKS AND PLAYGROUNDS,400 413,QUEENS,P-D019,3837,247,0,0,2933,0,0,0,3180,247,0,0,2933,0,0,0,3180,494,0,0,5866,0,0,0,6360,,,"BROOKVILLE PARK SYNTHETIC TURF FIELD RECONSTRUCTION, BOROUGH OF QUEENS",cpd11-20qn.pdf
P-413CAMB,CAMBRIA PLGD RECONSTRUCTION,846,DEPT OF PARKS AND RECREATION,NEIGHBORHOOD PARKS AND PLAYGROUNDS,400,QUEENS,P-D019 P-Q245,4211,0,100,0,3911,0,0,0,4011,0,100,0,3911,0,0,0,4011,0,200,0,7822,0,0,0,8022,,,CAMBRIA PLAYGROUND/CABBELL PARK--PLAYGROUND RECONSTRUCTION,cpd11-20qn.pdf
P-413CAST,Castlewood Playground - Reconstruction of the MPPA Q327-119M,846,DEPT OF PARKS AND RECREATION,NEIGHBORHOOD PARKS AND PLAYGROUNDS,400,QUEENS,P-Q245 P-D019,3700,379,1,0,3010,0,0,0,3390,379,1,0,3010,0,0,0,3390,758,2,0,6020,0,0,0,6780,PROJECT DELAYED DUE TO CHANGES IN SCOPE/DESIGN,,CASTLEWOOD PLAYGROUND,cpd11-20qn.pdf
P-413COV2,Sunset Cove Pk Oyster Garden/Boardwalk Cons. Q498-117M,846,DEPT OF PARKS AND RECREATION,"LARGE, MAJOR AND REGIONAL PARK RECONSTRUCTION",400,QUEENS,P-1018 P-Q003 P-Q245,1000,25,0,0,3608,0,0,0,3633,25,0,0,3608,0,0,0,3633,50,0,0,7216,0,0,0,7266,,,SUNSET COVE PARK PHASE II - CONSTRUCTION OF AN OFFSHORE EDUCATIONAL OYSTER GARDEN AND,cpd11-20qn.pdf
P-413IDL3,IDLEWILD PK SITE B Q392,846,DEPT OF PARKS AND RECREATION,"LARGE, MAJOR AND REGIONAL PARK RECONSTRUCTION",400 413,QUEENS,ED-0075 P-0245Q,2001,75,2364,202,0,0,0,0,2641,75,2364,202,0,0,0,0,2641,150,4728,404,0,0,0,0,5282,PROJECT DELAYED PENDING APPROVAL OF STATE REQ CONTRACT,QUEENS,IDLEWILD PK SITE B,cpd11-20qn.pdf
P-413IDPK,IDLEWILD PK MARSH NATURE CENTER Q392-210M,846,DEPT OF PARKS AND RECREATION,"LARGE, MAJOR AND REGIONAL PARK RECONSTRUCTION",413,QUEENS,P-1018 P-0245Q,100,8360,12,421,0,0,0,0,8793,8360,12,421,0,0,0,0,8793,16720,24,842,0,0,0,0,17586,PROJECT DELAYED DUE TO UNFORESEEN SITE/FIELD CONDITION,,IDLEWILD PK MARSH ENVIRONMENTAL CENTER Q392,cpd11-20qn.pdf
P-413JH72,VIC HANSON/JHS 72 PLGD RC Q352,846,DEPT OF PARKS AND RECREATION,NEIGHBORHOOD PARKS AND PLAYGROUNDS,400 413,QUEENS,P-Q245,420,0,0,0,0,350,0,0,350,0,0,0,0,350,0,0,350,0,0,0,0,700,0,0,700,PROJECT DELAYED DUE TO CHANGES IN SCOPE/DESIGN,,VIC HANSON/JHS 72 PLGD RC Q352,cpd11-20qn.pdf
P-413LPCT,Laurelton Playground Basketball and Handball Courts,846,DEPT OF PARKS AND RECREATION,NEIGHBORHOOD PARKS AND PLAYGROUNDS,400,QUEENS,P-D019,2000,25,182,0,3818,0,0,0,4025,25,182,0,3818,0,0,0,4025,50,364,0,7636,0,0,0,8050,,,"LAURELTON PLAYGROUND PHASE 2 (BASKETBALL AND HANDBALL COURTS), BOROUGH OF QUEENS",cpd11-20qn.pdf
P-413LPL2,Laurelton Playground RC Q027-110M,846,DEPT OF PARKS AND RECREATION,NEIGHBORHOOD PARKS AND PLAYGROUNDS,400 413,QUEENS,P-Q245,1500,1767,36,0,0,0,0,0,1803,1767,36,0,0,0,0,0,1803,3534,72,0,0,0,0,0,3606,PROJECT DELAYED DUE TO UNFORESEEN SITE/FIELD CONDITION,BROOKVILLE BLVD BETWEEN 136 AND 137 AVENUES,"INSTALLATION OF NEW TOT PLAYGROUND, SPRAY SHOWER, BENCHES, NEW LANDSCAPING",cpd11-20qn.pdf
P-413LPL3,Laurelton Plgd and Bayswater Park Skate Elements QG-316M,846,DEPT OF PARKS AND RECREATION,NEIGHBORHOOD PARKS AND PLAYGROUNDS,400 413,QUEENS,P-1018,300,3510,0,84,0,0,0,0,3594,3510,0,84,0,0,0,0,3594,7020,0,168,0,0,0,0,7188,PROJECT DELAYED DUE TO CHANGES IN SCOPE/DESIGN,,LAURELTON PLAYGROUND,cpd11-20qn.pdf
P-413QCFM,"QNS FMHSE-RENOV ED BLDG,GRNHSE & ADRIANCE FMHSE Q453-102MA",846,DEPT OF PARKS AND RECREATION,VEHICLES AND EQUIPMENT,413,QUEENS,P-Q010,482,390,47,0,0,0,0,0,437,390,47,0,0,0,0,0,437,780,94,0,0,0,0,0,874,PROJECT DELAYED DUE TO BUDGETARY CONSTRAINTS,QNS COUNTY,"RENOV ED BLDG, GREENHOUSE COMPLEX, & ADRIANCE FARMHOUSE",cpd11-20qn.pdf
P-413READ,Bellerose Playground (PS 133) Creation of Reading Garden,846,DEPT OF PARKS AND RECREATION,NEIGHBORHOOD PARKS AND PLAYGROUNDS,400,QUEENS,P-1018,250,44,0,0,0,20,0,0,64,44,0,0,0,20,0,0,64,88,0,0,0,40,0,0,128,PROJECT DELAYED DUE TO CHANGES IN SCOPE/DESIGN,,"CREATION OF A READING GARDEN AT PS 133 (BELLEROSE PLAYGROUND), BOROUGH OF QUEENS",cpd11-20qn.pdf
P-413SPBD,Springfield Park Basketball Courts and BBQ Area Q107-119M,846,DEPT OF PARKS AND RECREATION,NEIGHBORHOOD PARKS AND PLAYGROUNDS,400,QUEENS,P-D019 P-0245Q,4200,439,0,0,3221,0,0,0,3660,439,0,0,3221,0,0,0,3660,878,0,0,6442,0,0,0,7320,,,"SPRINGFIELD PARK BASKETBALL COURTS AND BBQ, BOROUGH OF QUEENS",cpd11-20qn.pdf
P-413WGPF,WILLIAM GUNN PLAYGROUND EXPANSION,846,DEPT OF PARKS AND RECREATION,NEIGHBORHOOD PARKS AND PLAYGROUNDS,400 413,QUEENS,P-D019,500,0,0,0,0,500,0,0,500,0,0,0,0,500,0,0,500,0,0,0,0,1000,0,0,1000,PROJECT DELAYED DUE TO CHANGES IN SCOPE/DESIGN,,EXPAND MPPA MULTI USE YARD INTO STREET BED AS PER YESHIVA AGREEMENT ADD FENCING AND,cpd11-20qn.pdf
P-41417PG,BROAD CHANNEL 17TH STREET PLAYGROUND Q460-118M,846,DEPT OF PARKS AND RECREATION,NEIGHBORHOOD PARKS AND PLAYGROUNDS,400 414,QUEENS,P-Q245 P-D019,2678,267,0,2252,0,0,0,0,2519,267,0,2252,0,0,0,0,2519,534,0,4504,0,0,0,0,5038,,BROAD CHANNEL 17TH STREET PLAYGROUND,BROAD CHANNEL 17TH STREET PLAYGROUND,cpd11-20qn.pdf
P-414B108,Beach 108th Esplanade Improvements Q496-119M,846,DEPT OF PARKS AND RECREATION,NEIGHBORHOOD PARKS AND PLAYGROUNDS,400,QUEENS,P-1018 P-0581,2276,152,0,0,0,0,0,0,152,152,0,0,0,0,0,0,152,304,0,0,0,0,0,0,304,,,"IMPROVEMENTS TO THE HARBOR PARK ESPLANADE ALONG BEACH CHANNEL DRIVE, AT BEACH 108TH",cpd11-20qn.pdf
P-414B9TH,Beach 9th Street Basketball Courts,846,DEPT OF PARKS AND RECREATION,BEACHES AND BOARDWALKS,400,QUEENS,P-D019,400,0,400,0,0,0,0,0,400,0,400,0,0,0,0,0,400,0,800,0,0,0,0,0,800,,,"BEACH 9TH STREET RENOVATION OF BASKETBALL COURTS, AT ROCKAWAY BEACH AND BOARDWALK,",cpd11-20qn.pdf
P-414BAY6,Michaelis-Bayswater Park Reconstruction Q007-119M,846,DEPT OF PARKS AND RECREATION,NEIGHBORHOOD PARKS AND PLAYGROUNDS,414,QUEENS,P-1018,4280,245,0,288,3672,0,0,0,4205,245,0,288,3672,0,0,0,4205,490,0,576,7344,0,0,0,8410,,,"RECONSTRUCTION OF BAYSWATER PARK, BOROUGH OF QUEENS",cpd11-20qn.pdf
P-414BAYS,BAYSWATER-MICHAELIS PK-W0 B/F'S INCL IRRIG Q007-102M,846,DEPT OF PARKS AND RECREATION,NEIGHBORHOOD PARKS AND PLAYGROUNDS,414,QUEENS,P-Q245,960,880,66,0,0,0,0,0,946,880,66,0,0,0,0,0,946,1760,132,0,0,0,0,0,1892,PROJECT DELAYED DUE TO BUDGETARY CONSTRAINTS,"BEACH CHANEL DRIVE, B. 32ND ST",RECON 2 B/F'S,cpd11-20qn.pdf
P-414BC88,Beach 88th Street Park Construction Q499-118M,846,DEPT OF PARKS AND RECREATION,BEACHES AND BOARDWALKS,400,QUEENS,P-1018,200,19,0,181,0,0,0,0,200,19,0,181,0,0,0,0,200,38,0,362,0,0,0,0,400,,,"CONSTRUCTION OF A PARK ON BEACH 88TH STREET, BOROUGH OF QUEENS",cpd11-20qn.pdf
P-414BCAP,Broad Channel American Park,846,DEPT OF PARKS AND RECREATION,NEIGHBORHOOD PARKS AND PLAYGROUNDS,400 414,QUEENS,P-D019,312,25,267,0,2733,0,0,0,3025,25,267,0,2733,0,0,0,3025,50,534,0,5466,0,0,0,6050,PROJECT DELAYED DUE TO CHANGES IN SCOPE/DESIGN,,BROAD CHANNEL AMERICAN PARK,cpd11-20qn.pdf
P-414C03B,BROAD CHANNEL PK DAY CAMP Q467-199,846,DEPT OF PARKS AND RECREATION,"LARGE, MAJOR AND REGIONAL PARK RECONSTRUCTION",414,QUEENS,P-Q005,1060,149,36,0,0,0,0,0,185,149,36,0,0,0,0,0,185,298,72,0,0,0,0,0,370,,"CROSS BAY BLVD, 207TH AVE, 20TH ROAD, BROAD CHANNEL",CONSTR OF A BALLFLD & RESTORATION OF WETLANDS AND ADJOINING LANDSCAPEIN BROAD CHANNEL,cpd11-20qn.pdf
P-414LABY,Shorefront Labyrinth and Seating Area Q163-518M,846,DEPT OF PARKS AND RECREATION,BEACHES AND BOARDWALKS,400,QUEENS,P-D019 P-Q003,332,21,402,34,0,0,0,0,457,21,402,34,0,0,0,0,457,42,804,68,0,0,0,0,914,PROJECT DELAYED DUE TO UNFORESEEN SITE/FIELD CONDITION,,"CREATION OF A LABYRINTH/YOGA AREA ALONG SHORE FRONT PARKWAY, IN THE VICINITY OF BEACH",cpd11-20qn.pdf
P-414LAN2,Lannett Playground Sitting Area R/C Q407-118M,846,DEPT OF PARKS AND RECREATION,NEIGHBORHOOD PARKS AND PLAYGROUNDS,400,QUEENS,P-Q245,250,1158,333,0,0,0,0,0,1491,1158,333,0,0,0,0,0,1491,2316,666,0,0,0,0,0,2982,PROJECT DELAYED DUE TO CHANGES IN SCOPE/DESIGN,LANNETT PLAYGROUND,LANNETT PLAYGROUND,cpd11-20qn.pdf
P-414ODON,O'Donohue Park Picnic Grove Construction,846,DEPT OF PARKS AND RECREATION,BEACHES AND BOARDWALKS,400,QUEENS,P-D019,320,0,0,0,0,320,0,0,320,0,0,0,0,320,0,0,320,0,0,0,0,640,0,0,640,PROJECT DELAYED DUE TO CHANGES IN SCOPE/DESIGN,,"O'DONOHUE PARK PICNIC GROVE AND BBQ AREA CONSTRUCTION, AT ROCKAWAY BEACH AND",cpd11-20qn.pdf
P-414RB59,Beach 59th Street Playground R/C Q162E-118M,846,DEPT OF PARKS AND RECREATION,BEACHES AND BOARDWALKS,400,QUEENS,P-D019 P-Q245,200,503,0,0,4884,0,0,0,5387,503,0,0,4884,0,0,0,5387,1006,0,0,9768,0,0,0,10774,PROJECT DELAYED DUE TO CHANGES IN SCOPE/DESIGN,,BEACH 59 ST PLAYGROUND UPGRADE PK,cpd11-20qn.pdf
P-414RBHD,Rockaway Beach Shorefront Pkwy Handball Courts Q163-315M,846,DEPT OF PARKS AND RECREATION,BEACHES AND BOARDWALKS,,QUEENS,P-D019 P-1018,500,389,58,1,0,0,0,0,448,389,58,1,0,0,0,0,448,778,116,2,0,0,0,0,896,PROJECT DELAYED DUE TO CHANGES IN SCOPE/DESIGN,,ROCKAWAY BEACH SHOREFRONT PKWY HANDBALL COURTS,cpd11-20qn.pdf
P-414RBRR,ROCKAWAY BEACH 108 ST ROLLER RINK Q163-114M,846,DEPT OF PARKS AND RECREATION,"LARGE, MAJOR AND REGIONAL PARK RECONSTRUCTION",400 414,QUEENS,P-D019,300,600,60,203,0,0,0,0,863,600,60,203,0,0,0,0,863,1200,120,406,0,0,0,0,1726,PROJECT DELAYED DUE TO CHANGES IN SCOPE/DESIGN,,RC OF ROLLER HOCKEY RINK AND INSTALLATION OF RECREATION LIGHTING AT ROCKAWAY BEACH,cpd11-20qn.pdf
P-414RKSP,ROCKAWAY BEACH SKATE PARK FACILITY- RC Q163-111MA,846,DEPT OF PARKS AND RECREATION,NEIGHBORHOOD PARKS AND PLAYGROUNDS,400,QUEENS,P-1018,750,1213,35,0,0,0,0,0,1248,1213,35,0,0,0,0,0,1248,2426,70,0,0,0,0,0,2496,PROJECT DELAYED DUE TO CHANGES IN SCOPE/DESIGN,,ROCKAWAY SKATE PARK,cpd11-20qn.pdf
P-414THUR,Thursby Basin Park Construction,846,DEPT OF PARKS AND RECREATION,NEIGHBORHOOD PARKS AND PLAYGROUNDS,400,QUEENS,P-D171 P-D019,583,45,5,507,26,0,0,0,583,45,5,507,26,0,0,0,583,90,10,1014,52,0,0,0,1166,,,"CONSTRUCTION OF THURSBY BASIN PARK, AT ROCKAWAY BEACH AND BOARDWALK, IN THE BOROUGH",cpd11-20qn.pdf
P-414TRB2,Tribute Park Reconstruction Q028-116M,846,DEPT OF PARKS AND RECREATION,NEIGHBORHOOD PARKS AND PLAYGROUNDS,400 414,QUEENS,P-1018,675,1748,0,266,0,0,0,0,2014,1748,0,266,0,0,0,0,2014,3496,0,532,0,0,0,0,4028,PROJECT DELAYED DUE TO CHANGES IN SCOPE/DESIGN,QUEENS,TRIBUTE PARK,cpd11-20qn.pdf
P-415AQNT,FMCP Aquatic Center Netting,846,DEPT OF PARKS AND RECREATION,"LARGE, MAJOR AND REGIONAL PARK RECONSTRUCTION",400,QUEENS,P-0245Q,7954,100,7300,0,0,0,0,0,7400,100,7300,0,0,0,0,0,7400,200,14600,0,0,0,0,0,14800,,,FMCP AQUATIC CENTER NETTING,cpd11-20qn.pdf
P-415AQUA,FMCP - Aquatic Center Roof Replacement,846,DEPT OF PARKS AND RECREATION,"LARGE, MAJOR AND REGIONAL PARK RECONSTRUCTION",400,QUEENS,P-0245Q P-0013,12056,943,110,1922,0,24745,0,0,27720,943,110,1922,0,24745,0,0,27720,1886,220,3844,0,49490,0,0,55440,,,"REPLACEMENT OF ROOF AT THE AQUATIC CENTER, IN FLUSHING MEADOWS CORONAPARK",cpd11-20qn.pdf
P-415CAND,FMCP - Reconstruction of Candela Structures,846,DEPT OF PARKS AND RECREATION,"LARGE, MAJOR AND REGIONAL PARK RECONSTRUCTION",400,QUEENS,P-D019 P-0245Q P-1018,3500,150,686,1983,0,0,0,0,2819,150,686,1983,0,0,0,0,2819,300,1372,3966,0,0,0,0,5638,,,"RECONSTRUCTION OF CANDELAS AT FLUSHING MEADOWS CORONA PARK, BOROUGH OF QUEENS",cpd11-20qn.pdf
P-415FMC2,FMCP - Meadow Lake Promenade R/C Q099-113M,846,DEPT OF PARKS AND RECREATION,"LARGE, MAJOR AND REGIONAL PARK RECONSTRUCTION",400 403 404 406 407 408,QUEENS,P-0245Q,1200,5286,0,375,0,0,0,0,5661,5286,0,375,0,0,0,0,5661,10572,0,750,0,0,0,0,11322,PROJECT DELAYED DUE TO UNFORESEEN SITE/FIELD CONDITION,,REALIGN ROADWAY AND REPAIR EXISTING SETTLING PATH SYSTEM ADJACENT TO HONG KONG,cpd11-20qn.pdf
P-415FMWS,FMCP - Adult Fitness Equipment Installation Q099-318M,846,DEPT OF PARKS AND RECREATION,"LARGE, MAJOR AND REGIONAL PARK RECONSTRUCTION",400,QUEENS,P-D019 P-1018,266,36,282,0,0,0,0,0,318,36,282,0,0,0,0,0,318,72,564,0,0,0,0,0,636,,,"INSTALLATION OF ADULT FITNESS EQUIPMENT AT FLUSHING MEADOWS CORONA PARK, BOROUGH OF",cpd11-20qn.pdf
P-415FOTF,FMCP - Fourtain of the Fairs R/C Q099-117M,846,DEPT OF PARKS AND RECREATION,"LARGE, MAJOR AND REGIONAL PARK RECONSTRUCTION",400,QUEENS,P-0013,5144,6666,517,0,0,0,0,0,7183,6666,517,0,0,0,0,0,7183,13332,1034,0,0,0,0,0,14366,,,"FLUSHING MEADOWS CORONA PARK - FOUNTAIN OF THE FAIRS RECONSTRUCTION, BOROUGH OF",cpd11-20qn.pdf
P-415FSTF,FMCP - Synthetic Turf Fields 8 & 9 R/C Q099-319M,846,DEPT OF PARKS AND RECREATION,"LARGE, MAJOR AND REGIONAL PARK RECONSTRUCTION",400,QUEENS,P-0510,9973,639,1,668,6789,0,0,0,8097,639,1,668,6789,0,0,0,8097,1278,2,1336,13578,0,0,0,16194,,,"FLUSHING MEADOWS CORONA PARK - RECONSTRUCTION OF SYNTHETIC TURF FIELDS 8 & 9, BOROUGH",cpd11-20qn.pdf
P-415LWCS,FMCP - Lawrence Playground Comfort Station R/C Q099-817MA,846,DEPT OF PARKS AND RECREATION,NEIGHBORHOOD PARKS AND PLAYGROUNDS,400,QUEENS,P-0245Q,1310,986,264,0,0,0,0,0,1250,986,264,0,0,0,0,0,1250,1972,528,0,0,0,0,0,2500,,,"RECONSTRUCTION OF COMFORT STATION IN LAWRENCE PLAYGROUND, IN FLUSING MEADOWS",cpd11-20qn.pdf
P-415LWP2,FMCP - Lawrence Playground R/C Q099-717M,846,DEPT OF PARKS AND RECREATION,NEIGHBORHOOD PARKS AND PLAYGROUNDS,400,QUEENS,P-1018,4999,4291,0,126,0,0,0,0,4417,4291,0,126,0,0,0,0,4417,8582,0,252,0,0,0,0,8834,,,RECONSTRUCTION OF LAWRENCE PLAYGROUND IN FLUSHING MEADOWS CORONA PARK,cpd11-20qn.pdf
P-415MEA2,FMCP - MEADOW LAKE- PATHS Q099-215M,846,DEPT OF PARKS AND RECREATION,"LARGE, MAJOR AND REGIONAL PARK RECONSTRUCTION",400 403 404 406 407 408,QUEENS,P-Q245 P-D019 P-0013,900,447,0,750,1100,1900,0,0,4197,447,0,750,1100,1900,0,0,4197,894,0,1500,2200,3800,0,0,8394,PROJECT DELAYED DUE TO CHANGES IN SCOPE/DESIGN,,FMCP - MEADOW LAKE- PATHS Q099,cpd11-20qn.pdf
P-415PAS4,FMCP-Passerelle Roof,846,DEPT OF PARKS AND RECREATION,"LARGE, MAJOR AND REGIONAL PARK RECONSTRUCTION",400,QUEENS,P-0245Q,21280,0,0,0,1935,0,19345,0,21280,0,0,0,1935,0,19345,0,21280,0,0,0,3870,0,38690,0,42560,,,"PASSERELLE ROOF, BOROUGH OF QUEENS",cpd11-20qn.pdf
P-415PAVI,FMCP - NYS PAVILION RC Q099-116M,846,DEPT OF PARKS AND RECREATION,"LARGE, MAJOR AND REGIONAL PARK RECONSTRUCTION",400 403 404 406 407 408,QUEENS,P-0245Q P-D019 P-Q001 P-Q003 P-0013,150,19701,4582,0,0,0,0,0,24283,19701,4582,0,0,0,0,0,24283,39402,9164,0,0,0,0,0,48566,PROJECT DELAYED DUE TO UNFORESEEN SITE/FIELD CONDITION,QUEENS,FMCP PAVILLION...11/26/18 $28K P-D019 FY21 XFER FROM P-403127Q..11/26/18 $743K P-D019 FY20 XFER,cpd11-20qn.pdf
P-415SCHL,Flushing Meadows Corona Park UPK,846,DEPT OF PARKS AND RECREATION,"LARGE, MAJOR AND REGIONAL PARK RECONSTRUCTION",400,QUEENS,P-0013,20000,0,0,0,0,4560,18240,0,22800,0,0,0,0,4560,18240,0,22800,0,0,0,0,9120,36480,0,45600,PROJECT DELAYED DUE TO CHANGES IN SCOPE/DESIGN,,CONSTRUCTION OF A SCHOOL IN FLUSHING MEADOWS CORONA PARK,cpd11-20qn.pdf
P-415WLNC,FMCP-WILLOW LAKE NATURE CENTER Q348,846,DEPT OF PARKS AND RECREATION,NEIGHBORHOOD PARKS AND PLAYGROUNDS,400,QUEENS,P-D019 P-0506,750,75,75,0,2425,0,0,0,2575,75,75,0,2425,0,0,0,2575,150,150,0,4850,0,0,0,5150,PROJECT DELAYED DUE TO UNFORESEEN SITE/FIELD CONDITION,WILLOW LAKE NATURE CENTER,WILLOW LAKE NATURE CENTER,cpd11-20qn.pdf
P-415WRD2,FMCP - World's Fair Marina Pier 1 & 3 R/C Q099-218M,846,DEPT OF PARKS AND RECREATION,"LARGE, MAJOR AND REGIONAL PARK RECONSTRUCTION",400,QUEENS,P-1018,35962,2146,128,2864,2588,0,31100,0,38826,2146,128,2864,2588,0,31100,0,38826,4292,256,5728,5176,0,62200,0,77652,,,"RECONSTRUCTION OF PIER 1 & 3 AT WORLD'S FAIR MARINA, IN FLUSHING MEADOWS CORONA PARK",cpd11-20qn.pdf
P-415WRLD,FMCP - World's Fair Playground Asphalt Field Q099-517M,846,DEPT OF PARKS AND RECREATION,"LARGE, MAJOR AND REGIONAL PARK RECONSTRUCTION",400,QUEENS,P-Q245,2400,1746,0,396,0,0,0,0,2142,1746,0,396,0,0,0,0,2142,3492,0,792,0,0,0,0,4284,PROJECT DELAYED DUE TO CHANGES IN SCOPE/DESIGN,,RENOVATE ASPHALT FIELD AT WORLD'S FAIR PLAYGROUND,cpd11-20qn.pdf
P-4ANCH01,Anchor Park Site - Astoria Park (DESIGN ONLY - ALL PHASES),846,DEPT OF PARKS AND RECREATION,"LARGE, MAJOR AND REGIONAL PARK RECONSTRUCTION",400,QUEENS,P-D019,32730,3470,300,0,0,0,0,0,3770,3470,300,0,0,0,0,0,3770,6940,600,0,0,0,0,0,7540,,,ANCHOR PARK SITE - ASTORIA PARK,cpd11-20qn.pdf
P-4ANCH02,Anchor Pk - Astoria Park PH1,846,DEPT OF PARKS AND RECREATION,"LARGE, MAJOR AND REGIONAL PARK RECONSTRUCTION",400,QUEENS,P-0848 P-1018,13954,13163,126,0,0,0,0,0,13289,13163,126,0,0,0,0,0,13289,26326,252,0,0,0,0,0,26578,,,"ANCHOR PARK INITIATIVE AT ASTORIA PARK, PHASE 1, BOROUGH OF QUEENS",cpd11-20qn.pdf
P-4ANCH03,Anchor Pk - Astoria Park PH2A,846,DEPT OF PARKS AND RECREATION,"LARGE, MAJOR AND REGIONAL PARK RECONSTRUCTION",400,QUEENS,P-0848,9546,12400,152,0,0,0,0,0,12552,12400,152,0,0,0,0,0,12552,24800,304,0,0,0,0,0,25104,,,"RECONSTRUCTION OF CHARYBDIS PLAYGROUND AND ASTORIA POOL PLAY AREA, INASTORIA PARK,",cpd11-20qn.pdf
P-4ANCH04,Anchor Pk - Astoria Pk PH2B,846,DEPT OF PARKS AND RECREATION,"LARGE, MAJOR AND REGIONAL PARK RECONSTRUCTION",400,QUEENS,P-0848,3272,1365,1160,0,0,0,0,0,2525,1365,1160,0,0,0,0,0,2525,2730,2320,0,0,0,0,0,5050,,,"RECONSTRUCTION OF THE COMFORT STATION AT CHARYBDIS PLAYGROUND, IN ASTORIA PARK,",cpd11-20qn.pdf
P-4ANCH05,Anchor Park - Astoria Park Phase 3,846,DEPT OF PARKS AND RECREATION,"LARGE, MAJOR AND REGIONAL PARK RECONSTRUCTION",400,QUEENS,P-0848,4510,0,300,0,3505,0,0,0,3805,0,300,0,3505,0,0,0,3805,0,600,0,7010,0,0,0,7610,,,"ANCHOR PARK - ASTORIA PARK PHASE 3, BOROUGH OF QUEENS",cpd11-20qn.pdf
P-4ASTRRF,Recon of Roofing systems at Astoria Park FH,846,DEPT OF PARKS AND RECREATION,NEIGHBORHOOD PARKS AND PLAYGROUNDS,400,QUEENS,P-1018,577,25,501,0,0,0,0,0,526,25,501,0,0,0,0,0,526,50,1002,0,0,0,0,0,1052,,QUEENS,RECON OF ROOFING SYSTEMS AT ASTORIA PARK FH,cpd11-20qn.pdf
P-4BASDCS,Bayside Playground-Reconstruction of Comfort Station,846,DEPT OF PARKS AND RECREATION,NEIGHBORHOOD PARKS AND PLAYGROUNDS,400,QUEENS,P-0505,1645,297,123,0,1514,0,0,0,1934,297,123,0,1514,0,0,0,1934,594,246,0,3028,0,0,0,3868,,,BAYSIDE PLAYGROUND-RECONSTRUCTION OF COMFORT STATION,cpd11-20qn.pdf
P-4BAYMAR,Bayside Marina RC,846,DEPT OF PARKS AND RECREATION,MAJOR RECREATIONAL FACILITIES AND FACILITY RECONSTRUCTION,400,QUEENS,P-1018 P-1245,1849,361,0,0,3215,0,0,0,3576,361,0,0,3215,0,0,0,3576,722,0,0,6430,0,0,0,7152,,,RECONSTRUCTION OF BAYSIDE MARINA,cpd11-20qn.pdf
P-4BC94S1,Beach 94th Street Performance Space Cons. Q163-418M,846,DEPT OF PARKS AND RECREATION,NEIGHBORHOOD PARKS AND PLAYGROUNDS,400,QUEENS,P-Q003 P-D019,3326,13,168,0,0,0,0,0,181,13,168,0,0,0,0,0,181,26,336,0,0,0,0,0,362,,,BEACH 94TH STREET PERFORMANCE SPACE - CONSTRUCTION OF A PERFORMANCE SPACE AT SHORE,cpd11-20qn.pdf
P-4BLSPTH,Black Spectrum Theatre -Interior renovations q448-219m,846,DEPT OF PARKS AND RECREATION,NEIGHBORHOOD PARKS AND PLAYGROUNDS,400,QUEENS,P-D019,500,56,0,455,45,0,0,0,556,56,0,455,45,0,0,0,556,112,0,910,90,0,0,0,1112,,,BLACK SPECTRUM THEATRE -INTERIOR RENOVATIONS,cpd11-20qn.pdf
P-4BRKVBB,BROOKVILLE PARK TWO BASEBALL FIELD,846,DEPT OF PARKS AND RECREATION,NEIGHBORHOOD PARKS AND PLAYGROUNDS,400,QUEENS,P-D019 P-Q773,6700,170,606,236,4858,0,0,0,5870,170,606,236,4858,0,0,0,5870,340,1212,472,9716,0,0,0,11740,,,BROOKVILLE PARK CONSTRUCTION OF TWO BASEBALL FIELDS IN QUEENS,cpd11-20qn.pdf
P-4BSHIST,Ft. Totten Bayside Historical Society Officers ClubQ458-116M,846,DEPT OF PARKS AND RECREATION,MAJOR RECREATIONAL FACILITIES AND FACILITY RECONSTRUCTION,400 407,QUEENS,P-D019,180,468,0,229,0,0,0,0,697,468,0,229,0,0,0,0,697,936,0,458,0,0,0,0,1394,PROJECT DELAYED PENDING APPROVAL OF NECESSARY PERMITS,,FT. TOTTEN BAYSIDE HISTORICAL SOCIETY OFFICERS CLUBQ458-116M,cpd11-20qn.pdf
P-4BWALK1,FY12 Queens Boardwalks (FEMA Funded) Q162-212M,846,DEPT OF PARKS AND RECREATION,BEACHES AND BOARDWALKS,400 414,QUEENS,P-D019,2940,690,0,0,149,0,0,0,839,690,0,0,149,0,0,0,839,1380,0,0,298,0,0,0,1678,PROJECT DELAYED DUE TO UNFORESEEN SITE/FIELD CONDITION,"ROCKAWAY, QUEENS",ROCKAWAY BEACH BOARDWALK R/C,cpd11-20qn.pdf
P-4BWIDEF,QUEENS - MULTI SITE QG-210M,846,DEPT OF PARKS AND RECREATION,"LARGE, MAJOR AND REGIONAL PARK RECONSTRUCTION",400,QUEENS,P-0245Q,1582,1345,0,0,0,0,0,0,1345,1345,0,0,0,0,0,0,1345,2690,0,0,0,0,0,0,2690,PROJECT DELAYED DUE TO CHANGES IN SCOPE/DESIGN,,"RC OF PAVEMENTS, HANDBALL AND TENNIS CTS, ROLLER HOCKEY RINKS, FENCES, PLANTINGS AND",cpd11-20qn.pdf
P-4BWIDEK,QUEENS - COUNCIL & BP MULTI SITE (QG-1011M),846,DEPT OF PARKS AND RECREATION,NEIGHBORHOOD PARKS AND PLAYGROUNDS,400,QUEENS,P-D019,1735,1752,250,0,53,0,0,0,2055,1752,250,0,53,0,0,0,2055,3504,500,0,106,0,0,0,4110,PROJECT DELAYED DUE TO CHANGES IN SCOPE/DESIGN,,QUEENS - COUNCIL & BP MULTI SITE,cpd11-20qn.pdf
P-4BWIDEL,QUEENS - COUNCIL & MAYORAL MULTI SITE QG-1116M,846,DEPT OF PARKS AND RECREATION,"LARGE, MAJOR AND REGIONAL PARK RECONSTRUCTION",400,QUEENS,P-D019 P-1018,1398,1259,0,132,0,0,0,0,1391,1259,0,132,0,0,0,0,1391,2518,0,264,0,0,0,0,2782,,,"RECONSTRUCTION OF WATER SUPPLY IN SPRINGFIELD PARK, BROOKVILLE PARK, AND LIBERTY",cpd11-20qn.pdf
P-4BWIDEM,QUEENS - MULTI SITE QG-1216M,846,DEPT OF PARKS AND RECREATION,"LARGE, MAJOR AND REGIONAL PARK RECONSTRUCTION",400,QUEENS,P-D019 P-Q245 P-1018,2935,1068,0,255,0,0,0,0,1323,1068,0,255,0,0,0,0,1323,2136,0,510,0,0,0,0,2646,,,"RECONSTRUCTION OF BRINKERHOFF MALL, HOFFMAN PLAYGROUND, AND PATHS AT FOREST PARK",cpd11-20qn.pdf
P-4BWIDEN,QUEENS - COUNCIL & BP MULTI SITE QG-1316M,846,DEPT OF PARKS AND RECREATION,"LARGE, MAJOR AND REGIONAL PARK RECONSTRUCTION",400,QUEENS,P-D019 P-0245Q,1978,2131,0,154,0,0,0,0,2285,2131,0,154,0,0,0,0,2285,4262,0,308,0,0,0,0,4570,,,"RECONSTRUCTION OF ONE ROOM SCHOOL HOUSE PLAYGROUND, KISSENA PARK CORRIDOR",cpd11-20qn.pdf
P-4BWIDEP,QUEENS - COUNCIL MULTI SITE QG-217M,846,DEPT OF PARKS AND RECREATION,NEIGHBORHOOD PARKS AND PLAYGROUNDS,400,QUEENS,P-D019,400,2160,356,0,0,0,0,0,2516,2160,356,0,0,0,0,0,2516,4320,712,0,0,0,0,0,5032,,,QUEENS MULTI-SITE,cpd11-20qn.pdf
P-4BWIDEQ,Roy Wilkins Southern Qns Pk Performance Area R/C Q448-118M,846,DEPT OF PARKS AND RECREATION,NEIGHBORHOOD PARKS AND PLAYGROUNDS,400,QUEENS,P-0245Q,1018,697,0,50,0,0,0,0,747,697,0,50,0,0,0,0,747,1394,0,100,0,0,0,0,1494,,,RECONSTRUCTION OF BROAD CHANNEL PARK AND IDLEWIDE PARK SITE B,cpd11-20qn.pdf
P-4BWIDER,QUEENS - COUNCIL MULTISITE QG-618M,846,DEPT OF PARKS AND RECREATION,"LARGE, MAJOR AND REGIONAL PARK RECONSTRUCTION",400,QUEENS,P-D019,1411,1009,164,0,0,0,0,0,1173,1009,164,0,0,0,0,0,1173,2018,328,0,0,0,0,0,2346,,,"NEW AND/OR UPGRADED FITNESS EQUIPMENT ALONG SHORE FRONT PARKWAY, AT JUNIPER VALLEY",cpd11-20qn.pdf
P-4BWSTF1,Grover Cleveland Plgd & Pals Oval Synthetic Turf Field R/C,846,DEPT OF PARKS AND RECREATION,"LARGE, MAJOR AND REGIONAL PARK RECONSTRUCTION",400,QUEENS,P-0510,5338,1719,153,0,0,0,0,0,1872,1719,153,0,0,0,0,0,1872,3438,306,0,0,0,0,0,3744,,,"GROVER CLEVELAND PLAYGROUND AND PALS OVAL SYNTHETIC TURF FIELD RECONSTRUCTION,",cpd11-20qn.pdf
P-4BWTRI,GWERTZMAN TRIANGLE - Q274-199,846,DEPT OF PARKS AND RECREATION,NEIGHBORHOOD PARKS AND PLAYGROUNDS,414,QUEENS,P-C171,0,268,41,0,0,0,0,0,309,268,41,0,0,0,0,0,309,536,82,0,0,0,0,0,618,,ASTORIA BLVD & 97ST AND 60 ST & 55 DR,,cpd11-20qn.pdf
P-4CARSON,Silent Spring Playground R/C Q300-116M,846,DEPT OF PARKS AND RECREATION,NEIGHBORHOOD PARKS AND PLAYGROUNDS,400,QUEENS,P-1018,956,2145,0,174,0,0,0,0,2319,2145,0,174,0,0,0,0,2319,4290,0,348,0,0,0,0,4638,PROJECT DELAYED DUE TO CHANGES IN SCOPE/DESIGN,QUEENS,"SILENT SPRING PLAYGROUND RECONSTRUCTION, IN KISSENA PARK CORRIDOR, ACROSS FROM",cpd11-20qn.pdf
P-4CPIAHP,CPI PH2 - Astoria Health Playground R/C Q123-116M,846,DEPT OF PARKS AND RECREATION,NEIGHBORHOOD PARKS AND PLAYGROUNDS,400 401,QUEENS,P-1018,0,2318,1,763,0,0,0,0,3082,2318,1,763,0,0,0,0,3082,4636,2,1526,0,0,0,0,6164,PROJECT DELAYED DUE TO CHANGES IN SCOPE/DESIGN,14TH STREET BETWEEN 31 AVENUE AND 31 DRIVE.,ASTORIA HEALTH PLAYGROUND,cpd11-20qn.pdf
P-4CPIALM,CPI PH2 - Almeda Playground Reconstruction Q443-117M,846,DEPT OF PARKS AND RECREATION,NEIGHBORHOOD PARKS AND PLAYGROUNDS,400,QUEENS,P-1018,7152,7643,953,0,0,0,0,0,8596,7643,953,0,0,0,0,0,8596,15286,1906,0,0,0,0,0,17192,PROJECT DELAYED DUE TO CHANGES IN SCOPE/DESIGN,,CPI PHASE 3 - ALMEDA PLAYGROUND RECONSTRUCTION,cpd11-20qn.pdf
P-4CPIBN5,CPI PH1- RC- Astoria Heights & Bowne Plgd C/S QG-1015M,846,DEPT OF PARKS AND RECREATION,NEIGHBORHOOD PARKS AND PLAYGROUNDS,400 407,QUEENS,P-1018,3132,4506,149,0,46,0,0,0,4701,4506,149,0,46,0,0,0,4701,9012,298,0,92,0,0,0,9402,PROJECT DELAYED DUE TO UNFORESEEN SITE/FIELD CONDITION,"ASTORIA HEIGHTS - 30RD, 45 TO 46 STREETS - BOROUGH OF QUEENS, BOWNE PLAYGROUND - UNION &",ASTORIA HEIGHTS PLAYGROUND & BOWNE PLAYGROUND C/S RECONSTRUCTION,cpd11-20qn.pdf
P-4CPIBOW,CPI PH1- Bowne Playground R/C Q308-115M,846,DEPT OF PARKS AND RECREATION,NEIGHBORHOOD PARKS AND PLAYGROUNDS,400 407,QUEENS,P-1018 WP-0169,515,5978,1,155,331,0,0,0,6465,5978,1,155,331,0,0,0,6465,11956,2,310,662,0,0,0,12930,PROJECT DELAYED PENDING APPROVAL OF NECESSARY PERMITS,"UNION STREET AND SANFORD AVENUE, BOROUGH OF QUEENS",THE RECONSTRUCTION OF BOWNE PLAYGROUND,cpd11-20qn.pdf
P-4CPICHP,CPI PH2 - Chappetto Square R/C Q066H-118M,846,DEPT OF PARKS AND RECREATION,NEIGHBORHOOD PARKS AND PLAYGROUNDS,400,QUEENS,P-0245Q,0,3552,0,1615,0,0,0,0,5167,3552,0,1615,0,0,0,0,5167,7104,0,3230,0,0,0,0,10334,PROJECT DELAYED DUE TO CHANGES IN SCOPE/DESIGN,,CPI PHASE 2,cpd11-20qn.pdf
P-4CPICMA,CPI PH1- Louis Simeone Park R/C Q474-115M,846,DEPT OF PARKS AND RECREATION,NEIGHBORHOOD PARKS AND PLAYGROUNDS,400,QUEENS,P-1018,2240,3015,280,0,0,0,0,0,3295,3015,280,0,0,0,0,0,3295,6030,560,0,0,0,0,0,6590,PROJECT DELAYED DUE TO CHANGES IN SCOPE/DESIGN,CORONA MAC PK/SIMEONE PLGD,CORONA MAC PARK/SIMEONE PLGD & LANDSCAPE,cpd11-20qn.pdf
P-4CPIP35,CPI PH2 - Playground Thirty Five XXXV R/C Q296-116M,846,DEPT OF PARKS AND RECREATION,NEIGHBORHOOD PARKS AND PLAYGROUNDS,400,QUEENS,P-1018,2532,3063,2,117,0,0,0,0,3182,3063,2,117,0,0,0,0,3182,6126,4,234,0,0,0,0,6364,,,THE RECONSTRUCTION OF PLAYGROUND THIRTY FIVE XXXV,cpd11-20qn.pdf
P-4CPIRCP,CPI PH1 - Conch Playground R/C Q394-115M,846,DEPT OF PARKS AND RECREATION,NEIGHBORHOOD PARKS AND PLAYGROUNDS,400,QUEENS,P-1018,4410,7190,307,0,0,0,0,0,7497,7190,307,0,0,0,0,0,7497,14380,614,0,0,0,0,0,14994,PROJECT DELAYED DUE TO CHANGES IN SCOPE/DESIGN,ROCKAWAY COMMUNITY PARK/CONCH PLAYGROUND,ROCKAWAY COMMUNITY PARK / CONCH PLAYGROUND,cpd11-20qn.pdf
P-4CPPLGD,Cunningham Park Upper Playground R/C,846,DEPT OF PARKS AND RECREATION,NEIGHBORHOOD PARKS AND PLAYGROUNDS,400,QUEENS,P-0936,4000,258,710,0,3290,0,0,0,4258,258,710,0,3290,0,0,0,4258,516,1420,0,6580,0,0,0,8516,PROJECT DELAYED DUE TO CHANGES IN SCOPE/DESIGN,,CUNNINGHAM PARK PLAYGROUND,cpd11-20qn.pdf
P-4CPSLIT,College Point Sports Park - New Lighting,846,DEPT OF PARKS AND RECREATION,NEIGHBORHOOD PARKS AND PLAYGROUNDS,400,QUEENS,P-D019 P-Q245,2400,50,100,300,2000,0,0,0,2450,50,100,300,2000,0,0,0,2450,100,200,600,4000,0,0,0,4900,,,COLLEGE POINT SPORTS PARK - NEW LIGHTING,cpd11-20qn.pdf
P-4CPTLCS,Captain Tilly Park Comfort Station,846,DEPT OF PARKS AND RECREATION,NEIGHBORHOOD PARKS AND PLAYGROUNDS,400,QUEENS,P-0505,2701,290,0,0,2123,0,0,0,2413,290,0,0,2123,0,0,0,2413,580,0,0,4246,0,0,0,4826,,,CAPTAIN TILLY PARK COMFORT STATION,cpd11-20qn.pdf
P-4CROCLL,Crocheron Park Little League Field Upgrades Q012-117M,846,DEPT OF PARKS AND RECREATION,NEIGHBORHOOD PARKS AND PLAYGROUNDS,411,QUEENS,P-D019 P-0245Q,1700,1852,146,0,0,0,0,0,1998,1852,146,0,0,0,0,0,1998,3704,292,0,0,0,0,0,3996,PROJECT DELAYED DUE TO CHANGES IN SCOPE/DESIGN,,CROCHERON PARK LITTLE LEAGUE FIELD UPGRADES,cpd11-20qn.pdf
P-4CUN210,CUNNINGHAM PARK 210 ST PLAYGROUND UPGRADE Q021-220M,846,DEPT OF PARKS AND RECREATION,NEIGHBORHOOD PARKS AND PLAYGROUNDS,400,QUEENS,P-Q936 P-D019,4914,100,0,0,3800,0,0,0,3900,100,0,0,3800,0,0,0,3900,200,0,0,7600,0,0,0,7800,,,CUNNINGHAM PARK 210TH STREET PLAYGROUND UPGRADE,cpd11-20qn.pdf
P-4CUNNSL,Recon Upper Cunningham Park sewer line,846,DEPT OF PARKS AND RECREATION,NEIGHBORHOOD PARKS AND PLAYGROUNDS,400,QUEENS,P-0245Q,350,35,350,0,0,0,0,0,385,35,350,0,0,0,0,0,385,70,700,0,0,0,0,0,770,,"UPPER CUNNINGHAM PARK, QUEENS",RECON UPPER CUNNINGHAM PARK SEWER LINE,cpd11-20qn.pdf
P-4CUNPLG,Redwood Playground in Cunningham Park R/C Q021-117M,846,DEPT OF PARKS AND RECREATION,NEIGHBORHOOD PARKS AND PLAYGROUNDS,408,QUEENS,P-1018,1940,2295,169,0,0,0,0,0,2464,2295,169,0,0,0,0,0,2464,4590,338,0,0,0,0,0,4928,PROJECT DELAYED DUE TO CHANGES IN SCOPE/DESIGN,,CUNNINGHAM PARK LOWER PLAYGROUND RENOVATION,cpd11-20qn.pdf
P-4DUTCH1,Dutch Kills Comfort Station Q218-216M,846,DEPT OF PARKS AND RECREATION,"LARGE, MAJOR AND REGIONAL PARK RECONSTRUCTION",400 401,QUEENS,P-0245Q,1681,936,1,744,0,0,0,0,1681,936,1,744,0,0,0,0,1681,1872,2,1488,0,0,0,0,3362,,,RECONSTRUCTION OF PLAYGROUND AND COMFORT STATION,cpd11-20qn.pdf
P-4EABTRC,Emerald Ash Borer (EAB) Tree Remove Queens QG-819M,846,DEPT OF PARKS AND RECREATION,LAND ACQUISITION AND TREE PLANTING,400,QUEENS,P-0822,1219,0,1219,0,0,0,0,0,1219,0,1219,0,0,0,0,0,1219,0,2438,0,0,0,0,0,2438,,EMERALD ASH BORER (EAB) TREE REMOVE QUEENS,EMERALD ASH BORER (EAB) TREE REMOVE QUEENS,cpd11-20qn.pdf
P-4ELMPRK,EAST ELMHURST PARK,846,DEPT OF PARKS AND RECREATION,NEIGHBORHOOD PARKS AND PLAYGROUNDS,400,QUEENS,P-D019,5300,0,100,0,5200,0,0,0,5300,0,100,0,5200,0,0,0,5300,0,200,0,10400,0,0,0,10600,,,"EAST ELMHURST PARK - CONVERT GRASS FIELD TO SYNTHETIC TURF, QUEENS",cpd11-20qn.pdf
P-4EMLDRF,Recon of Roofing systems at Emerald,846,DEPT OF PARKS AND RECREATION,NEIGHBORHOOD PARKS AND PLAYGROUNDS,400,QUEENS,P-1249,165,15,143,0,0,0,0,0,158,15,143,0,0,0,0,0,158,30,286,0,0,0,0,0,316,,QUEENS,RECON OF ROOFING SYSTEMS AT EMERALD,cpd11-20qn.pdf
P-4FITZPG,FITZGERALD PLAYGROUND,846,DEPT OF PARKS AND RECREATION,NEIGHBORHOOD PARKS AND PLAYGROUNDS,400,QUEENS,P-Q245 P-D019,3250,0,1850,0,2250,0,0,0,4100,0,1850,0,2250,0,0,0,4100,0,3700,0,4500,0,0,0,8200,,,"FITGERALD PLAYGROUND RENOVATION, QN",cpd11-20qn.pdf
P-4FLBAY2,FLUSHING BAY DREDGING & CONSTR OF BOAT RAMP Q099-300M,846,DEPT OF PARKS AND RECREATION,"LARGE, MAJOR AND REGIONAL PARK RECONSTRUCTION",400,QUEENS,WP-0169,1718,1445,98,0,0,0,0,0,1543,1445,98,0,0,0,0,0,1543,2890,196,0,0,0,0,0,3086,,"EASTERN TERMINUS OF THE FLUSHING BAY PROM. LOCATED IN FLUSHING MEADOWS-CORONA PARK,",DREDGING AND CONSTR BOAT RAMP,cpd11-20qn.pdf
P-4FMCPIC,"Recon ice plant at FMCP, Queens",846,DEPT OF PARKS AND RECREATION,NEIGHBORHOOD PARKS AND PLAYGROUNDS,400,QUEENS,P-1250,3400,0,400,3000,0,0,0,0,3400,0,400,3000,0,0,0,0,3400,0,800,6000,0,0,0,0,6800,,QUEENS,"RECON ICE PLANT AT FMCP, QUEENS",cpd11-20qn.pdf
P-4FMGARG,Flushing Meadows Corona Park Garage,846,DEPT OF PARKS AND RECREATION,MAJOR RECREATIONAL FACILITIES AND FACILITY RECONSTRUCTION,400,QUEENS,P-0245Q,8000,6009,2360,0,0,0,0,0,8369,6009,2360,0,0,0,0,0,8369,12018,4720,0,0,0,0,0,16738,,,FLUSHING MEADOWS CORONA PARK GARAGE,cpd11-20qn.pdf
P-4FMMAUR,FMCP Mauro Playground Upgrades Q099-917M,846,DEPT OF PARKS AND RECREATION,NEIGHBORHOOD PARKS AND PLAYGROUNDS,400,QUEENS,P-Q245 P-1018,1800,5669,205,0,0,0,0,0,5874,5669,205,0,0,0,0,0,5874,11338,410,0,0,0,0,0,11748,PROJECT DELAYED DUE TO CHANGES IN SCOPE/DESIGN,,MAURO PLAYGROUND UPGRADES,cpd11-20qn.pdf
P-4FRDJPU,FREDERICK JUDGE PLAYGROUND UPGRADES Q119-120M,846,DEPT OF PARKS AND RECREATION,NEIGHBORHOOD PARKS AND PLAYGROUNDS,400,QUEENS,P-Q245 P-D019,3953,50,642,0,1700,1058,0,0,3450,50,642,0,1700,1058,0,0,3450,100,1284,0,3400,2116,0,0,6900,,,UPGRADES TO FREDERICK JUDGE PLAYGROUND IN QUEENS,cpd11-20qn.pdf
P-4FTTOTB,FT. TOTTEN PK CHAPEL & COMMANDER'S HOUSE Q458-112M,846,DEPT OF PARKS AND RECREATION,"LARGE, MAJOR AND REGIONAL PARK RECONSTRUCTION",407,QUEENS,P-1018 P-1324,3087,5025,2049,436,0,0,0,0,7510,5025,2049,436,0,0,0,0,7510,10050,4098,872,0,0,0,0,15020,PROJECT DELAYED DUE TO UNFORESEEN SITE/FIELD CONDITION,QUEENS,"FORT TOTTEN BUILDING 422 ADA ACCESSIBILITY, NEW ROOF AND EXTERIOR WORK",cpd11-20qn.pdf
P-4FTTOTC,FT. TOTTEN ELEVATORS Q458,846,DEPT OF PARKS AND RECREATION,"LARGE, MAJOR AND REGIONAL PARK RECONSTRUCTION",400,QUEENS,P-D019,350,0,350,0,0,0,0,0,350,0,350,0,0,0,0,0,350,0,700,0,0,0,0,0,700,,,FT. TOTTEN ELEVATORS Q458,cpd11-20qn.pdf
P-4GBLPLG,SEVEN GABLES PLAYGROUND,846,DEPT OF PARKS AND RECREATION,NEIGHBORHOOD PARKS AND PLAYGROUNDS,400,QUEENS,P-D019 P-Q245,5540,0,0,50,5540,0,0,0,5590,0,0,50,5540,0,0,0,5590,0,0,100,11080,0,0,0,11180,,,"RENOVATIONO OF SEVEN GABLES PLAYGROUND, QUEENS",cpd11-20qn.pdf
P-4GLNOAK,Tenney Pk (Glen Oaks) Bball Ct./Play Equip. R/C Q310-118M,846,DEPT OF PARKS AND RECREATION,NEIGHBORHOOD PARKS AND PLAYGROUNDS,400,QUEENS,P-Q245,1500,1086,482,0,0,0,0,0,1568,1086,482,0,0,0,0,0,1568,2172,964,0,0,0,0,0,3136,PROJECT DELAYED DUE TO CHANGES IN SCOPE/DESIGN,,RECONSTRUCTION OF THE PLAY EQUIPMENT AT TENNEY PARK (GLEN OAKS OVAL)...,cpd11-20qn.pdf
P-4HARTRF,Recon of Roofing systems at Hart Comf Sta,846,DEPT OF PARKS AND RECREATION,NEIGHBORHOOD PARKS AND PLAYGROUNDS,400,QUEENS,P-1249,175,16,152,0,0,0,0,0,168,16,152,0,0,0,0,0,168,32,304,0,0,0,0,0,336,,QUEENS,RECON OF ROOFING SYSTEMS AT HART COMF STA,cpd11-20qn.pdf
P-4HCHAND,HALLET'S COVE RENOVATION OF HANDBALL COURT AND FENCING,846,DEPT OF PARKS AND RECREATION,NEIGHBORHOOD PARKS AND PLAYGROUNDS,400,QUEENS,P-Q245,450,30,450,0,0,0,0,0,480,30,450,0,0,0,0,0,480,60,900,0,0,0,0,0,960,,,RENOVATION OF THE HANDBALL COURT WALL & ADJACENT FENCING AT HALLET'S COVE IN QUEENS,cpd11-20qn.pdf
P-4HCOVP2,Hallet's Cove Playground MPPA Q226-119M,846,DEPT OF PARKS AND RECREATION,NEIGHBORHOOD PARKS AND PLAYGROUNDS,400,QUEENS,P-D019,3537,375,0,2773,0,0,0,0,3148,375,0,2773,0,0,0,0,3148,750,0,5546,0,0,0,0,6296,,,CREATE A MULTIPURPOSE PLAY AREA AT HALLETS COVE PLAYGROUND,cpd11-20qn.pdf
P-4HCOVPG,Hallets Cove Playground R/C Q226-117M,846,DEPT OF PARKS AND RECREATION,NEIGHBORHOOD PARKS AND PLAYGROUNDS,401,QUEENS,P-0245Q,1210,2419,1,154,0,0,0,0,2574,2419,1,154,0,0,0,0,2574,4838,2,308,0,0,0,0,5148,PROJECT DELAYED DUE TO CHANGES IN SCOPE/DESIGN,,HALLETS COVE PLAYGROUND,cpd11-20qn.pdf
P-4HVRMAN,Hoover Manton Park MPPA Reconstruction SOGR,846,DEPT OF PARKS AND RECREATION,NEIGHBORHOOD PARKS AND PLAYGROUNDS,400,QUEENS,P-1018,1200,0,0,1200,0,0,0,0,1200,0,0,1200,0,0,0,0,1200,0,0,2400,0,0,0,0,2400,,QUEENS,MPPA AND COURT PAVEMENT RECONSTRUCTION SOGR,cpd11-20qn.pdf
P-4IDLETB,IDLEWILD PARK CONSTRUCTION OF NATURE TRAIL AND BOARDWALK,846,DEPT OF PARKS AND RECREATION,NEIGHBORHOOD PARKS AND PLAYGROUNDS,413,QUEENS,P-Q245,1000,0,0,1000,0,0,0,0,1000,0,0,1000,0,0,0,0,1000,0,0,2000,0,0,0,0,2000,,,IDLEWILD PARK - EASTERN QUEENS ALLIANCE,cpd11-20qn.pdf
P-4JAUSTI,JOSEPH AUSTIN PLAYGROUND Q391-108M,846,DEPT OF PARKS AND RECREATION,NEIGHBORHOOD PARKS AND PLAYGROUNDS,400 408,QUEENS,P-Q245,3700,3229,81,0,0,0,0,0,3310,3229,81,0,0,0,0,0,3310,6458,162,0,0,0,0,0,6620,PROJECT DELAYED DUE TO UNFORESEEN HAZARDOUS CONDITION,QUEENS,JOSEPH AUSTIN PLGD,cpd11-20qn.pdf
P-4JMMPP2,JOE MICHAEL MILE PHASE 2 PATH RENO NORTH,846,DEPT OF PARKS AND RECREATION,NEIGHBORHOOD PARKS AND PLAYGROUNDS,400,QUEENS,P-D019,3600,0,100,0,3300,0,0,0,3400,0,100,0,3300,0,0,0,3400,0,200,0,6600,0,0,0,6800,,,JOE MICHAEL MILE PHASE 2 PATH RENO NORTH,cpd11-20qn.pdf
P-4LATRUF,RUFUS KING MANOR & LEWIS H LATIMER HOUSE ROOFS QG-411M,846,DEPT OF PARKS AND RECREATION,NEIGHBORHOOD PARKS AND PLAYGROUNDS,400 412,QUEENS,P-Q245,1400,1978,0,541,0,0,0,0,2519,1978,0,541,0,0,0,0,2519,3956,0,1082,0,0,0,0,5038,PROJECT DELAYED DUE TO CHANGES IN SCOPE/DESIGN,,KING MANOR AND LEWIS H LATIMER HOUSE ROOF PROJECTS,cpd11-20qn.pdf
P-4LIBTPL,"Recon pool deck at Liberty Pool, Queens",846,DEPT OF PARKS AND RECREATION,NEIGHBORHOOD PARKS AND PLAYGROUNDS,400,QUEENS,P-1008 P-1018,1201,40,0,1301,0,0,0,0,1341,40,0,1301,0,0,0,0,1341,80,0,2602,0,0,0,0,2682,,"LIBERTY POOL, QUEENS","RECON POOL DECK AT LIBERTY POOL, QUEENS",cpd11-20qn.pdf
P-4LINDE2,Park of the Americas - Plygrd & Synthetic Turf R/C Q026-118M,846,DEPT OF PARKS AND RECREATION,NEIGHBORHOOD PARKS AND PLAYGROUNDS,400,QUEENS,P-0245Q,1000,4364,506,0,0,0,0,0,4870,4364,506,0,0,0,0,0,4870,8728,1012,0,0,0,0,0,9740,PROJECT DELAYED DUE TO CHANGES IN SCOPE/DESIGN,,"LINDEN PK BB FIELD, BASKETBALL CT & ADULT FITNESS EQUIP",cpd11-20qn.pdf
P-4LTLBSH,Nathan Weidenbaum Park Playground R/C Q205B-118M,846,DEPT OF PARKS AND RECREATION,NEIGHBORHOOD PARKS AND PLAYGROUNDS,400,QUEENS,P-D019 P-0935,500,2961,527,0,0,0,0,0,3488,2961,527,0,0,0,0,0,3488,5922,1054,0,0,0,0,0,6976,,,NATHAN WEIDENBAUM (LITTLE BUSH) PARK - PLAYGROUND RENOVATION,cpd11-20qn.pdf
P-4MARFAJ,MARIO FAJARDO PLAYGROUND,846,DEPT OF PARKS AND RECREATION,NEIGHBORHOOD PARKS AND PLAYGROUNDS,400,QUEENS,P-D019 P-Q245,3200,0,100,400,4900,0,0,0,5400,0,100,400,4900,0,0,0,5400,0,200,800,9800,0,0,0,10800,,,"MARI FAJARDO PLAYGROUND RENOVATION, QUEENS",cpd11-20qn.pdf
P-4NFWF01,NFWF - Alley Pond Park Living Shoreline Cons Q001-118M,846,DEPT OF PARKS AND RECREATION,"LARGE, MAJOR AND REGIONAL PARK RECONSTRUCTION",400,QUEENS,P-1018,91,0,0,0,0,0,0,0,0,0,0,0,0,0,0,0,0,0,0,0,0,0,0,0,0,,,"CONSTRUCTION OF A LIVING SHORELINE AT ALLEY POND PARK, BOROUGH OF QUEENS",cpd11-20qn.pdf
P-4NNANPG,NOONAN PLAYGROUND- Q044-119M,846,DEPT OF PARKS AND RECREATION,NEIGHBORHOOD PARKS AND PLAYGROUNDS,400,QUEENS,P-0505,3082,200,208,0,2292,0,0,0,2700,200,208,0,2292,0,0,0,2700,400,416,0,4584,0,0,0,5400,,,NOONAN PLAYGROUND,cpd11-20qn.pdf
P-4OLMST3,OLMSTED CTR FURNITURE Q099-808MA1,846,DEPT OF PARKS AND RECREATION,"LARGE, MAJOR AND REGIONAL PARK RECONSTRUCTION",400 403 404 406 407 408,QUEENS,P-0013,1200,887,1100,0,0,0,0,0,1987,887,1100,0,0,0,0,0,1987,1774,2200,0,0,0,0,0,3974,PROJECT DELAYED DUE TO UNFORESEEN SITE/FIELD CONDITION,"FMCP, QUEENS",OLMSTED CTR PARKING LOT,cpd11-20qn.pdf
P-4OLMST4,OLMSTED CTR RC (BUILDING) Q099-808MA,846,DEPT OF PARKS AND RECREATION,"LARGE, MAJOR AND REGIONAL PARK RECONSTRUCTION",400 403 404 406 407 408,QUEENS,P-0013 P-0245Q,16483,25839,5974,0,0,0,0,0,31813,25839,5974,0,0,0,0,0,31813,51678,11948,0,0,0,0,0,63626,PROJECT DELAYED DUE TO UNFORESEEN SITE/FIELD CONDITION,,"OLMSTED CTR RC (BUILDING) Q099-808M...2/26/18 $284K (P-0013, FY18) XFER FR P-4OLMST1...2/26/18 $4K",cpd11-20qn.pdf
P-4OVERLK,Overlook Park R/C Q299-117M,846,DEPT OF PARKS AND RECREATION,NEIGHBORHOOD PARKS AND PLAYGROUNDS,403,QUEENS,P-0245Q,2860,1242,0,770,0,0,0,0,2012,1242,0,770,0,0,0,0,2012,2484,0,1540,0,0,0,0,4024,,"DITMARS BLVD., 22 DR. BET. 97 ST. AND 100 ST., QUEENS",OVERLOOK PARK EAST ELMHURST DOG RUN,cpd11-20qn.pdf
P-4PASAIR,Passerelle Building/ Port Arth. AirTrain,846,DEPT OF PARKS AND RECREATION,MAJOR RECREATIONAL FACILITIES AND FACILITY RECONSTRUCTION,400,QUEENS,P-0245Q,125141,0,0,0,0,8675,116216,0,124891,0,0,0,0,8675,116216,0,124891,0,0,0,0,17350,232432,0,249782,,PASSERELLE/PORT AUTHORITY,PARKS PASSERELLE/PORT AUTHORITY AIRTRAIN,cpd11-20qn.pdf
P-4PDLBRC,Lost Battalion Rec Ctr RC Q401-115M,846,DEPT OF PARKS AND RECREATION,MAJOR RECREATIONAL FACILITIES AND FACILITY RECONSTRUCTION,400,QUEENS,P-1018 P-0506 P-D019,4000,1426,3,0,12897,0,0,0,14326,1426,3,0,12897,0,0,0,14326,2852,6,0,25794,0,0,0,28652,PROJECT DELAYED DUE TO CHANGES IN SCOPE/DESIGN,QUEENS,LOST BATTALION REC CTR RC,cpd11-20qn.pdf
P-4PLG12A,"Reconstruction of plgr, Borough ofQueens (QG-112M)",846,DEPT OF PARKS AND RECREATION,"LARGE, MAJOR AND REGIONAL PARK RECONSTRUCTION",400,QUEENS,P-0245Q,50,146,0,0,0,0,0,0,146,146,0,0,0,0,0,0,146,292,0,0,0,0,0,0,292,PROJECT DELAYED DUE TO CHANGES IN SCOPE/DESIGN,QUEENS BOROUGHWIDE,PLGR,cpd11-20qn.pdf
P-4PLG12B,FY12 Reconstruction of plgr Queens QG-212M,846,DEPT OF PARKS AND RECREATION,NEIGHBORHOOD PARKS AND PLAYGROUNDS,400,QUEENS,P-D019 P-Q245,925,838,433,0,0,0,0,0,1271,838,433,0,0,0,0,0,1271,1676,866,0,0,0,0,0,2542,PROJECT DELAYED DUE TO CHANGES IN SCOPE/DESIGN,BOROUGHWIDE,FY12 RECONSTRUCTION OF PLGR QUEENS,cpd11-20qn.pdf
P-4PLG13G,FY13 Queens Plgrd Multisite QG-913M,846,DEPT OF PARKS AND RECREATION,NEIGHBORHOOD PARKS AND PLAYGROUNDS,400,QUEENS,P-Q245,1478,1123,235,0,0,0,0,0,1358,1123,235,0,0,0,0,0,1358,2246,470,0,0,0,0,0,2716,,,"RECONSTRUCTION OF PAVEMENTS, DRAINAGE, PLANTINGS, AND GENERAL SITEWORK AT HOLY COW",cpd11-20qn.pdf
P-4PLG13H,FY13 Queens Plgrd Multisite QG-514MA,846,DEPT OF PARKS AND RECREATION,NEIGHBORHOOD PARKS AND PLAYGROUNDS,400,QUEENS,P-D019,600,2465,0,70,0,0,0,0,2535,2465,0,70,0,0,0,0,2535,4930,0,140,0,0,0,0,5070,PROJECT DELAYED DUE TO CHANGES IN SCOPE/DESIGN,,"RECONSTRUCTION OF PAVEMENT, FENCING, AND SIDEWALKS, NEW ADULT FITNESSEQUIPMENT AND",cpd11-20qn.pdf
P-4PLG13M,FY13 Queens Plgrd Multisite QG-1913M,846,DEPT OF PARKS AND RECREATION,NEIGHBORHOOD PARKS AND PLAYGROUNDS,400,QUEENS,P-D019,720,629,39,0,0,0,0,0,668,629,39,0,0,0,0,0,668,1258,78,0,0,0,0,0,1336,PROJECT DELAYED DUE TO CHANGES IN SCOPE/DESIGN,,SGT. COLLINS PK RENOVATIONS WK AND ADDITION GAZEBO,cpd11-20qn.pdf
P-4PNYT29,"PlaNYC FY18 Street Tree Queens CB 7,8,11 QG-",846,DEPT OF PARKS AND RECREATION,LAND ACQUISITION AND TREE PLANTING,400,QUEENS,P-0822,2386,3180,340,0,0,0,0,0,3520,3180,340,0,0,0,0,0,3520,6360,680,0,0,0,0,0,7040,,"PLANYC FY18 STREET TREE QUEENS CB 7,8,11","PLANYC FY18 STREET TREE QUEENS CB 7,8,11",cpd11-20qn.pdf
P-4PNYT30,"PlaNYC FY18 Street Tree Queens CB 12,13,14",846,DEPT OF PARKS AND RECREATION,LAND ACQUISITION AND TREE PLANTING,400,QUEENS,P-0822,2365,158,0,2990,0,0,0,0,3148,158,0,2990,0,0,0,0,3148,316,0,5980,0,0,0,0,6296,,"PLANYC FY18 STREET TREE QUEENS CB 12,13,14","PLANYC FY18 STREET TREE QUEENS CB 12,13,14",cpd11-20qn.pdf
P-4PS183P,P.S. 183 PLAYGROUND RC Q403-111M,846,DEPT OF PARKS AND RECREATION,NEIGHBORHOOD PARKS AND PLAYGROUNDS,400 414,QUEENS,P-D019,1000,1407,39,0,15,0,0,0,1461,1407,39,0,15,0,0,0,1461,2814,78,0,30,0,0,0,2922,PROJECT DELAYED DUE TO CHANGES IN SCOPE/DESIGN,,PLAYGROUND IS IN DIRE NEED OF NEW EQUIPMENT AND REFURBISHMENT,cpd11-20qn.pdf
P-4PWOB01,PWOB - FMCP Henry Hudson Entrance Q099-317M,846,DEPT OF PARKS AND RECREATION,"LARGE, MAJOR AND REGIONAL PARK RECONSTRUCTION",400,QUEENS,P-1018,3950,4054,910,0,0,0,0,0,4964,4054,910,0,0,0,0,0,4964,8108,1820,0,0,0,0,0,9928,,,PARKS WITHOUT BORDERS SITE - FLUSHING MEADOWS CORONA PARK 111TH STREET (HENDRY,cpd11-20qn.pdf
P-4QCFMEC,QUEENS COUNTY FARM MUSEUM--CONSTRUCTION OF NEW EDUCATION CTR,846,DEPT OF PARKS AND RECREATION,NEIGHBORHOOD PARKS AND PLAYGROUNDS,400,QUEENS,P-Q245,1440,0,1440,0,0,0,0,0,1440,0,1440,0,0,0,0,0,1440,0,2880,0,0,0,0,0,2880,,,QUEENS COUNTY FARM MUSEUM--CONSTRUCTION OF A NEW EDUCATION CENTER.,cpd11-20qn.pdf
P-4QCMGL2,Queens County Farm-Gas Line Part II,846,DEPT OF PARKS AND RECREATION,NEIGHBORHOOD PARKS AND PLAYGROUNDS,400,QUEENS,P-Q245,60,0,60,0,0,0,0,0,60,0,60,0,0,0,0,0,60,0,120,0,0,0,0,0,120,,,QUEENS COUNTY FARM-GAS LINE PART 2,cpd11-20qn.pdf
P-4QMULT2,QUEENS MULTISITE,846,DEPT OF PARKS AND RECREATION,NEIGHBORHOOD PARKS AND PLAYGROUNDS,400,QUEENS,P-D019,225,0,0,0,3000,0,0,0,3000,0,0,0,3000,0,0,0,3000,0,0,0,6000,0,0,0,6000,PROJECT DELAYED DUE TO SCHEDULING OF UTILITY WORK,,IDLEWILD PK CRICKET PITCH FIELD CONSTRUCTION; JOHN BOWNE HS BASEBALLFIELDS,cpd11-20qn.pdf
P-4QNHSRC,QUEENS HISTORICAL SOCIETY CONSTRUCTION AND RENOVATION,846,DEPT OF PARKS AND RECREATION,NEIGHBORHOOD PARKS AND PLAYGROUNDS,400,QUEENS,P-Q245 P-D019,1700,0,1700,0,0,0,0,0,1700,0,1700,0,0,0,0,0,1700,0,3400,0,0,0,0,0,3400,,,QUEENS HISTORICAL SOCIETY CONSTRUCTION AND RENOVATION IN QUEENS,cpd11-20qn.pdf
P-4QNPAV1,State of Good Repair - Queens,846,DEPT OF PARKS AND RECREATION,NEIGHBORHOOD PARKS AND PLAYGROUNDS,400,QUEENS,P-1018,1219,0,0,0,1219,0,0,0,1219,0,0,0,1219,0,0,0,1219,0,0,0,2438,0,0,0,2438,,QUEENS,STATE OF GOOD REPAIR - QUEENS,cpd11-20qn.pdf
P-4QSTORE,QUEENS STOREHOUSE Q099-520M,846,DEPT OF PARKS AND RECREATION,MAJOR RECREATIONAL FACILITIES AND FACILITY RECONSTRUCTION,400,QUEENS,P-0245Q,14048,0,1500,0,0,14048,0,0,15548,0,1500,0,0,14048,0,0,15548,0,3000,0,0,28096,0,0,31096,,QUEENS,QUEENS STOREHOUSE,cpd11-20qn.pdf
P-4QWCAMS,Queens Wildlife Center Aviary Mesh Replacement,846,DEPT OF PARKS AND RECREATION,ZOOS,400,QUEENS,P-Q245,400,0,0,0,400,0,0,0,400,0,0,0,400,0,0,0,400,0,0,0,800,0,0,0,800,,,QUEENS WILDLIFE CENTER AVIARY MESH REPLACEMENT,cpd11-20qn.pdf
P-4RAINE2,"Rainey Pk Picnic Grove, Bsktball Ct, & Dog Run R/C Q048-119M",846,DEPT OF PARKS AND RECREATION,NEIGHBORHOOD PARKS AND PLAYGROUNDS,400 401,QUEENS,P-D019 P-Q245,1200,150,585,0,6915,0,0,0,7650,150,585,0,6915,0,0,0,7650,300,1170,0,13830,0,0,0,15300,PROJECT DELAYED DUE TO CHANGES IN SCOPE/DESIGN,,"RAINEY PARK - RECONSTRUCTION OF THE PICNIC GROVE, BASKETBALL COURT, AND DOG RUN,",cpd11-20qn.pdf
P-4RCKHQS,Rockaway Operational Headquarters-Supplement Funding,846,DEPT OF PARKS AND RECREATION,BEACHES AND BOARDWALKS,400,QUEENS,P-1018,1730,0,0,0,0,0,1730,0,1730,0,0,0,0,0,1730,0,1730,0,0,0,0,0,3460,0,3460,,,ROCKAWAY OPERATIONAL HEADQUARTERS-SUPPLEMENT,cpd11-20qn.pdf
P-4RDGEWD,Rosemary's Plgd R/C Q398-117M,846,DEPT OF PARKS AND RECREATION,NEIGHBORHOOD PARKS AND PLAYGROUNDS,400,QUEENS,P-D019,300,3384,475,0,0,0,0,0,3859,3384,475,0,0,0,0,0,3859,6768,950,0,0,0,0,0,7718,PROJECT DELAYED DUE TO CHANGES IN SCOPE/DESIGN,,RIDGEWOOD PARK,cpd11-20qn.pdf
P-4RGROI2,Rockaway Beach Reformulation- Groin removal & crossing cons,846,DEPT OF PARKS AND RECREATION,BEACHES AND BOARDWALKS,400,QUEENS,P-0245Q,8288,0,1288,7000,0,25000,0,0,33288,0,1288,7000,0,25000,0,0,33288,0,2576,14000,0,50000,0,0,66576,,,THE US ARMY CORPS OF ENGINEERS WILL BE CONSTRUCTING NEW GROINS ON ROCKAWAY BEACH IN,cpd11-20qn.pdf
P-4SAND02,SANDY - Spring Creek Pk GI Resiliency Q165-116MA,846,DEPT OF PARKS AND RECREATION,LAND ACQUISITION AND TREE PLANTING,400,QUEENS,P-1018,3370,302,0,0,0,0,0,0,302,302,0,0,0,0,0,0,302,604,0,0,0,0,0,0,604,,,NATURAL AREA RESTORATION AND INSTALLATION OF A BERM/WALL SYSTEM AND STORMWATER,cpd11-20qn.pdf
P-4SHREAC,Shorefront Parkway Adventure Course Q163-218M,846,DEPT OF PARKS AND RECREATION,BEACHES AND BOARDWALKS,400,QUEENS,P-Q003 P-D019,408,0,583,0,0,0,0,0,583,0,583,0,0,0,0,0,583,0,1166,0,0,0,0,0,1166,,,"CONSTRUCTION OF AN ADVENTURE COURSE ALONG SHOREFRONT PARKWAY, BOROUGHOF QUEENS",cpd11-20qn.pdf
P-4SHREDP,Shorefront Parkway Dog Run Cons. Q163-118M,846,DEPT OF PARKS AND RECREATION,BEACHES AND BOARDWALKS,400,QUEENS,P-Q003,154,0,154,0,0,0,0,0,154,0,154,0,0,0,0,0,154,0,308,0,0,0,0,0,308,,,"CONSTRUCTION OF A DOG PARK ALONG SHOREFRONT PARKWAY, BOROUGH OF QUEENS",cpd11-20qn.pdf
P-4SHREPG,Shorefront Tot Playground and Plaza Area Q163-318M,846,DEPT OF PARKS AND RECREATION,BEACHES AND BOARDWALKS,400,QUEENS,P-Q003,644,0,644,0,0,0,0,0,644,0,644,0,0,0,0,0,644,0,1288,0,0,0,0,0,1288,,,"CONSTRUCTION OF A TOT PLAYGROUND AND PLAZA AREA ALONG SHOREFRONT PARKWAY, BOROUGH",cpd11-20qn.pdf
P-4SHRESA,Shorefront Parkway Park Amenities,846,DEPT OF PARKS AND RECREATION,BEACHES AND BOARDWALKS,400,QUEENS,P-Q003,491,0,54,281,24,0,0,0,359,0,54,281,24,0,0,0,359,0,108,562,48,0,0,0,718,,,"CONSTRUCTION OF PARK AMENITIES ALONG SHOREFRONT PARKWAY, BOROUGH OF QUEENS",cpd11-20qn.pdf
P-4SHRESF,Shorefront Parkway Multi-Purpose Sports Field Cons Q163-618M,846,DEPT OF PARKS AND RECREATION,BEACHES AND BOARDWALKS,400,QUEENS,P-Q003,728,51,623,54,0,0,0,0,728,51,623,54,0,0,0,0,728,102,1246,108,0,0,0,0,1456,,,"CONSTRUCTION OF A MULTI-PURPOSE SPORTS FIELD ALONG SHOREFRONT PARKWAY, BOROUGH OF",cpd11-20qn.pdf
P-4STFCAR,"Syn Turf Field Recon at Rachel Carson at Kessina, QN",846,DEPT OF PARKS AND RECREATION,NEIGHBORHOOD PARKS AND PLAYGROUNDS,400,QUEENS,P-1018,605,0,605,0,0,0,0,0,605,0,605,0,0,0,0,0,605,0,1210,0,0,0,0,0,1210,,"RACHEL CARSON AT KESSINA, QN","SYN TURF FIELD RECON AT RACHEL CARSON AT KESSINA, QN",cpd11-20qn.pdf
P-4SUNRSE,Sunrise Stables Acquisition,846,DEPT OF PARKS AND RECREATION,NEIGHBORHOOD PARKS AND PLAYGROUNDS,400,QUEENS,P-D019,636,0,10,490,0,0,0,0,500,0,10,490,0,0,0,0,500,0,20,980,0,0,0,0,1000,,SOUTH CONDUIT AND LINDEN,SUNRISE STABLES ACQUISITION,cpd11-20qn.pdf
P-4TRE18A,FY18 Street Tree Queens CBs 1-5 QG-,846,DEPT OF PARKS AND RECREATION,LAND ACQUISITION AND TREE PLANTING,400,QUEENS,P-Q245,2660,173,0,500,0,0,0,0,673,173,0,500,0,0,0,0,673,346,0,1000,0,0,0,0,1346,,FY18 STREET TREE QUEENS CBS 1-5,FY18 STREET TREE QUEENS CBS 1-5,cpd11-20qn.pdf
P-4TRE20A,FY20 Street Tree Queens CBs 1-6 QG-419M,846,DEPT OF PARKS AND RECREATION,LAND ACQUISITION AND TREE PLANTING,400,QUEENS,P-0822 P-D822 P-1018,2057,75,2057,0,0,0,0,0,2132,75,2057,0,0,0,0,0,2132,150,4114,0,0,0,0,0,4264,,FY20 STREET TREE QUEENS CBS 1-6 QG-419M,FY20 STREET TREE QUEENS CBS 1-6 QG-419M,cpd11-20qn.pdf
P-4TRE20B,"FY20 Street Tree Queens CBs 7,8,11 QG-219M",846,DEPT OF PARKS AND RECREATION,LAND ACQUISITION AND TREE PLANTING,400,QUEENS,P-0822 WP-0169 P-1018,1977,75,1977,0,0,0,0,0,2052,75,1977,0,0,0,0,0,2052,150,3954,0,0,0,0,0,4104,,"FY20 STREET TREE QUEENS CBS 7,8,11 QG-219M","FY20 STREET TREE QUEENS CBS 7,8,11 QG-219M",cpd11-20qn.pdf
P-4TRE20C,"FY20 Street Tree Queens CBs 9,10,14 QG-519M",846,DEPT OF PARKS AND RECREATION,LAND ACQUISITION AND TREE PLANTING,400,QUEENS,P-1018,2052,2127,0,0,0,0,0,0,2127,2127,0,0,0,0,0,0,2127,4254,0,0,0,0,0,0,4254,,"FY20 STREET TREE QUEENS CBS 9,10,14 QG-519M","FY20 STREET TREE QUEENS CBS 9,10,14 QG-519M",cpd11-20qn.pdf
P-4TRE21A,FY21 Street Tree Queens CBs 1-6 QG-,846,DEPT OF PARKS AND RECREATION,LAND ACQUISITION AND TREE PLANTING,400,QUEENS,P-D019 P-0822,797,25,2205,0,0,0,0,0,2230,25,2205,0,0,0,0,0,2230,50,4410,0,0,0,0,0,4460,,FY21 STREET TREE QUEENS CBS 1-6,FY21 STREET TREE QUEENS CBS 1-6,cpd11-20qn.pdf
P-4TRE21B,"FY21 Street Tree Queens CBs 9,14 QG-",846,DEPT OF PARKS AND RECREATION,LAND ACQUISITION AND TREE PLANTING,400,QUEENS,WM-0006 P-0822 P-1018,1631,0,451,0,0,0,0,0,451,0,451,0,0,0,0,0,451,0,902,0,0,0,0,0,902,,"FY21 STREET TREE QUEENS CBS 9,14","FY21 STREET TREE QUEENS CBS 9,14",cpd11-20qn.pdf
P-4TREL21,"FY21 Street Trees QN CB's 8,11-13(3Y)",846,DEPT OF PARKS AND RECREATION,LAND ACQUISITION AND TREE PLANTING,400,QUEENS,P-D822 P-D019 SE-0200Q WM-0006 P-0822,3591,25,2695,1354,0,0,0,0,4074,25,2695,1354,0,0,0,0,4074,50,5390,2708,0,0,0,0,8148,,QUEENS,"FY21 STREET TREES QN CB'S 8,11-13(3Y)",cpd11-20qn.pdf
P-4TRS19A,"QueensTree-Damaged Sidewalk R/C CB 8,11-14",846,DEPT OF PARKS AND RECREATION,LAND ACQUISITION AND TREE PLANTING,400,QUEENS,P-1331,1540,1585,662,0,0,0,0,0,2247,1585,662,0,0,0,0,0,2247,3170,1324,0,0,0,0,0,4494,,"QUEENSTREE-DAMAGED SIDEWALK R/C CB 8,11-14","QUEENSTREE-DAMAGED SIDEWALK R/C CB 8,11-14",cpd11-20qn.pdf
P-4TRS21A,FY21 Street Tree 7mo Queens CBs7 QG-,846,DEPT OF PARKS AND RECREATION,LAND ACQUISITION AND TREE PLANTING,400,QUEENS,P-0822,882,25,882,0,0,0,0,0,907,25,882,0,0,0,0,0,907,50,1764,0,0,0,0,0,1814,,FY21 STREET TREE 7MO QUEENS CBS7,FY21 STREET TREE 7MO QUEENS CBS7,cpd11-20qn.pdf
P-4TRS21B,FY21 Street Tree 7mo Queens CBs 10 QG-,846,DEPT OF PARKS AND RECREATION,LAND ACQUISITION AND TREE PLANTING,400,QUEENS,P-0822,945,25,945,0,0,0,0,0,970,25,945,0,0,0,0,0,970,50,1890,0,0,0,0,0,1940,,FY21 STREET TREE 7MO QUEENS CBS 10,FY21 STREET TREE 7MO QUEENS CBS 10,cpd11-20qn.pdf
P-4TRSD19,"QueensTree-Damaged Sidewalk R/C CB 1-7,9,10",846,DEPT OF PARKS AND RECREATION,LAND ACQUISITION AND TREE PLANTING,400,QUEENS,P-D019 P-1018 P-1331 P-D822,1890,1565,1666,0,0,0,0,0,3231,1565,1666,0,0,0,0,0,3231,3130,3332,0,0,0,0,0,6462,,QUEENSTREE-DAMAGED SIDEWALK R/C,QUEENSTREE-DAMAGED SIDEWALK R/C,cpd11-20qn.pdf
P-4UDALNP,Udalls Cove Park & Nature Preserve,846,DEPT OF PARKS AND RECREATION,LAND ACQUISITION AND TREE PLANTING,400,QUEENS,P-D019,350,0,350,0,0,0,0,0,350,0,350,0,0,0,0,0,350,0,700,0,0,0,0,0,700,,BOROUGH OF QUEENS,UDALLS COVE PARK & NATURE PRESERVE,cpd11-20qn.pdf
P-4VIETNA,VIETNAM VETERAN MEMORIAL - ELMHURST PARK Q492-117M,846,DEPT OF PARKS AND RECREATION,NEIGHBORHOOD PARKS AND PLAYGROUNDS,400,QUEENS,P-Q245 P-D019,500,2751,562,0,0,0,0,0,3313,2751,562,0,0,0,0,0,3313,5502,1124,0,0,0,0,0,6626,PROJECT DELAYED DUE TO UNFORESEEN SITE/FIELD CONDITION,FORMER KEYSPAN GAS TANK PROPERTY ON 57TH AVENUE BETWEEN 74TH AND 80THSTREETS,CONSTRUCT WAR MEMORIAL ON SITE OF FORMER KEYSPAN GAS TANK PROPERTY ON57TH AVE BET 74,cpd11-20qn.pdf
P-4WOODPZ,WOODSIDE PLAZA,846,DEPT OF PARKS AND RECREATION,NEIGHBORHOOD PARKS AND PLAYGROUNDS,400,QUEENS,P-D019 P-Q245,2000,0,100,650,2000,0,0,0,2750,0,100,650,2000,0,0,0,2750,0,200,1300,4000,0,0,0,5500,,,"RENOVATION OF WOODSIDE PLAZA, QUEENS",cpd11-20qn.pdf
P-4WPJAMC,Walk to Park NYCHA Pomonok Houses Construction,846,DEPT OF PARKS AND RECREATION,NEIGHBORHOOD PARKS AND PLAYGROUNDS,400,QUEENS,P-0245Q,3000,270,0,3000,0,0,0,0,3270,270,0,3000,0,0,0,0,3270,540,0,6000,0,0,0,0,6540,,,"WALK TO PARK NYCHA SOUTH JAMAICA II PLAYGROUND CONSTRUCTION, BOROUGH OF QUEENS",cpd11-20qn.pdf
P-4WPWSDE,Walk to Park NYCHA Woodside Playground Construction,846,DEPT OF PARKS AND RECREATION,NEIGHBORHOOD PARKS AND PLAYGROUNDS,400,QUEENS,P-0245Q,1200,164,0,1000,200,0,0,0,1364,164,0,1000,200,0,0,0,1364,328,0,2000,400,0,0,0,2728,,,"WALK TO PARK NYCHA WOODSIDE PLAYGROUND CONSTRUCTION, BOROUGH OF QUEENS",cpd11-20qn.pdf
P-6BLD14A,FY14 BUILDINGS-RC OF C/S & FACILTIES VAR PKS LOC QG-1613MA,846,DEPT OF PARKS AND RECREATION,"LARGE, MAJOR AND REGIONAL PARK RECONSTRUCTION",400,QUEENS,P-1018,1154,2193,47,29,0,0,0,0,2269,2193,47,29,0,0,0,0,2269,4386,94,58,0,0,0,0,4538,,,FY14 BUILDINGS-RC OF C/S & FACILTIES AT VAR PKS & RECR LOC,cpd11-20qn.pdf
P-6BLD14B,FY14 BUILDINGS-RC OF C/S & FACILTIES AT VAR PKS & RECR LOC,846,DEPT OF PARKS AND RECREATION,"LARGE, MAJOR AND REGIONAL PARK RECONSTRUCTION",400,QUEENS,P-D019 P-Q245 P-1018,1674,2017,498,3,0,0,0,0,2518,2017,498,3,0,0,0,0,2518,4034,996,6,0,0,0,0,5036,,,FY14 BUILDINGS-RC OF C/S & FACILTIES AT VAR PKS & RECR LOC,cpd11-20qn.pdf
P-6ROOFQN,Recon roofs at Forest Pk garage & Oak Ridge QG-918M,846,DEPT OF PARKS AND RECREATION,NEIGHBORHOOD PARKS AND PLAYGROUNDS,400,QUEENS,P-1249,3774,2077,385,0,0,0,0,0,2462,2077,385,0,0,0,0,0,2462,4154,770,0,0,0,0,0,4924,,CITYWIDE,RECON ROOFS AT FOREST PK GARAGE & OAK RIDGE IN FOREST PARK,cpd11-20qn.pdf
SANDY4-02,SANDY- Emergency Storm Make Safe - Rockaway Beach Q162-213M,846,DEPT OF PARKS AND RECREATION,NEIGHBORHOOD PARKS AND PLAYGROUNDS,414,QUEENS,P-1018,2531,913,0,46,0,0,0,0,959,913,0,46,0,0,0,0,959,1826,0,92,0,0,0,0,1918,PROJECT DELAYED DUE TO CHANGES IN SCOPE/DESIGN,,EMERGENCY-STORM MAKE SAFE OF ROCKAWAY BEACH,cpd11-20qn.pdf
SANDY4-08,PNP Socrates Sculpture Park,846,DEPT OF PARKS AND RECREATION,NEIGHBORHOOD PARKS AND PLAYGROUNDS,400 401,QUEENS,P-1018,206,99,31,0,0,0,0,0,130,99,31,0,0,0,0,0,130,198,62,0,0,0,0,0,260,PROJECT DELAYED DUE TO CHANGES IN SCOPE/DESIGN,QUEENS,QUEENS SOCRATES SCULPTURE PARK,cpd11-20qn.pdf
SANDY4-10,"Ralph DeMarco Pk, Shoreline R/C Q004-213M",846,DEPT OF PARKS AND RECREATION,NEIGHBORHOOD PARKS AND PLAYGROUNDS,400,QUEENS,P-1018,92,220,911,503,0,35,0,0,1669,220,911,503,0,35,0,0,1669,440,1822,1006,0,70,0,0,3338,PROJECT DELAYED DUE TO CHANGES IN SCOPE/DESIGN,"RALPH DEMARCO PK, QUEENS","SANDY - R/C OF SHORELINE IN RALPH DEMARCO PK, TYPE 3",cpd11-20qn.pdf
SANDY4-11,SANDY- R/C of Rockaway Garage,846,DEPT OF PARKS AND RECREATION,NEIGHBORHOOD PARKS AND PLAYGROUNDS,400,QUEENS,P-1018,843,0,0,0,0,479,0,0,479,0,0,0,0,479,0,0,479,0,0,0,0,958,0,0,958,,"ROCKAWAY GARAGE , QUEENS",R/C OF ARCHITECTURAL AND MACHANICAL COMPONENTS AT THE ROCKAWAY GARAGE,cpd11-20qn.pdf
SANDY4-12,SANDY- Joe Michael's Mile Promenade Q135-214M,846,DEPT OF PARKS AND RECREATION,NEIGHBORHOOD PARKS AND PLAYGROUNDS,400,QUEENS,P-1018,222,312,6,0,0,0,0,0,318,312,6,0,0,0,0,0,318,624,12,0,0,0,0,0,636,PROJECT DELAYED DUE TO CHANGES IN SCOPE/DESIGN,"28 ROAD AND CROSS ISLAND PKWY, QUEENS",R/C OF THE PROMENADE(JOE MICHAEL'S MILE),cpd11-20qn.pdf
SANDY4-13,SANDY-Rockaway Beach roller hockey rink - Type 3 Q163-114M,846,DEPT OF PARKS AND RECREATION,NEIGHBORHOOD PARKS AND PLAYGROUNDS,400,QUEENS,P-1018,446,31,0,45,0,0,0,0,76,31,0,45,0,0,0,0,76,62,0,90,0,0,0,0,152,,,SANDY-ROCKAWAY BEACH,cpd11-20qn.pdf
SANDY4-15,SANDY - Tree removals - Queens CB 6-15 QG-414M,846,DEPT OF PARKS AND RECREATION,LAND ACQUISITION AND TREE PLANTING,400,QUEENS,P-1018,1900,81,131,0,0,8,0,0,220,81,131,0,0,8,0,0,220,162,262,0,0,16,0,0,440,,QUEENS,TREE REMOVALS RELATED TO SANDY IN THE BOROUGH OF QUEENS,cpd11-20qn.pdf
SANDY4-18,SANDY - Tribute Park Reconstruction Q028-116M,846,DEPT OF PARKS AND RECREATION,NEIGHBORHOOD PARKS AND PLAYGROUNDS,400,QUEENS,P-1018,476,563,0,19,0,0,0,0,582,563,0,19,0,0,0,0,582,1126,0,38,0,0,0,0,1164,,SANDY - TRIBUTE PK AND FLIGHT 587 MEMORIAL,SANDY - TRIBUTE PK AND FLIGHT 587 MEMORIAL,cpd11-20qn.pdf
SANDY4-21,SANDY-FOREST PARK GREENHOUSE BROKEN GLASS REPLACEMENT,846,DEPT OF PARKS AND RECREATION,"LARGE, MAJOR AND REGIONAL PARK RECONSTRUCTION",400,QUEENS,P-1018,253,0,0,26,0,0,0,0,26,0,0,26,0,0,0,0,26,0,0,52,0,0,0,0,52,,,SANDY-FOREST PARK GREENHOUSE BROKEN GLASS REPLACEMENT,cpd11-20qn.pdf
SANDY4-22,SANDY - Rockaway Beach Shorefront Pkwy Handball Ct Q163-315M,846,DEPT OF PARKS AND RECREATION,NEIGHBORHOOD PARKS AND PLAYGROUNDS,400,QUEENS,P-1018,1658,469,30,0,0,0,0,0,499,469,30,0,0,0,0,0,499,938,60,0,0,0,0,0,998,PROJECT DELAYED DUE TO CHANGES IN SCOPE/DESIGN,"BEACH 105 STREET AND BEACH 102 STREET, SOUTH OF SHORE FRONT PARKWAY AT ROCKAWAY BCH",SANDY-ROCKAWAY BCH-R/C OF 8 HANDBALL COURTS,cpd11-20qn.pdf
SANDY4-23,Rockaway Beach Sports Areas,846,DEPT OF PARKS AND RECREATION,MAJOR RECREATIONAL FACILITIES AND FACILITY RECONSTRUCTION,400,QUEENS,P-1018,10357,0,0,0,0,161,0,0,161,0,0,0,0,161,0,0,161,0,0,0,0,322,0,0,322,PROJECT DELAYED DUE TO CHANGES IN SCOPE/DESIGN,,ROCKAWAY BEACH SPORTS AREAS,cpd11-20qn.pdf
SANDY4-25,Bayside Marina Reconstruction (Q135-117M),846,DEPT OF PARKS AND RECREATION,MAJOR RECREATIONAL FACILITIES AND FACILITY RECONSTRUCTION,400,QUEENS,P-1018,1939,337,38,350,0,0,0,0,725,337,38,350,0,0,0,0,725,674,76,700,0,0,0,0,1450,,,BAYSIDE MARINA,cpd11-20qn.pdf
SANDY4-26,World's Fair Marina Q099-218M,846,DEPT OF PARKS AND RECREATION,MAJOR RECREATIONAL FACILITIES AND FACILITY RECONSTRUCTION,400,QUEENS,P-1018,7081,364,300,459,0,0,0,0,1123,364,300,459,0,0,0,0,1123,728,600,918,0,0,0,0,2246,,,WORLD'S FAIR MARINA,cpd11-20qn.pdf
SANDY4-27,Little Bay Revetment,846,DEPT OF PARKS AND RECREATION,NEIGHBORHOOD PARKS AND PLAYGROUNDS,400,QUEENS,P-1018,457,52,103,0,0,0,0,0,155,52,103,0,0,0,0,0,155,104,206,0,0,0,0,0,310,,,JOE MICHAEL'S MILE/LITTLE BAY REVETMENT,cpd11-20qn.pdf
SANDY4-29,FMCP Electrical Repairs,846,DEPT OF PARKS AND RECREATION,NEIGHBORHOOD PARKS AND PLAYGROUNDS,400,QUEENS,P-1018,15440,383,1,0,1616,1688,0,0,3688,383,1,0,1616,1688,0,0,3688,766,2,0,3232,3376,0,0,7376,,,FMCP ELECTRICAL REPAIRS,cpd11-20qn.pdf
SANDY4-32,SANDY - Beach 94th Street Performance Space Cons. Q163-418M,846,DEPT OF PARKS AND RECREATION,BEACHES AND BOARDWALKS,400,QUEENS,P-1018,3532,68,0,0,0,0,0,0,68,68,0,0,0,0,0,0,68,136,0,0,0,0,0,0,136,,,"CONSTRUCTION OF A PERFORMANCE SPACE ON BEACH 94TH STREET, IN ROCKAWAYBEACH, BOROUGH",cpd11-20qn.pdf
SANDY4-33,SANDY - Shorefront Park MPPA Sports Field Cons. Q163-618M,846,DEPT OF PARKS AND RECREATION,BEACHES AND BOARDWALKS,400,QUEENS,P-1018,8448,77,23,2,0,0,0,0,102,77,23,2,0,0,0,0,102,154,46,4,0,0,0,0,204,,,SHOREFRONT PARK MULTI-PURPOSE SPORTS FIELD CONSTRUCTION,cpd11-20qn.pdf
SANDY4-34,SANDY - Shorefront Labyrinth and Seating Area Q163-518M,846,DEPT OF PARKS AND RECREATION,BEACHES AND BOARDWALKS,400,QUEENS,P-1018,2398,95,142,0,12,0,0,0,249,95,142,0,12,0,0,0,249,190,284,0,24,0,0,0,498,,,SHOREFRONT LABYRINTH AND SEATING AREA CONSTRUCTION - BOROUGH OF QUEENS,cpd11-20qn.pdf
SANDY4-35,SANDY - Shorefront Tot Playground and Plaza Area Q163-318M,846,DEPT OF PARKS AND RECREATION,BEACHES AND BOARDWALKS,400,QUEENS,P-1018,10141,415,328,0,0,0,0,0,743,415,328,0,0,0,0,0,743,830,656,0,0,0,0,0,1486,,,"SHOREFRONT TOT PLAYGROUND AND PLAZA AREA CONSTRUCTION, BOROUGH OF QUEENS",cpd11-20qn.pdf
SANDY4-36,SANDY - Shorefront Parkway Adventure Course Q163-218M,846,DEPT OF PARKS AND RECREATION,BEACHES AND BOARDWALKS,400,QUEENS,P-1018,4890,301,213,0,28,0,0,0,542,301,213,0,28,0,0,0,542,602,426,0,56,0,0,0,1084,,,"SHOREFRONT PARKWAY ADVENTURE COURSE CONSTRUCTION, AT ROCKAWAY BEACH AND",cpd11-20qn.pdf
SANDY4-37,SANDY - Beach 88th Street Park Construction Q499-118M,846,DEPT OF PARKS AND RECREATION,BEACHES AND BOARDWALKS,400,QUEENS,P-1018,9172,114,0,0,0,0,0,0,114,114,0,0,0,0,0,0,114,228,0,0,0,0,0,0,228,,,"CONSTRUCTION OF A PARK ON BEACH 88TH STREET, BOROUGH OF QUEENS",cpd11-20qn.pdf
SANDY4-38,SANDY - Beach 24th to Beach 25th Street Ramp Q162-218M,846,DEPT OF PARKS AND RECREATION,BEACHES AND BOARDWALKS,400,QUEENS,P-1018,1473,74,0,0,0,0,0,0,74,74,0,0,0,0,0,0,74,148,0,0,0,0,0,0,148,,,"CONSTRUCTION OF A RAMP BETWEEN BEACH 24TH AND BEACH 25TH STREETS, BOROUGH OF QUEENS",cpd11-20qn.pdf
SANDY4-39,SANDY - Rockaway Community Park Shoreline R/C Q371-119M,846,DEPT OF PARKS AND RECREATION,NEIGHBORHOOD PARKS AND PLAYGROUNDS,414,QUEENS,P-1018,13819,157,0,0,0,0,0,0,157,157,0,0,0,0,0,0,157,314,0,0,0,0,0,0,314,,,"RECONSTRUCTION OF THE SHORELINE AT ROCKAWAY COMMUNITY PARK, BOROUGH OF QUEENS",cpd11-20qn.pdf
SANDY4-41,SANDY - Michaelis-Bayswater Park R/C Q007-119M,846,DEPT OF PARKS AND RECREATION,NEIGHBORHOOD PARKS AND PLAYGROUNDS,414,QUEENS,P-1018,55602,296,0,0,0,0,0,0,296,296,0,0,0,0,0,0,296,592,0,0,0,0,0,0,592,PROJECT DELAYED DUE TO CHANGES IN SCOPE/DESIGN,,"RECONSTRUCTION OF BAYSWATER PARK, BOROUGH OF QUEENS",cpd11-20qn.pdf
SANDY4-42,SANDY - Shorefront Parkway Dog Run Cons. Q163-118M,846,DEPT OF PARKS AND RECREATION,BEACHES AND BOARDWALKS,400,QUEENS,P-1018,1885,205,88,0,0,0,0,0,293,205,88,0,0,0,0,0,293,410,176,0,0,0,0,0,586,,,"CONSTRUCTION OF A DOG PARK ON SHOREFRONT PARKWAY, BOROUGH OF QUEENS",cpd11-20qn.pdf
SANDY4-43,SANDY - Queens B,846,DEPT OF PARKS AND RECREATION,NEIGHBORHOOD PARKS AND PLAYGROUNDS,400,QUEENS,P-1018,1071,0,0,0,0,107,0,0,107,0,0,0,0,107,0,0,107,0,0,0,0,214,0,0,214,PROJECT DELAYED DUE TO CHANGES IN SCOPE/DESIGN,,SANDY - QUEENS B,cpd11-20qn.pdf
SANDY4-44,SANDY - Shorefront Parkway Park Amenities,846,DEPT OF PARKS AND RECREATION,BEACHES AND BOARDWALKS,400,QUEENS,P-1018,3611,180,0,8,0,0,0,0,188,180,0,8,0,0,0,0,188,360,0,16,0,0,0,0,376,,,"CONSTRUCTION OF PARK AMENITIES ALONG SHOREFRONT PARKWAY, BOROUGH OF QUEENS",cpd11-20qn.pdf
SANDY4-45,SANDY - Thursby Basin Park Construction Q479-120M,846,DEPT OF PARKS AND RECREATION,NEIGHBORHOOD PARKS AND PLAYGROUNDS,400,QUEENS,P-1018,12025,100,0,0,0,0,0,0,100,100,0,0,0,0,0,0,100,200,0,0,0,0,0,0,200,,,"CONSTRUCTION OF THURSBY BASIN PARK, AT ROCKAWAY BEACH AND BOARDWALK, IN THE BOROUGH",cpd11-20qn.pdf
SANDY4-46,Joe Michael's Mile (Q012-120M),846,DEPT OF PARKS AND RECREATION,NEIGHBORHOOD PARKS AND PLAYGROUNDS,400,QUEENS,P-1018,1955,17,2,8,0,168,0,0,195,17,2,8,0,168,0,0,195,34,4,16,0,336,0,0,390,,"CROSS ISLAND PARKWAY, UTOPIA PARKWAY, QUEENS.","RECONSTRUCTION, REPLACEMENT, REHABILITATION AND/OR STABALIZATION OF DAMAGED",cpd11-20qn.pdf
SANDY4-48,Bayswater Park Reconstruction-FEMA,846,DEPT OF PARKS AND RECREATION,"LARGE, MAJOR AND REGIONAL PARK RECONSTRUCTION",400,QUEENS,P-1018,39588,100,0,0,0,0,0,0,100,100,0,0,0,0,0,0,100,200,0,0,0,0,0,0,200,,"DWIGHT AVE., SEAGIRT BLVD. BET. BEACH 38 ST. AND BAY 32 ST. QUEENS",THIS PROJECT WILL RECONSTRUCT BAYSWATER PARK,cpd11-20qn.pdf
SANDY4-49,Bayswater Park Recons of Maint. & Operations-FEMA,846,DEPT OF PARKS AND RECREATION,"LARGE, MAJOR AND REGIONAL PARK RECONSTRUCTION",400,QUEENS,P-1018,12093,65,0,0,0,0,0,0,65,65,0,0,0,0,0,0,65,130,0,0,0,0,0,0,130,,"DWIGHT AVE., SEAGIRT BLVD. BET. BEACH 38 ST. AND BAY 32 ST. QUEENS",THIS PROJECT WILL CONSTRUCT A COMFORT STATION AND MAINTENANCE AND OPERATIONS BUILDING,cpd11-20qn.pdf
SANDY4-51,Bayswater Park Comfort Station Construction-FEMA,846,DEPT OF PARKS AND RECREATION,"LARGE, MAJOR AND REGIONAL PARK RECONSTRUCTION",400,QUEENS,P-1018,7302,10,0,0,0,0,0,0,10,10,0,0,0,0,0,0,10,20,0,0,0,0,0,0,20,,"DWIGHT AVE., SEAGIRT BLVD. BET. BEACH 38 ST. AND BAY 32 ST. QUEENS",BAYSWATER PARK COMFORT STATION CONSTRUCTION,cpd11-20qn.pdf
SANDY6-08,Asser Levy HMP (Hazard Mitigation Plan ) Funding,846,DEPT OF PARKS AND RECREATION,NEIGHBORHOOD PARKS AND PLAYGROUNDS,400,QUEENS,P-1018,3732,8,0,0,0,67,0,0,75,8,0,0,0,67,0,0,75,16,0,0,0,134,0,0,150,PROJECT DELAYED DUE TO CHANGES IN SCOPE/DESIGN,,SANDY-SAFETY SURFACE & PAVEMENTS (NON-EMERGENCY),cpd11-20qn.pdf
SANDY6-19,Two Park Shoreline Protection,846,DEPT OF PARKS AND RECREATION,NEIGHBORHOOD PARKS AND PLAYGROUNDS,400,QUEENS,P-1018,532,0,0,0,0,53,0,0,53,0,0,0,0,53,0,0,53,0,0,0,0,106,0,0,106,PROJECT DELAYED DUE TO CHANGES IN SCOPE/DESIGN,,TWO PARK SHORELINE PROTECTION,cpd11-20qn.pdf
SEQ-TREES,South East Queens Sewer Build-out Trees Restitution,846,DEPT OF PARKS AND RECREATION,REPLACEMENT OR AUGMENTATION OF EXISTING SYSTEMS,400,QUEENS,SE-0002Q,3000,0,1200,1718,0,0,0,0,2918,0,1200,1718,0,0,0,0,2918,0,2400,3436,0,0,0,0,5836,,QUEENS BOROWIDE,SOUTH EAST QUEENSTREES RESTITUTION,cpd11-20qn.pdf
BB05-01-A,"GI - Cons of ROW Bioswales & Stormwwater GS in BB-005, Ph 1",850,DEPT OF DESIGN & CONSTRUCTION,GREEN INFRASTRUCTURE PROGRAM,400,QUEENS,WP-0169 EP-0007,9636,120,21692,3400,0,0,0,0,25212,120,21692,3400,0,0,0,0,25212,240,43384,6800,0,0,0,0,50424,PROJECT DELAYED DUE TO UNFORESEEN SITE/FIELD CONDITION,,"GI - CONSTRUCTION OF RIGHT- OF - WAY BIOSWALES AND STORMWATER GREENSTREETS IN BB-005,",cpd11-20qn.pdf
BB05-02-A,"GI - Cons of ROW Bioswales & Stormwwater GS in BB-005, Ph 2",850,DEPT OF DESIGN & CONSTRUCTION,GREEN INFRASTRUCTURE PROGRAM,400,QUEENS,HW-0200 WP-0169 EP-0007,5082,200,16591,5673,0,0,0,0,22464,200,16591,5673,0,0,0,0,22464,400,33182,11346,0,0,0,0,44928,,,"GI - CONSTRUCTION OF RIGHT- OF - WAY BIOSWALES AND STORMWATER GREENSTREETS IN BB-005,",cpd11-20qn.pdf
BBJ-Q,Borough Based Jails New Queens Detention Facility,850,DEPT OF DESIGN & CONSTRUCTION,New Jail Facilities,,QUEENS,C-0114,0,0,20976,63187,279642,491205,466998,630853,1952861,0,20976,63187,279642,491205,466998,630853,1952861,0,41952,126374,559284,982410,933996,1261706,3905722,,,CONSTRUCTION OF NEW QUEENS FACILITY,cpd11-20qn.pdf
BBJ-QGAR,Borough Based Jails Queens Garage,850,DEPT OF DESIGN & CONSTRUCTION,New Jail Facilities,,QUEENS,C-0114,0,0,24967,53720,13303,0,0,0,91990,0,24967,53720,13303,0,0,0,91990,0,49934,107440,26606,0,0,0,183980,,,CONSTRUCTION OF NE W QUEENS GARAGE,cpd11-20qn.pdf
CO277ELV2,25-10 COURT HOUSE SQ.- ELEVATORS,850,DEPT OF DESIGN & CONSTRUCTION,RECONSTRUCTION/RENOVATION OF COURT FACILITIES,401,QUEENS,CO-0264 CO-0277,1056,4341,73,450,412,0,0,0,5276,4341,73,450,412,0,0,0,5276,8682,146,900,824,0,0,0,10552,PROJECT DELAYED DUE TO CHANGES IN SCOPE/DESIGN,,25-10 COURT HOUSE SQ.- ELEVATORS,cpd11-20qn.pdf
CO277FA,25-10 COURT HOUSE SQ.- FIRE ALARM SYSTEM,850,DEPT OF DESIGN & CONSTRUCTION,RECONSTRUCTION/RENOVATION OF COURT FACILITIES,402,QUEENS,CO-0264 CO-0277,276,95,835,195,6532,0,0,0,7657,95,835,195,6532,0,0,0,7657,190,1670,390,13064,0,0,0,15314,PROJECT DELAYED DUE TO CHANGES IN SCOPE/DESIGN,,25-10 COURT HOUSE SQUARE - FIRE ALARM SYSTEM,cpd11-20qn.pdf
CO296ELEC,125-01 QUEENS BLVD - ELECTRICAL UPGRADES,850,DEPT OF DESIGN & CONSTRUCTION,RECONSTRUCTION/RENOVATION OF COURT FACILITIES,409,QUEENS,CO-0296,51044,7736,0,0,0,0,0,44119,51855,7736,0,0,0,0,0,44119,51855,15472,0,0,0,0,0,88238,103710,PROJECT DELAYED DUE TO BUDGETARY CONSTRAINTS,,125-01 QUEENS BLVD - ELECTRICAL UPGRADES,cpd11-20qn.pdf
CO296RF,125-01 QUEENS BLVD.- ROOF,850,DEPT OF DESIGN & CONSTRUCTION,RECONSTRUCTION/RENOVATION OF COURT FACILITIES,409,QUEENS,CO-0296,3359,664,0,0,0,6408,0,0,7072,664,0,0,0,6408,0,0,7072,1328,0,0,0,12816,0,0,14144,PROJECT DELAYED DUE TO CHANGES IN SCOPE/DESIGN,,125-01 QUEENS BLVD.- ROOF,cpd11-20qn.pdf
CO299EXT2,89-17 SUTPHIN BLVD.- PLAZA/SIDEWALK RECONSTRUCTION,850,DEPT OF DESIGN & CONSTRUCTION,RECONSTRUCTION/RENOVATION OF COURT FACILITIES,412,QUEENS,CO-0299,7006,884,0,0,5779,0,0,0,6663,884,0,0,5779,0,0,0,6663,1768,0,0,11558,0,0,0,13326,PROJECT DELAYED DUE TO CHANGES IN SCOPE/DESIGN,,PLAZA RENOVATION,cpd11-20qn.pdf
CO299FIRE,89-17 SUTPHIN BLVD - FIRE ALARM DESIGN & REPLACEMENT,850,DEPT OF DESIGN & CONSTRUCTION,RECONSTRUCTION/RENOVATION OF COURT FACILITIES,401,QUEENS,CO-0299,6944,681,0,0,0,0,0,6744,7425,681,0,0,0,0,0,6744,7425,1362,0,0,0,0,0,13488,14850,PROJECT DELAYED DUE TO CHANGES IN SCOPE/DESIGN,,89-17 SUTPHIN BLVD - FIRE ALARM DESIGN & REPLACEMENT,cpd11-20qn.pdf
CO300ELV2,88-11 SUTPHIN BLVD.- ELEVATOR,850,DEPT OF DESIGN & CONSTRUCTION,RECONSTRUCTION/RENOVATION OF COURT FACILITIES,412,QUEENS,CO-0300,7445,14178,0,0,0,0,64,0,14242,14178,0,0,0,0,64,0,14242,28356,0,0,0,0,128,0,28484,PROJECT DELAYED DUE TO UNFORESEEN SITE/FIELD CONDITION,,88-11 SUTPHIN BLVD.- ELEVATOR,cpd11-20qn.pdf
CS-FB-LLD,Flushing Bay Low Lying Sewer Diversion,850,DEPT OF DESIGN & CONSTRUCTION,WATER QUALITY MANDATES,400 403 407,QUEENS,SE-0002Q,6730,6895,1443,0,0,0,0,0,8338,6895,1443,0,0,0,0,0,8338,13790,2886,0,0,0,0,0,16676,PROJECT DELAYED DUE TO UNFORESEEN SITE/FIELD CONDITION,,CONSTRUCTION OF FLUSHING BAY LOW LEVEL SEWER DIVISION,cpd11-20qn.pdf
CV19COERO,Centers of Excellence,850,DEPT OF DESIGN & CONSTRUCTION,NEW FACILITIES,,QUEENS,HO-0214,26749,13661,3992,0,0,0,0,0,17653,13661,3992,0,0,0,0,0,17653,27322,7984,0,0,0,0,0,35306,,THE LOCATION FOR THE ROOSEVELT SITE WILL BE LOCATED AT 71-17 ROOSEVELT AVENUE IN,THE WORK TO BE DONE WILL INCLUDE GENERAL CONSTRUCTION; NEW LOW- FLOW PLUMBING,cpd11-20qn.pdf
DOTSEQ01,Southeast Queens - DOT Priority Grids Group 1 (SEQPGRD1),850,DEPT OF DESIGN & CONSTRUCTION,REPLACEMENT OR AUGMENTATION OF EXISTING SYSTEMS,400,QUEENS,SE-0200Q WM-0001 SE-0002Q,12229,363,0,0,0,0,11324,0,11687,363,0,0,0,0,11324,0,11687,726,0,0,0,0,22648,0,23374,PROJECT DELAYED DUE TO CHANGES IN SCOPE/DESIGN,,SOUTHEAST QUEENS PROGRAM JOINT PROJECT BETWEEN DOT AND DEP TO IMPROVEDRAINAGE,cpd11-20qn.pdf
DOTSEQ02,Southeast Queens - DOT Priority Grids Group 2 (SEQPGRD2),850,DEPT OF DESIGN & CONSTRUCTION,REPLACEMENT OR AUGMENTATION OF EXISTING SYSTEMS,400,QUEENS,WM-0001 SE-0200Q SE-0002Q,11085,382,0,0,0,1462,13641,0,15485,382,0,0,0,1462,13641,0,15485,764,0,0,0,2924,27282,0,30970,PROJECT DELAYED DUE TO UNFORESEEN SITE/FIELD CONDITION,,OUTHEAST QUEENS PROGRAM JOINT PROJECT BETWEEN DOT AND DEP TO IMPROVE DRAINAGE,cpd11-20qn.pdf
E16-0002,DCAS - Queens Civil Court,850,DEPT OF DESIGN & CONSTRUCTION,"BUILDING CONSTRUCTION, RECONSTRUCTION OR RETROFIT",412,QUEENS,PU-0025,3005,794,4716,464,0,0,0,0,5974,794,4716,464,0,0,0,0,5974,1588,9432,928,0,0,0,0,11948,PROJECT DELAYED DUE TO UNFORESEEN SITE/FIELD CONDITION,,QUEENS CIVIL COURT,cpd11-20qn.pdf
E16-0004,DSNY - Queens 7 District Garage Annex,850,DEPT OF DESIGN & CONSTRUCTION,"BUILDING CONSTRUCTION, RECONSTRUCTION OR RETROFIT",407,QUEENS,PU-0025,2162,1889,69,160,0,0,0,0,2118,1889,69,160,0,0,0,0,2118,3778,138,320,0,0,0,0,4236,PROJECT DELAYED DUE TO UNFORESEEN SITE/FIELD CONDITION,,QUEENS 7 DISTRICT GARAGE ANNEX,cpd11-20qn.pdf
EO26-0007,DOT - Brookville Yard (Rosedale Arterials/Fleet Services),850,DEPT OF DESIGN & CONSTRUCTION,"BUILDING CONSTRUCTION, RECONSTRUCTION OR RETROFIT",401,QUEENS,PU-0025,300,0,0,197,983,0,0,0,1180,0,0,197,983,0,0,0,1180,0,0,394,1966,0,0,0,2360,,,BROOKVILLE YARD (ROSEDALE ARTERIALS/FLEET SERVICES) - LIGHTING UPGRADE,cpd11-20qn.pdf
EO26-0009,NYPD - 620 Circle Drive - Lighting and HVAC Upgrades,850,DEPT OF DESIGN & CONSTRUCTION,"BUILDING CONSTRUCTION, RECONSTRUCTION OR RETROFIT",401,QUEENS,PU-0025,300,0,0,0,1377,0,0,0,1377,0,0,0,1377,0,0,0,1377,0,0,0,2754,0,0,0,2754,PROJECT DELAYED DUE TO CHANGES IN SCOPE/DESIGN,,DDC - 620 CIRCLE DRIVE - LIGHTING AND HVAC UPGRADES,cpd11-20qn.pdf
F175EC268,NEW FIREHOUSE - EC268,850,DEPT OF DESIGN & CONSTRUCTION,NEW FACILITIES AND RENOVATIONS,414,QUEENS,F-0175,22000,2305,1597,16609,0,0,0,0,20511,2305,1597,16609,0,0,0,0,20511,4610,3194,33218,0,0,0,0,41022,PROJECT DELAYED DUE TO CHANGES IN SCOPE/DESIGN,,NEW FIREHOUSE - EC268,cpd11-20qn.pdf
F204INFRA,Fort Totten Infrastructure Upgrade,850,DEPT OF DESIGN & CONSTRUCTION,NEW FACILITIES AND RENOVATIONS,400,QUEENS,F-0204,57686,0,2936,0,0,52750,0,0,55686,0,2936,0,0,52750,0,0,55686,0,5872,0,0,105500,0,0,111372,,,FORT TOTTEN INFRASTRUCTURE UPGRADE,cpd11-20qn.pdf
GCJA03-3A,"GI - Cons of ROW Bioswales & Stormwater GS in JAM-003, 3A",850,DEPT OF DESIGN & CONSTRUCTION,GREEN INFRASTRUCTURE PROGRAM,400 410 412 413 414,QUEENS,WP-0169,16536,14278,176,0,0,0,0,0,14454,14278,176,0,0,0,0,0,14454,28556,352,0,0,0,0,0,28908,PROJECT DELAYED DUE TO UNFORESEEN SITE/FIELD CONDITION,,GI - DESIGN & CONSTRUCTION OF RIGHTOF WAY BIOSWALES AND STORMAWATER GREENSTREETS AT,cpd11-20qn.pdf
GCJA03-3B,GI - CONS OF ROW GI IN JAMAICA BAY CSO AREAS JAM-03 & JAM-3A,850,DEPT OF DESIGN & CONSTRUCTION,GREEN INFRASTRUCTURE PROGRAM,400,QUEENS,WP-0169 EP-0007,20497,3473,15344,0,0,0,0,0,18817,3473,15344,0,0,0,0,0,18817,6946,30688,0,0,0,0,0,37634,PROJECT DELAYED DUE TO UNFORESEEN SITE/FIELD CONDITION,,CONSTRUCTION OF RIGHT-OF-WAY GREEN INFRASTRUCTURE IN THE JAMAICA BAY CSO AREAS JAM-003,cpd11-20qn.pdf
GCTI10-1A,"CONS OF ROW GI FLUSHING CRK CSO TRIB AREA TI-10, ST 1, PH A",850,DEPT OF DESIGN & CONSTRUCTION,GREEN INFRASTRUCTURE PROGRAM,400,QUEENS,WP-0169,14000,13581,60,0,0,0,0,0,13641,13581,60,0,0,0,0,0,13641,27162,120,0,0,0,0,0,27282,,,"CONSTRUCTION OF ROW GREEN INFRASTRUCTURE IN FLUSHING CREEK CSO TRIBUTARY AREA TI-10,",cpd11-20qn.pdf
GCTI10-1B,"CONS OF ROW GI FLUSHING CRK CSO TRIB AREA TI-10, ST 1, PH B",850,DEPT OF DESIGN & CONSTRUCTION,GREEN INFRASTRUCTURE PROGRAM,400,QUEENS,WP-0169 EP-0007,18547,3474,14730,4488,0,0,0,0,22692,3474,14730,4488,0,0,0,0,22692,6948,29460,8976,0,0,0,0,45384,PROJECT DELAYED DUE TO UNFORESEEN SITE/FIELD CONDITION,,"CONSTRUCTION OF ROW GREEN INFRASTRUCTURE IN FLUSHING CREEK CSO TRIBUTARY AREA TI-10,",cpd11-20qn.pdf
GCTI10-4B,CONS OF ROW GI IN PHASE 4 FLUSHING CRK CSO TRIB AREA TI-10,850,DEPT OF DESIGN & CONSTRUCTION,GREEN INFRASTRUCTURE PROGRAM,400,QUEENS,HW-0200,27600,24702,208,0,0,0,0,0,24910,24702,208,0,0,0,0,0,24910,49404,416,0,0,0,0,0,49820,PROJECT DELAYED DUE TO UNFORESEEN SITE/FIELD CONDITION,,CONSTRUCTION OF ROW GREEN INFRASTRUCTURE IN PHASE 4 OF FLUSHING CREEK CSO TRIBUTARY,cpd11-20qn.pdf
GCTI11-02,GI-Construct ROW Bioswales Stormwater Greenstreets in TI-011,850,DEPT OF DESIGN & CONSTRUCTION,GREEN INFRASTRUCTURE PROGRAM,400,QUEENS,EP-0007,4070,11911,0,67,0,0,0,0,11978,11911,0,67,0,0,0,0,11978,23822,0,134,0,0,0,0,23956,PROJECT DELAYED DUE TO UNFORESEEN SITE/FIELD CONDITION,,GI - CONSTRUCTION OF RIGHT-OF-WAY BIOSWALES AND STORMWATER GREENSTREETS IN TI-011,cpd11-20qn.pdf
GQBB09-01,GI - CONSTRUCTION OF GREEN INFRASTRUCTURE IN NEWTOWN CLUSTER,850,DEPT OF DESIGN & CONSTRUCTION,GREEN INFRASTRUCTURE PROGRAM,400,QUEENS,WP-0169,0,12659,51,0,0,0,0,0,12710,12659,51,0,0,0,0,0,12710,25318,102,0,0,0,0,0,25420,,,GI - CONSTRUCTION OF GREEN INFRASTRUCTURE IN NEWTOWN CLUSTER,cpd11-20qn.pdf
GQTI03-23,GI - GREEN INFRASTRUCTURE IN TI-003 & TI-023 EAST RIVER CSO,850,DEPT OF DESIGN & CONSTRUCTION,GREEN INFRASTRUCTURE PROGRAM,400,QUEENS,WP-0169,18714,8914,14770,0,0,0,0,0,23684,8914,14770,0,0,0,0,0,23684,17828,29540,0,0,0,0,0,47368,PROJECT DELAYED DUE TO UNFORESEEN SITE/FIELD CONDITION,,GI - GREEN INFRASTRUCTURE IN TI-003 & TI-023 EAST RIVER CSO,cpd11-20qn.pdf
HBPED216S,PED BRIDGE - 216 ST (Q),850,DEPT OF DESIGN & CONSTRUCTION,FAIR BRIDGES,400 411,QUEENS,HB-0215 SE-1000,6321,2788,585,43,170,0,0,0,3586,2788,585,43,170,0,0,0,3586,5576,1170,86,340,0,0,0,7172,PROJECT DELAYED DUE TO UNFORESEEN SITE/FIELD CONDITION,PED BRIDGE - 216 ST (Q),PED BRIDGE - 216 ST (Q),cpd11-20qn.pdf
HBPED800Q,"PED BRIDGE - PORPOISE BRIDGE AND TIDE GATE (SANDY4-30, 4-31)",850,DEPT OF DESIGN & CONSTRUCTION,FAIR BRIDGES,400,QUEENS,P-0245Q,65656,6452,93,314,50285,0,0,0,57144,6452,93,314,50285,0,0,0,57144,12904,186,628,100570,0,0,0,114288,PROJECT DELAYED DUE TO CHANGES IN SCOPE/DESIGN,PED BRIDGE - PORPOISE BRIDGE AND TIDE GATE,PED BRIDGE - PORPOISE BRIDGE AND TIDE GATE,cpd11-20qn.pdf
HD-153C2,EDGEMERE (PHASE C2),850,DEPT OF DESIGN & CONSTRUCTION,NEIGHBORHOOD-BASED HOUSING INITIATIVES,499,QUEENS,HW-0061 F-0001 HD-0153,9096,14380,0,0,115,0,0,0,14495,14380,0,0,115,0,0,0,14495,28760,0,0,230,0,0,0,28990,PROJECT DELAYED DUE TO UNFORESEEN SITE/FIELD CONDITION,EDGEMERE (PHASE C2),EDGEMERE (PHASE C2),cpd11-20qn.pdf
HL82CORHC,"Corona Health Center-Exterior Facade, Basement and Lobby",850,DEPT OF DESIGN & CONSTRUCTION,CLINIC RENOVATION AND REHABILITATION,,QUEENS,HL-0082,8200,1466,55,0,8761,0,0,0,10282,1466,55,0,8761,0,0,0,10282,2932,110,0,17522,0,0,0,20564,PROJECT DELAYED DUE TO BUDGETARY CONSTRAINTS,,"CORONA HEALTH CENTER EXTERIOR FACADE, BASEMENT AND LOBBY",cpd11-20qn.pdf
HRC002MPL,A/C UPGRADE OF MONTESSORI PROGRESSIVE LEARNING CTR,850,DEPT OF DESIGN & CONSTRUCTION,SOCIAL SERVICES BUILDINGS,400,QUEENS,HR-C002,1177,145,0,87,260,0,0,0,492,145,0,87,260,0,0,0,492,290,0,174,520,0,0,0,984,PROJECT DELAYED DUE TO BUDGETARY CONSTRAINTS,,REPLACEMENT OF EXISTING AIR CONDITIONING SYSTEM195-95 LINDEN BLVD QNO LONG TERM,cpd11-20qn.pdf
HWC988QB4,"QUEENS BOULEVARD MEDIAN EXTENSIONS INTO CROSSWALKS, QUEENS",850,DEPT OF DESIGN & CONSTRUCTION,PRIMARY STREET RECONSTRUCTION,400 402 404 406 409,QUEENS,HW-0200 TF-0502 TF-0002 WM-0001,4700,2624,140,0,0,0,0,0,2764,2624,140,0,0,0,0,0,2764,5248,280,0,0,0,0,0,5528,PROJECT DELAYED DUE TO CHANGES IN SCOPE/DESIGN,"QUEENS BOULEVARD MEDIAN EXTENSIONS INTO CROSSWALKS, QUEENS","QUEENS BOULEVARD MEDIAN EXTENSIONS INTO CROSSWALKS, QUEENS",cpd11-20qn.pdf
HWCSCH4C1,Safe Routes to Schools - Phase 4C1,850,DEPT OF DESIGN & CONSTRUCTION,PRIMARY STREET RECONSTRUCTION,400,QUEENS,HW-0988 WM-0001,4209,7331,507,0,0,0,0,0,7838,7331,507,0,0,0,0,0,7838,14662,1014,0,0,0,0,0,15676,PROJECT DELAYED DUE TO UNFORESEEN SITE/FIELD CONDITION,SAFE ROUTES TO SCHOOLS - PHASE 4C1,SAFE ROUTES TO SCHOOLS - PHASE 4C1,cpd11-20qn.pdf
HWCSCHPQN,SAFE ROUTES TO SCHOOLS- QUEENS,850,DEPT OF DESIGN & CONSTRUCTION,PRIMARY STREET RECONSTRUCTION,400,QUEENS,HW-D103 HW-0988 HW-D105,11289,1230,600,389,9800,0,0,0,12019,1230,600,389,9800,0,0,0,12019,2460,1200,778,19600,0,0,0,24038,,SAFE ROUTES TO SCHOOLS- QUEENS,SAFE ROUTES TO SCHOOLS- QUEENS,cpd11-20qn.pdf
HWD10311,111th Street Malls (QED-1049),850,DEPT OF DESIGN & CONSTRUCTION,PRIMARY STREET RECONSTRUCTION,400 403 404,QUEENS,HW-D103 HW-0001Q,2700,1383,0,17876,0,0,0,0,19259,1383,0,17876,0,0,0,0,19259,2766,0,35752,0,0,0,0,38518,PROJECT DELAYED DUE TO BUDGETARY CONSTRAINTS,111TH ST MALLS,111TH ST MALLS,cpd11-20qn.pdf
HWHARPER,Reconstruction of Harper Street Asphalt Plant - Construction,850,DEPT OF DESIGN & CONSTRUCTION,FACILITY RECONSTRUCTION,400,QUEENS,HW-0003,37801,18342,470,812,19825,0,0,0,39449,18342,470,812,19825,0,0,0,39449,36684,940,1624,39650,0,0,0,78898,,RECONSTRUCTION OF HARPER STREET ASPHALT PLANT,RECONSTRUCTION OF HARPER STREET ASPHALT PLANT,cpd11-20qn.pdf
HWP14QTA,CITYWIDE COMPLEX PED RAMPS (TRANSIT AUTHORITY) - QUEENS,850,DEPT OF DESIGN & CONSTRUCTION,PEDESTRIAN RAMP CONSTRUCTION,400,QUEENS,HW-0200,3102,6294,208,0,0,0,0,0,6502,6294,208,0,0,0,0,0,6502,12588,416,0,0,0,0,0,13004,PROJECT DELAYED DUE TO UNFORESEEN SITE/FIELD CONDITION,CITYWIDE COMPLEX PED RAMPS (TRANSIT AUTHORITY) - QUEENS,CITYWIDE COMPLEX PED RAMPS (TRANSIT AUTHORITY) - QUEENS,cpd11-20qn.pdf
HWP2006Q,CITYWIDE PED RAMPS - QUEENS(SIM),850,DEPT OF DESIGN & CONSTRUCTION,PEDESTRIAN RAMP CONSTRUCTION,402 405 410 411,QUEENS,HW-0200,12132,9509,446,0,0,0,0,0,9955,9509,446,0,0,0,0,0,9955,19018,892,0,0,0,0,0,19910,,CITYWIDE PED RAMPS - QUEENS,CITYWIDE PED RAMPS - QUEENS,cpd11-20qn.pdf
HWPLZ010Q,Corona Plaza,850,DEPT OF DESIGN & CONSTRUCTION,PRIMARY STREET RECONSTRUCTION,400 403 404,QUEENS,HW-1684 TF-0002,3500,8167,850,0,0,0,0,0,9017,8167,850,0,0,0,0,0,9017,16334,1700,0,0,0,0,0,18034,PROJECT DELAYED DUE TO BUDGETARY CONSTRAINTS,CORONA PLAZA,CORONA PLAZA,cpd11-20qn.pdf
HWPR19Q1,Pedestrian Ramp Rehabilitation - Queens,850,DEPT OF DESIGN & CONSTRUCTION,PEDESTRIAN RAMP CONSTRUCTION,400,QUEENS,HW-0200,15471,8520,5462,1233,0,0,0,0,15215,8520,5462,1233,0,0,0,0,15215,17040,10924,2466,0,0,0,0,30430,PROJECT DELAYED DUE TO BUDGETARY CONSTRAINTS,,PEDESTRIAN RAMP REHABILITATION - QUEENS,cpd11-20qn.pdf
HWPR19Q2,Pedestrian Ramp Rehabilitation - Queens,850,DEPT OF DESIGN & CONSTRUCTION,PEDESTRIAN RAMP CONSTRUCTION,400,QUEENS,HW-0200,15471,8860,5832,1720,0,0,0,0,16412,8860,5832,1720,0,0,0,0,16412,17720,11664,3440,0,0,0,0,32824,PROJECT DELAYED DUE TO BUDGETARY CONSTRAINTS,,PEDESTRIAN RAMP REHABILITATION - QUEENS,cpd11-20qn.pdf
HWPR20Q1,Pedestrian Ramp Rehabilitation - Queens,850,DEPT OF DESIGN & CONSTRUCTION,PEDESTRIAN RAMP CONSTRUCTION,400,QUEENS,HW-0200,17211,350,17211,0,0,0,0,0,17561,350,17211,0,0,0,0,0,17561,700,34422,0,0,0,0,0,35122,,PEDESTRIAN RAMP REHABILITATION - QUEENS,PEDESTRIAN RAMP REHABILITATION - QUEENS,cpd11-20qn.pdf
HWPR20Q2,Pedestrian Ramp Rehabilitation - Queens,850,DEPT OF DESIGN & CONSTRUCTION,PEDESTRIAN RAMP CONSTRUCTION,400,QUEENS,HW-0200,17211,300,17211,0,0,0,0,0,17511,300,17211,0,0,0,0,0,17511,600,34422,0,0,0,0,0,35022,,PEDESTRIAN RAMP REHABILITATION - QUEENS,PEDESTRIAN RAMP REHABILITATION - QUEENS,cpd11-20qn.pdf
HWPR20Q3,Pedestrian Ramp Rehabilitation - Queens,850,DEPT OF DESIGN & CONSTRUCTION,PEDESTRIAN RAMP CONSTRUCTION,400,QUEENS,HW-0200,17211,200,17211,0,0,0,0,0,17411,200,17211,0,0,0,0,0,17411,400,34422,0,0,0,0,0,34822,,PEDESTRIAN RAMP REHABILITATION - QUEENS,PEDESTRIAN RAMP REHABILITATION - QUEENS,cpd11-20qn.pdf
HWPR20QC,Non-Standard Upgrades Ped Ramp - Queens,850,DEPT OF DESIGN & CONSTRUCTION,PEDESTRIAN RAMP CONSTRUCTION,400,QUEENS,HW-0200,6088,529,287,0,5659,0,0,0,6475,529,287,0,5659,0,0,0,6475,1058,574,0,11318,0,0,0,12950,PROJECT DELAYED DUE TO BUDGETARY CONSTRAINTS,COMPLEX UPGRADES PED RAMP - QUEENS,COMPLEX UPGRADES PED RAMP - QUEENS,cpd11-20qn.pdf
HWPR21Q1,Rehabilitation of Standard Ped Ramps - Queens,850,DEPT OF DESIGN & CONSTRUCTION,PEDESTRIAN RAMP CONSTRUCTION,400,QUEENS,HW-0200,16533,200,0,7946,7947,0,0,0,16093,200,0,7946,7947,0,0,0,16093,400,0,15892,15894,0,0,0,32186,,,REHABILITATION OF STANDARD PED RAMPS - QUEENS,cpd11-20qn.pdf
HWQ100SBB,Woodhaven Blvd SBS Phase B,850,DEPT OF DESIGN & CONSTRUCTION,TRAFFIC WORK IN CONJUNCTION WITH HIGHWAY RECONSTRUCTION,400,QUEENS,HW-1684,48691,200,4880,0,0,43811,0,0,48891,200,4880,0,0,43811,0,0,48891,400,9760,0,0,87622,0,0,97782,PROJECT DELAYED DUE TO BUDGETARY CONSTRAINTS,WOODHAVEN BLVD SBS PHASE B,WOODHAVEN BLVD SBS PHASE B,cpd11-20qn.pdf
HWQ1161,REHAB OF 99TH AND 100TH AVENUES,850,DEPT OF DESIGN & CONSTRUCTION,PRIMARY STREET RECONSTRUCTION,412,QUEENS,TF-0002,16965,17337,0,285,0,0,0,0,17622,17337,0,285,0,0,0,0,17622,34674,0,570,0,0,0,0,35244,PROJECT DELAYED DUE TO UNFORESEEN SITE/FIELD CONDITION,,,cpd11-20qn.pdf
HWQ1182A,Broad Channel Bulkheads - Phase I (SEQ200582),850,DEPT OF DESIGN & CONSTRUCTION,PRIMARY STREET RECONSTRUCTION,400 414,QUEENS,HW-0001Q,3807,21378,0,0,0,0,3575,0,24953,21378,0,0,0,0,3575,0,24953,42756,0,0,0,0,7150,0,49906,PROJECT DELAYED DUE TO UNFORESEEN SITE/FIELD CONDITION,BROAD CHANNEL BULKHEADS ON WEST 11 TO WEST 13 ROAD,BROAD CHANNEL BULKHEADS ON WEST 11 TO WEST 13 ROAD,cpd11-20qn.pdf
HWQ1182B,Broad Channel Bulkheads - Phase II (SEQ200586),850,DEPT OF DESIGN & CONSTRUCTION,PRIMARY STREET RECONSTRUCTION,400,QUEENS,TF-0002 SE-0200Q WM-0001 HW-0001Q,19167,20506,6359,833,0,0,0,0,27698,20506,6359,833,0,0,0,0,27698,41012,12718,1666,0,0,0,0,55396,PROJECT DELAYED DUE TO CHANGES IN SCOPE/DESIGN,BROAD CHANNEL BULKHEADS PHASE II,BROAD CHANNEL BULKHEADS PHASE II,cpd11-20qn.pdf
HWQ1184A,"James Court Roadway & Bulkhead, Queens (Joint Bid)",850,DEPT OF DESIGN & CONSTRUCTION,PRIMARY STREET RECONSTRUCTION,400 412,QUEENS,HW-D103 HW-0001Q,1948,3761,0,1583,0,0,0,567,5911,3761,0,1583,0,0,0,567,5911,7522,0,3166,0,0,0,1134,11822,PROJECT DELAYED DUE TO CHANGES IN SCOPE/DESIGN,JAMES COURT ROADWAY AND BULKHEAD,JAMES COURT ROADWAY AND BULKHEAD,cpd11-20qn.pdf
HWQ1187,"Westbourne-Dunbar Roadways & Bulkheads (SAND1187, SEQ200595)",850,DEPT OF DESIGN & CONSTRUCTION,PRIMARY STREET RECONSTRUCTION,400 414,QUEENS,HW-0001Q,5000,1834,0,0,0,0,0,17525,19359,1834,0,0,0,0,0,17525,19359,3668,0,0,0,0,0,35050,38718,PROJECT DELAYED DUE TO BUDGETARY CONSTRAINTS,WESTBOURNE - DUNBAR ROADWAYS & BULKHEADS,WESTBOURNE - DUNBAR ROADWAYS & BULKHEADS,cpd11-20qn.pdf
HWQ1190A,Reconstruction of Queens Blvd Phase 1 (QED-1042A),850,DEPT OF DESIGN & CONSTRUCTION,PRIMARY STREET RECONSTRUCTION,400,QUEENS,HW-0001Q,49520,10080,250,0,64871,0,0,0,75201,10080,250,0,64871,0,0,0,75201,20160,500,0,129742,0,0,0,150402,PROJECT DELAYED DUE TO UNFORESEEN SITE/FIELD CONDITION,RECONSTRUCTION OF QUEENS BLVD PHASE 1,RECONSTRUCTION OF QUEENS BLVD PHASE 1,cpd11-20qn.pdf
HWQ1190B,Reconstruction of Queens Blvd Phase 2,850,DEPT OF DESIGN & CONSTRUCTION,PRIMARY STREET RECONSTRUCTION,400,QUEENS,HW-0001Q,81984,2532,0,0,7198,51761,0,0,61491,2532,0,0,7198,51761,0,0,61491,5064,0,0,14396,103522,0,0,122982,PROJECT DELAYED DUE TO CHANGES IN SCOPE/DESIGN,RECONSTRUCTION OF QUEENS BLVD PHASE 2,RECONSTRUCTION OF QUEENS BLVD PHASE 2,cpd11-20qn.pdf
HWQ1190-C,Reconstruction of Queens Blvd Phase 3,850,DEPT OF DESIGN & CONSTRUCTION,PRIMARY STREET RECONSTRUCTION,400,QUEENS,HW-0001Q HW-D103,98817,2022,0,0,0,0,96722,0,98744,2022,0,0,0,0,96722,0,98744,4044,0,0,0,0,193444,0,197488,PROJECT DELAYED DUE TO CHANGES IN SCOPE/DESIGN,,"RECONSTRUCTION OF QUEENS BLVD, PHASE 3",cpd11-20qn.pdf
HWQ1193,Union Turnpike Curb Repair,850,DEPT OF DESIGN & CONSTRUCTION,PRIMARY STREET RECONSTRUCTION,400,QUEENS,HW-0001Q,24709,320,0,0,5673,0,0,0,5993,320,0,0,5673,0,0,0,5993,640,0,0,11346,0,0,0,11986,PROJECT DELAYED DUE TO UNFORESEEN SITE/FIELD CONDITION,UNION TURNPIKE CURB REPAIR,UNION TURNPIKE CURB REPAIR,cpd11-20qn.pdf
HWQ1195,Colfax and Murdock Street Raising (SEQNS003),850,DEPT OF DESIGN & CONSTRUCTION,PRIMARY STREET RECONSTRUCTION,400,QUEENS,HW-0001Q,29735,771,0,0,0,0,0,9317,10088,771,0,0,0,0,0,9317,10088,1542,0,0,0,0,0,18634,20176,PROJECT DELAYED DUE TO UNFORESEEN SITE/FIELD CONDITION,,COLFAX AND MURDOCK STREET RAISING,cpd11-20qn.pdf
HWQ121B3,RECONSTRUCTION OF SOUTH JAMAICA AREA (SEQ200562),850,DEPT OF DESIGN & CONSTRUCTION,PRIMARY STREET RECONSTRUCTION,412,QUEENS,HW-0121 HW-0200 TF-0002 TF-0502 HW-0944 HW-0061,10404,3069,0,31470,0,0,0,0,34539,3069,0,31470,0,0,0,0,34539,6138,0,62940,0,0,0,0,69078,PROJECT DELAYED DUE TO CHANGES IN SCOPE/DESIGN,SOUTH JAMAICA QUEENS,RECON OF SOUTH JAMAICA AREA,cpd11-20qn.pdf
HWQ200578,SEQ - Foch Boulevard Safety Improvements (SEQ200578),850,DEPT OF DESIGN & CONSTRUCTION,PRIMARY STREET RECONSTRUCTION,400,QUEENS,HW-0001Q,6653,4974,0,0,0,0,0,2663,7637,4974,0,0,0,0,0,2663,7637,9948,0,0,0,0,0,5326,15274,PROJECT DELAYED DUE TO UNFORESEEN SITE/FIELD CONDITION,SE-Q FOCH BOULEVARD SAFETY IMPROVEMENTS,SE-Q FOCH BOULEVARD SAFETY IMPROVEMENTS,cpd11-20qn.pdf
HWQ213C,Main Street Sidewalk Widening,850,DEPT OF DESIGN & CONSTRUCTION,PRIMARY STREET RECONSTRUCTION,400 407,QUEENS,HW-0001Q SE-0002Q,4064,9843,192,12,0,1192,0,0,11239,9843,192,12,0,1192,0,0,11239,19686,384,24,0,2384,0,0,22478,PROJECT DELAYED DUE TO UNFORESEEN SITE/FIELD CONDITION,MAIN STREET SIDEWALK WIDENING,MAIN STREET SIDEWALK WIDENING,cpd11-20qn.pdf
HWQ274F1,RECONSTRUCTION OF STREETS IN ROSEDALE AREA (SEQ200446),850,DEPT OF DESIGN & CONSTRUCTION,PRIMARY STREET RECONSTRUCTION,413,QUEENS,HW-0061 HW-0001Q,14344,12531,537,2910,0,0,0,0,15978,12531,537,2910,0,0,0,0,15978,25062,1074,5820,0,0,0,0,31956,PROJECT DELAYED DUE TO CHANGES IN SCOPE/DESIGN,RECONSTRUCTION OF STREETS IN THE ROSEDALE AREA - PHASE II,RECONSTRUCTION OF STREETS IN THE ROSEDALE AREA - PHASE II,cpd11-20qn.pdf
HWQ274F2,RECON OF STREETS IN ROSEDALE AREA - PHASE 2,850,DEPT OF DESIGN & CONSTRUCTION,PRIMARY STREET RECONSTRUCTION,400,QUEENS,HW-0061 HW-0274,22140,1296,2602,0,33553,0,0,0,37451,1296,2602,0,33553,0,0,0,37451,2592,5204,0,67106,0,0,0,74902,,RECON OF STREETS IN ROSEDALE AREA - PHASE 2,RECON OF STREETS IN ROSEDALE AREA - PHASE 2,cpd11-20qn.pdf
HWQ411B,"Reconstruction of Albert Road Area, 94th St, Qns (SEQ002568)",850,DEPT OF DESIGN & CONSTRUCTION,PRIMARY STREET RECONSTRUCTION,410,QUEENS,HW-0411 HW-0200 HW-0061,20836,34054,3556,0,28,0,0,0,37638,34054,3556,0,28,0,0,0,37638,68108,7112,0,56,0,0,0,75276,PROJECT DELAYED DUE TO CHANGES IN SCOPE/DESIGN,,"94TH STREET ETC, QUEENSTHE EXISTING ROADWAY SHALL BE RECONSTRUCTEDROADWAY",cpd11-20qn.pdf
HWQ631B-3,ALMEDA AV - PHASE III,850,DEPT OF DESIGN & CONSTRUCTION,PRIMARY STREET RECONSTRUCTION,414,QUEENS,SE-087HW,12332,25,0,0,0,0,1284,0,1309,25,0,0,0,0,1284,0,1309,50,0,0,0,0,2568,0,2618,PROJECT DELAYED DUE TO CHANGES IN SCOPE/DESIGN,ALMEDA AV - PHASE III,ALMEDA AV - PHASE III,cpd11-20qn.pdf
HWQ662G,Springfield Gardens Phase V (SE-862),850,DEPT OF DESIGN & CONSTRUCTION,PRIMARY STREET RECONSTRUCTION,413,QUEENS,HW-0001Q HW-0061 HW-0662 HW-0200 TF-0002 TF-0502,24283,1681,0,0,0,5045,0,18711,25437,1681,0,0,0,5045,0,18711,25437,3362,0,0,0,10090,0,37422,50874,PROJECT DELAYED DUE TO CHANGES IN SCOPE/DESIGN,ROCKAWAY BLVD,ROCKAWAY BLVD,cpd11-20qn.pdf
HWQ677,"91ST AVE, ETC, QUEENS",850,DEPT OF DESIGN & CONSTRUCTION,PRIMARY STREET RECONSTRUCTION,409,QUEENS,HW-0677 WM-0001,9053,6939,226,0,0,0,0,0,7165,6939,226,0,0,0,0,0,7165,13878,452,0,0,0,0,0,14330,PROJECT DELAYED DUE TO UNFORESEEN SITE/FIELD CONDITION,,91TH AVENUETHE EXISTING ROADWAY SHALL BE RECONSTRUCTEDROADWAY RECONSTRUCTION,cpd11-20qn.pdf
HWQ708,RECONSTRUCTION OF 73RD PLACE,850,DEPT OF DESIGN & CONSTRUCTION,PRIMARY STREET RECONSTRUCTION,405,QUEENS,WM-0001,20809,2501,0,0,0,3262,0,0,5763,2501,0,0,0,3262,0,0,5763,5002,0,0,0,6524,0,0,11526,PROJECT DELAYED DUE TO CHANGES IN SCOPE/DESIGN,,73RD PL,cpd11-20qn.pdf
HWQ724B,Recon of Streets in Brookville-Edgewood Triangle (SEQ200519),850,DEPT OF DESIGN & CONSTRUCTION,PRIMARY STREET RECONSTRUCTION,413,QUEENS,HW-0724 HW-0061 HW-0001Q HW-0200 TF-0002 TF-0502,11889,5802,1390,0,0,15727,0,0,22919,5802,1390,0,0,15727,0,0,22919,11604,2780,0,0,31454,0,0,45838,PROJECT DELAYED DUE TO CHANGES IN SCOPE/DESIGN,BROOKVILLE-EDGEWOOD TRIANGE ROSEDALE QUEENS,BROOKVILLE-EDGEWOOD TRIANGE,cpd11-20qn.pdf
HWQ787B3,"Sutter Ave, Etc - Phase V (B3)",850,DEPT OF DESIGN & CONSTRUCTION,PRIMARY STREET RECONSTRUCTION,402,QUEENS,HW-0787 HW-0200 TF-0002 TF-0502 HW-0061 HW-0001Q,513,477,0,0,0,0,0,1816,2293,477,0,0,0,0,0,1816,2293,954,0,0,0,0,0,3632,4586,PROJECT DELAYED DUE TO CHANGES IN SCOPE/DESIGN,"SUTTER AVE, ETC - PHASE V (B3)","SUTTER AVE, ETC - PHASE V (B3)",cpd11-20qn.pdf
HWQ976,SEQ - FRANCIS LEWIS BLVD & 93RD AVE (QED-976),850,DEPT OF DESIGN & CONSTRUCTION,PRIMARY STREET RECONSTRUCTION,400,QUEENS,HW-0001Q,725,0,0,0,0,0,0,725,725,0,0,0,0,0,0,725,725,0,0,0,0,0,0,1450,1450,PROJECT DELAYED DUE TO UNFORESEEN SITE/FIELD CONDITION,,SEQ FRANCIS LEWIS BLVD - BUS PADS AND STEEL-FACED CURBS,cpd11-20qn.pdf
HWQ985,SHORE ROAD RECONSTRUCTION (SEQ200585),850,DEPT OF DESIGN & CONSTRUCTION,PRIMARY STREET RECONSTRUCTION,400 407,QUEENS,HW-0001Q,7725,7516,5587,308,0,0,0,0,13411,7516,5587,308,0,0,0,0,13411,15032,11174,616,0,0,0,0,26822,PROJECT DELAYED DUE TO UNFORESEEN SITE/FIELD CONDITION,,"SHORE ROAD FROM EAST DRIVE TO 36TH AVE, DOUGLASTON",cpd11-20qn.pdf
HWQF030,HARPER ST WASTE WATER AND STORM WATER CONVEYANCES,850,DEPT OF DESIGN & CONSTRUCTION,FACILITY RECONSTRUCTION,400 407,QUEENS,HW-0003,2000,1300,0,0,6697,0,0,0,7997,1300,0,0,6697,0,0,0,7997,2600,0,0,13394,0,0,0,15994,PROJECT DELAYED DUE TO CHANGES IN SCOPE/DESIGN,,WASTE WATER MITIGATION,cpd11-20qn.pdf
HWQF033,28-11 QPN 7TH FL REHABILITATION,850,DEPT OF DESIGN & CONSTRUCTION,FACILITY RECONSTRUCTION,400 402,QUEENS,HW-0003,3347,0,1166,0,12682,0,0,0,13848,0,1166,0,12682,0,0,0,13848,0,2332,0,25364,0,0,0,27696,PROJECT DELAYED DUE TO BUDGETARY CONSTRAINTS,QUEENS,COLLEGE POINT WINDOWS,cpd11-20qn.pdf
HWS2006Q2,PRIOR NOTICE SIDEWALKS - QUEENS (2),850,DEPT OF DESIGN & CONSTRUCTION,SIDEWALK RECONSTRUCTION,400,QUEENS,WM-0001 HW-0200,3523,3040,74,0,0,0,0,165,3279,3040,74,0,0,0,0,165,3279,6080,148,0,0,0,0,330,6558,PROJECT DELAYED DUE TO UNFORESEEN SITE/FIELD CONDITION,PRIOR NOTICE SIDEWALKS - QUEENS (2),PRIOR NOTICE SIDEWALKS - QUEENS (2),cpd11-20qn.pdf
HWS2018Q2,Prior Notice Sidwalks - Queens,850,DEPT OF DESIGN & CONSTRUCTION,SIDEWALK RECONSTRUCTION,400,QUEENS,HW-0200,5378,5088,220,0,0,0,0,0,5308,5088,220,0,0,0,0,0,5308,10176,440,0,0,0,0,0,10616,PROJECT DELAYED DUE TO UNFORESEEN SITE/FIELD CONDITION,PRIOR NOTICE SIDWALKS - QUEENS,PRIOR NOTICE SIDWALKS - QUEENS,cpd11-20qn.pdf
HWS2020Q1,Prior Notice Sidewalks- Queens,850,DEPT OF DESIGN & CONSTRUCTION,SIDEWALK RECONSTRUCTION,400,QUEENS,HW-0200 P-1018,8000,80,6725,435,0,0,0,0,7240,80,6725,435,0,0,0,0,7240,160,13450,870,0,0,0,0,14480,PROJECT DELAYED DUE TO BUDGETARY CONSTRAINTS,PRIOR NOTICE SIDEWALKS- QUEENS,PRIOR NOTICE SIDEWALKS- QUEENS,cpd11-20qn.pdf
HWS2020Q2,Prior Notice Sidewalks- Queens,850,DEPT OF DESIGN & CONSTRUCTION,SIDEWALK RECONSTRUCTION,400,QUEENS,HW-0200 P-1018,7999,60,6685,432,0,0,0,0,7177,60,6685,432,0,0,0,0,7177,120,13370,864,0,0,0,0,14354,PROJECT DELAYED DUE TO BUDGETARY CONSTRAINTS,PRIOR NOTICE SIDEWALKS- QUEENS,PRIOR NOTICE SIDEWALKS- QUEENS,cpd11-20qn.pdf
LQARVEXPN,Arverne Library - Replacement facility,850,DEPT OF DESIGN & CONSTRUCTION,REPLACEMENT BRANCHES,400,QUEENS,LQ-D122 LQ-0122 LQ-Q122,7600,1630,1102,5675,2674,0,0,0,11081,1630,1102,5675,2674,0,0,0,11081,3260,2204,11350,5348,0,0,0,22162,PROJECT DELAYED DUE TO BUDGETARY CONSTRAINTS,,ARVERNE LIBRARY EXPANSION,cpd11-20qn.pdf
LQASADA,ASTORIA - Brach renovation with ADA,850,DEPT OF DESIGN & CONSTRUCTION,RECONSTRUCTION NECESSARY TO MAINTAIN FACILITIES,400,QUEENS,LQ-D122 LQ-0122,1479,1342,65,7518,0,0,0,0,8925,1342,65,7518,0,0,0,0,8925,2684,130,15036,0,0,0,0,17850,PROJECT DELAYED DUE TO BUDGETARY CONSTRAINTS,,ASTORIA ADA RENOVATION FY16 CM CONSTANTINIDES,cpd11-20qn.pdf
LQBPEXPN,BAISLEY PARK - Branch Renovation,850,DEPT OF DESIGN & CONSTRUCTION,REPLACEMENT BRANCHES,412,QUEENS,LQ-D122 LQ-Q122 LQ-0122 LQ-Q005,6500,125,1068,0,0,8872,0,0,10065,125,1068,0,0,8872,0,0,10065,250,2136,0,0,17744,0,0,20130,PROJECT DELAYED DUE TO BUDGETARY CONSTRAINTS,,BAISLEY PARK - EXPANSION,cpd11-20qn.pdf
LQBTRENOV,BAY TERRACE,850,DEPT OF DESIGN & CONSTRUCTION,ESSENTIAL RECONSTRUCTION OF FACILITIES,400,QUEENS,LQ-D122 LQ-0122 LQ-Q122,3822,0,5628,0,0,0,0,0,5628,0,5628,0,0,0,0,0,5628,0,11256,0,0,0,0,0,11256,PROJECT DELAYED DUE TO CHANGES IN SCOPE/DESIGN,,BAY TERRACE RENOVATION,cpd11-20qn.pdf
LQBW-EXP,Briarwood,850,DEPT OF DESIGN & CONSTRUCTION,ESSENTIAL RECONSTRUCTION OF FACILITIES,400,QUEENS,LQ-D122 LQ-0122,12901,25,0,0,0,1132,0,11582,12739,25,0,0,0,1132,0,11582,12739,50,0,0,0,2264,0,23164,25478,,,ROOF AND EXTERIOR UPGRADE,cpd11-20qn.pdf
LQD122-AU,Auburndale - Roof Replacement,850,DEPT OF DESIGN & CONSTRUCTION,ESSENTIAL RECONSTRUCTION OF FACILITIES,407,QUEENS,LQ-D122,705,653,0,0,0,73,0,0,726,653,0,0,0,73,0,0,726,1306,0,0,0,146,0,0,1452,PROJECT DELAYED DUE TO CHANGES IN SCOPE/DESIGN,,ROOF REPLACEMENT & RELATED WORK,cpd11-20qn.pdf
LQD122BCE,BROAD CHANNEL EXTERIOR RENOVATION,850,DEPT OF DESIGN & CONSTRUCTION,RECONSTRUCTION NECESSARY TO MAINTAIN FACILITIES,400 414,QUEENS,LQ-D001 LQ-0122,250,0,0,0,0,225,0,175,400,0,0,0,0,225,0,175,400,0,0,0,0,450,0,350,800,PROJECT DELAYED DUE TO CHANGES IN SCOPE/DESIGN,,,cpd11-20qn.pdf
LQD122BR2,BROADWAY LIBRARY - RENOVATION (PHASE THREE AND FOUR),850,DEPT OF DESIGN & CONSTRUCTION,RECONSTRUCTION NECESSARY TO MAINTAIN FACILITIES,401,QUEENS,LQ-D122 LQ-Q122 LQ-0122,1575,896,2200,147,0,0,0,0,3243,896,2200,147,0,0,0,0,3243,1792,4400,294,0,0,0,0,6486,PROJECT DELAYED DUE TO CHANGES IN SCOPE/DESIGN,,,cpd11-20qn.pdf
LQD122-CM,CAMBRIA HEIGHTS - Lower Level Renovation,850,DEPT OF DESIGN & CONSTRUCTION,RECONSTRUCTION NECESSARY TO MAINTAIN FACILITIES,413,QUEENS,LQ-D122,2800,1421,0,0,71,0,0,0,1492,1421,0,0,71,0,0,0,1492,2842,0,0,142,0,0,0,2984,PROJECT DELAYED PENDING RESOLUTION OF LEGAL ISSUES,,RENOVATION,cpd11-20qn.pdf
LQD122GL2,GLENDALE LIBRARY RENOVATION,850,DEPT OF DESIGN & CONSTRUCTION,ESSENTIAL RECONSTRUCTION OF FACILITIES,405,QUEENS,LQ-0122 LQ-D122,2803,8003,1186,0,0,0,0,0,9189,8003,1186,0,0,0,0,0,9189,16006,2372,0,0,0,0,0,18378,PROJECT DELAYED DUE TO CHANGES IN SCOPE/DESIGN,,RENOVATION,cpd11-20qn.pdf
LQD122HO1,Hollis Library - Building Infrastructure,850,DEPT OF DESIGN & CONSTRUCTION,RECONSTRUCTION NECESSARY TO MAINTAIN FACILITIES,408,QUEENS,LQ-Q122 LQ-0122 LQ-D122,3125,950,0,5848,0,3010,0,0,9808,950,0,5848,0,3010,0,0,9808,1900,0,11696,0,6020,0,0,19616,PROJECT DELAYED DUE TO CHANGES IN SCOPE/DESIGN,,BUILDING INFRASTRUCTURE,cpd11-20qn.pdf
LQD122NF4,NORTH FOREST PARK - Renovation,850,DEPT OF DESIGN & CONSTRUCTION,RECONSTRUCTION NECESSARY TO MAINTAIN FACILITIES,406,QUEENS,LQ-D122 LQ-0122,1750,447,0,0,2409,455,0,0,3311,447,0,0,2409,455,0,0,3311,894,0,0,4818,910,0,0,6622,PROJECT DELAYED DUE TO CHANGES IN SCOPE/DESIGN,,NORTH FOREST PARK RENOVATION,cpd11-20qn.pdf
LQD122-QW,QUEENS WEST BRANCH,850,DEPT OF DESIGN & CONSTRUCTION,REPLACEMENT BRANCHES,401,QUEENS,LQ-0122,2000,28904,1970,0,0,0,0,0,30874,28904,1970,0,0,0,0,0,30874,57808,3940,0,0,0,0,0,61748,PROJECT DELAYED DUE TO BUDGETARY CONSTRAINTS,LONG ISLAND CITY,NEW BRANCH FACILITY,cpd11-20qn.pdf
LQD122RO2,ROCHDALE VILLAGE - HVAC & Controls,850,DEPT OF DESIGN & CONSTRUCTION,ESSENTIAL RECONSTRUCTION OF FACILITIES,412,QUEENS,LQ-D122 LQ-0122 LQ-Q122,460,567,1430,0,0,0,0,0,1997,567,1430,0,0,0,0,0,1997,1134,2860,0,0,0,0,0,3994,PROJECT DELAYED DUE TO CHANGES IN SCOPE/DESIGN,,BOILER & CONTROLS,cpd11-20qn.pdf
LQD122-S2,STEINWAY - Phase II Renovation,850,DEPT OF DESIGN & CONSTRUCTION,ESSENTIAL RECONSTRUCTION OF FACILITIES,401,QUEENS,LQ-D122 LQ-0122,2405,6050,2016,0,0,0,0,0,8066,6050,2016,0,0,0,0,0,8066,12100,4032,0,0,0,0,0,16132,PROJECT DELAYED DUE TO CHANGES IN SCOPE/DESIGN,,STEINWAY RENOVATION,cpd11-20qn.pdf
LQD122-WN,WOODHAVEN - Renovation,850,DEPT OF DESIGN & CONSTRUCTION,RECONSTRUCTION NECESSARY TO MAINTAIN FACILITIES,409,QUEENS,LQ-D122 LQ-Q122 LQ-0122,200,1571,0,8830,0,0,0,0,10401,1571,0,8830,0,0,0,0,10401,3142,0,17660,0,0,0,0,20802,PROJECT DELAYED DUE TO BUDGETARY CONSTRAINTS,,REPLACEMENT OF WINDOWS & DOORS,cpd11-20qn.pdf
LQD122-WP,WINDSOR PARK - Renovation,850,DEPT OF DESIGN & CONSTRUCTION,REPLACEMENT BRANCHES,411,QUEENS,LQ-D122,1650,1556,0,0,0,0,0,102,1658,1556,0,0,0,0,0,102,1658,3112,0,0,0,0,0,204,3316,PROJECT DELAYED DUE TO BUDGETARY CONSTRAINTS,,RENOVATION,cpd11-20qn.pdf
LQD122WS3,WOODSIDE - INTERIOR LIGHTING UPGRADE,850,DEPT OF DESIGN & CONSTRUCTION,REPLACEMENT BRANCHES,400,QUEENS,LQ-D122,165,92,87,0,0,0,0,0,179,92,87,0,0,0,0,0,179,184,174,0,0,0,0,0,358,PROJECT DELAYED DUE TO CHANGES IN SCOPE/DESIGN,,WOODSIDE INTERIOR LIGHTS,cpd11-20qn.pdf
LQDL-NEW,DOUGLASTON,850,DEPT OF DESIGN & CONSTRUCTION,REPLACEMENT BRANCHES,400,QUEENS,LQ-0122 LQ-Q122 LQ-D122,23968,2513,0,0,756,0,19411,1000,23680,2513,0,0,756,0,19411,1000,23680,5026,0,0,1512,0,38822,2000,47360,,,REPLACEMENT FACILITY,cpd11-20qn.pdf
LQEM19BKP,BAISLEY PARK,850,DEPT OF DESIGN & CONSTRUCTION,ESSENTIAL RECONSTRUCTION OF FACILITIES,400,QUEENS,LQ-0122,1365,1299,140,0,0,0,0,0,1439,1299,140,0,0,0,0,0,1439,2598,280,0,0,0,0,0,2878,PROJECT DELAYED DUE TO CHANGES IN SCOPE/DESIGN,,BAISLEY PARK,cpd11-20qn.pdf
LQEM19BPK,BAISLEY PARK,850,DEPT OF DESIGN & CONSTRUCTION,ESSENTIAL RECONSTRUCTION OF FACILITIES,400,QUEENS,LQ-0122 LQ-D122,275,197,1286,0,0,2000,0,0,3483,197,1286,0,0,2000,0,0,3483,394,2572,0,0,4000,0,0,6966,,,BAISLEY PARK,cpd11-20qn.pdf
LQEM19FFA,FLUSHING,850,DEPT OF DESIGN & CONSTRUCTION,ESSENTIAL RECONSTRUCTION OF FACILITIES,400,QUEENS,LQ-0122,551,0,349,0,0,0,3262,0,3611,0,349,0,0,0,3262,0,3611,0,698,0,0,0,6524,0,7222,PROJECT DELAYED DUE TO BUDGETARY CONSTRAINTS,,FLUSHING,cpd11-20qn.pdf
LQEM19FLU,FLUSHING,850,DEPT OF DESIGN & CONSTRUCTION,ESSENTIAL RECONSTRUCTION OF FACILITIES,400,QUEENS,LQ-0122,1190,0,75,0,0,0,1000,0,1075,0,75,0,0,0,1000,0,1075,0,150,0,0,0,2000,0,2150,PROJECT DELAYED DUE TO BUDGETARY CONSTRAINTS,,FLUSHING,cpd11-20qn.pdf
LQFLELV,FLUSHING LIBRARY - CONSTRUCTION OF SECOND ELEVATOR,850,DEPT OF DESIGN & CONSTRUCTION,RECONSTRUCTION NECESSARY TO MAINTAIN FACILITIES,400,QUEENS,LQ-Q122 LQ-0122 LQ-D122,2990,957,0,0,9365,0,0,0,10322,957,0,0,9365,0,0,0,10322,1914,0,0,18730,0,0,0,20644,PROJECT DELAYED DUE TO CHANGES IN SCOPE/DESIGN,,CONSTRUCTION OF SECOND ELEVATOR AT FLUSHING. BP FUNDED FY 16,cpd11-20qn.pdf
LQHIHVAC,HILLCREST - HVAC,850,DEPT OF DESIGN & CONSTRUCTION,RECONSTRUCTION NECESSARY TO MAINTAIN FACILITIES,400,QUEENS,LQ-D122 LQ-0122,798,308,628,0,0,0,0,0,936,308,628,0,0,0,0,0,936,616,1256,0,0,0,0,0,1872,PROJECT DELAYED DUE TO CHANGES IN SCOPE/DESIGN,,HILLCREST - HVAC FY 16,cpd11-20qn.pdf
LQHIROOF,HILLCREST ROOF,850,DEPT OF DESIGN & CONSTRUCTION,RECONSTRUCTION NECESSARY TO MAINTAIN FACILITIES,400,QUEENS,LQ-D122 LQ-0122,903,394,1513,0,0,0,0,0,1907,394,1513,0,0,0,0,0,1907,788,3026,0,0,0,0,0,3814,PROJECT DELAYED DUE TO CHANGES IN SCOPE/DESIGN,,HILLCREST ROOF - FY 16,cpd11-20qn.pdf
LQLAROOF,LAURELTON ROOF,850,DEPT OF DESIGN & CONSTRUCTION,RECONSTRUCTION NECESSARY TO MAINTAIN FACILITIES,400,QUEENS,LQ-D122 LQ-0122,860,434,1142,0,0,0,0,0,1576,434,1142,0,0,0,0,0,1576,868,2284,0,0,0,0,0,3152,PROJECT DELAYED DUE TO CHANGES IN SCOPE/DESIGN,,LAURELTON ROOF -,cpd11-20qn.pdf
LQMVHVAC,MIDDLE VILLAGE - HVAC,850,DEPT OF DESIGN & CONSTRUCTION,RECONSTRUCTION NECESSARY TO MAINTAIN FACILITIES,400,QUEENS,LQ-D122,790,1017,82,0,0,0,0,0,1099,1017,82,0,0,0,0,0,1099,2034,164,0,0,0,0,0,2198,PROJECT DELAYED DUE TO CHANGES IN SCOPE/DESIGN,,MIDDLE VILLAGE - HVAC FY 16,cpd11-20qn.pdf
LQOZROOF,OZONE PARK ROOF REPLACEMENT,850,DEPT OF DESIGN & CONSTRUCTION,ESSENTIAL RECONSTRUCTION OF FACILITIES,400,QUEENS,LQ-Q122 LQ-0122,800,468,782,0,0,0,0,0,1250,468,782,0,0,0,0,0,1250,936,1564,0,0,0,0,0,2500,PROJECT DELAYED DUE TO BUDGETARY CONSTRAINTS,,OZONE PARK ROOF REPLACEMENT,cpd11-20qn.pdf
LQQ122-BL,Masonry Repairs - Bellerose,850,DEPT OF DESIGN & CONSTRUCTION,RECONSTRUCTION NECESSARY TO MAINTAIN FACILITIES,413,QUEENS,LQ-0122,634,1072,47,0,0,0,0,0,1119,1072,47,0,0,0,0,0,1119,2144,94,0,0,0,0,0,2238,PROJECT DELAYED DUE TO BUDGETARY CONSTRAINTS,,MASONRY REPAIRS - BL,cpd11-20qn.pdf
LQQ122-DL,"MULTIBRANCH (C, DL, NO, RO, S &SZ) - Roof Replacements",850,DEPT OF DESIGN & CONSTRUCTION,ESSENTIAL RECONSTRUCTION OF FACILITIES,411,QUEENS,LQ-0122,1620,2021,179,0,0,0,0,0,2200,2021,179,0,0,0,0,0,2200,4042,358,0,0,0,0,0,4400,PROJECT DELAYED DUE TO BUDGETARY CONSTRAINTS,,ROOF REPLACEMENT,cpd11-20qn.pdf
LQQ122EE2,EAST ELMHURST - Expansion,850,DEPT OF DESIGN & CONSTRUCTION,REPLACEMENT BRANCHES,403,QUEENS,LQ-Q122 LQ-0122 LQ-D122,2967,10799,1047,0,0,0,0,0,11846,10799,1047,0,0,0,0,0,11846,21598,2094,0,0,0,0,0,23692,PROJECT DELAYED DUE TO CHANGES IN SCOPE/DESIGN,,EAST ELMHURST EXPANSION,cpd11-20qn.pdf
LQQ122-FA,FAR ROCKAWAY - Replacement Facility,850,DEPT OF DESIGN & CONSTRUCTION,REPLACEMENT BRANCHES,414,QUEENS,LQ-Q122 LQ-0122 LQ-D001,1250,27179,5340,0,0,0,0,0,32519,27179,5340,0,0,0,0,0,32519,54358,10680,0,0,0,0,0,65038,PROJECT DELAYED DUE TO CHANGES IN SCOPE/DESIGN,,"DESIGN, CONSTRUCTION, OUTFITTING FOR REPLACEMENT FAR ROCKAWAY LIBRARY",cpd11-20qn.pdf
LQQ122-R1,RICHMOND HILL - Branch Renovation,850,DEPT OF DESIGN & CONSTRUCTION,ESSENTIAL RECONSTRUCTION OF FACILITIES,409,QUEENS,LQ-Q122 LQ-D122 LQ-0122,1650,7,0,0,0,14428,0,0,14435,7,0,0,0,14428,0,0,14435,14,0,0,0,28856,0,0,28870,PROJECT DELAYED DUE TO CHANGES IN SCOPE/DESIGN,,HVAC AND CONTROLS.,cpd11-20qn.pdf
LQQ122-RG,REGO PARK LIBRARY - REPLACEMENT FACILITY,850,DEPT OF DESIGN & CONSTRUCTION,REPLACEMENT BRANCHES,406,QUEENS,LQ-0122 LQ-D122 LQ-Q122,1250,3536,225,0,15756,0,15319,1000,35836,3536,225,0,15756,0,15319,1000,35836,7072,450,0,31512,0,30638,2000,71672,PROJECT DELAYED DUE TO BUDGETARY CONSTRAINTS,"91-41 63RD DRIVE, REGO PARK, NEW YORK 11374","DESIGN, CONSTRUCTION AND OUTFITTING FOR NEW REPLACEMENT FACILITY",cpd11-20qn.pdf
LQQBHHVAC,QUEENSBORO HILL - HVAC,850,DEPT OF DESIGN & CONSTRUCTION,RECONSTRUCTION NECESSARY TO MAINTAIN FACILITIES,400,QUEENS,LQ-D122 LQ-0122,815,300,2510,0,0,0,0,0,2810,300,2510,0,0,0,0,0,2810,600,5020,0,0,0,0,0,5620,PROJECT DELAYED DUE TO CHANGES IN SCOPE/DESIGN,,QUEENSBORO HILL HVAC,cpd11-20qn.pdf
LQQVHVAC,QUEENS VILLAGE - HVAC,850,DEPT OF DESIGN & CONSTRUCTION,RECONSTRUCTION NECESSARY TO MAINTAIN FACILITIES,400,QUEENS,LQ-0122,1000,378,1152,0,0,0,0,0,1530,378,1152,0,0,0,0,0,1530,756,2304,0,0,0,0,0,3060,PROJECT DELAYED DUE TO CHANGES IN SCOPE/DESIGN,,QUEENS VILLAGE HVAC,cpd11-20qn.pdf
LQQVROOF,QUEENS VILLAGE - ROOF,850,DEPT OF DESIGN & CONSTRUCTION,RECONSTRUCTION NECESSARY TO MAINTAIN FACILITIES,400,QUEENS,LQ-0122 LQ-D122,761,186,733,0,0,0,0,0,919,186,733,0,0,0,0,0,919,372,1466,0,0,0,0,0,1838,,,QUEENS VILLAGE ROOF,cpd11-20qn.pdf
LQRDMASON,RIDGEWOOD - MASONRY,850,DEPT OF DESIGN & CONSTRUCTION,RECONSTRUCTION NECESSARY TO MAINTAIN FACILITIES,400,QUEENS,LQ-0122,1718,482,1704,0,0,0,0,0,2186,482,1704,0,0,0,0,0,2186,964,3408,0,0,0,0,0,4372,,,RIDGEWOOD MASONRY,cpd11-20qn.pdf
LQSARENOV,ST. ALBANS RENOVATION,850,DEPT OF DESIGN & CONSTRUCTION,ESSENTIAL RECONSTRUCTION OF FACILITIES,400,QUEENS,LQ-Q122 LQ-0122 LQ-D122 LQ-D001,2485,0,0,0,8894,0,0,0,8894,0,0,0,8894,0,0,0,8894,0,0,0,17788,0,0,0,17788,PROJECT DELAYED DUE TO BUDGETARY CONSTRAINTS,,ST. ALBANS RENOVATION,cpd11-20qn.pdf
LQSAROOF,ST. ALBANS ROOF REPLACEMENT,850,DEPT OF DESIGN & CONSTRUCTION,ESSENTIAL RECONSTRUCTION OF FACILITIES,400,QUEENS,LQ-D122 LQ-0122,669,1197,26,0,0,0,0,129,1352,1197,26,0,0,0,0,129,1352,2394,52,0,0,0,0,258,2704,PROJECT DELAYED DUE TO BUDGETARY CONSTRAINTS,,ST. ALBANS ROOF REPLACEMENT,cpd11-20qn.pdf
LQSEHVAC,SEASIDE -HVAC,850,DEPT OF DESIGN & CONSTRUCTION,RECONSTRUCTION NECESSARY TO MAINTAIN FACILITIES,400,QUEENS,LQ-D122 LQ-0122,645,206,870,0,0,0,0,0,1076,206,870,0,0,0,0,0,1076,412,1740,0,0,0,0,0,2152,,,SEASIDE HVAC,cpd11-20qn.pdf
LQWSADA,WOODSIDE ADA,850,DEPT OF DESIGN & CONSTRUCTION,RECONSTRUCTION NECESSARY TO MAINTAIN FACILITIES,400,QUEENS,LQ-D122 LQ-0122,196,55,0,0,0,45,0,121,221,55,0,0,0,45,0,121,221,110,0,0,0,90,0,242,442,PROJECT DELAYED DUE TO BUDGETARY CONSTRAINTS,,WOODSIDE ADA,cpd11-20qn.pdf
P-407BHI3,BOWNE HOUSE INTERIOR RESTORATIONS,850,DEPT OF DESIGN & CONSTRUCTION,"LARGE, MAJOR AND REGIONAL PARK RECONSTRUCTION",400,QUEENS,P-Q245 P-D019,1875,1224,121,3398,0,0,0,0,4743,1224,121,3398,0,0,0,0,4743,2448,242,6796,0,0,0,0,9486,PROJECT DELAYED DUE TO BUDGETARY CONSTRAINTS,QUEENS,BOWNE HOUSE INTERIOR RESTORATIONS,cpd11-20qn.pdf
P-407BHV4,BOWNE HOUSE VISITORS CENTER Q022,850,DEPT OF DESIGN & CONSTRUCTION,"LARGE, MAJOR AND REGIONAL PARK RECONSTRUCTION",400,QUEENS,P-D019 P-Q245 P-1018,2465,46,0,1105,0,3804,0,0,4955,46,0,1105,0,3804,0,0,4955,92,0,2210,0,7608,0,0,9910,PROJECT DELAYED DUE TO BUDGETARY CONSTRAINTS,,BOWNE HOUSE VISITORS CENTER Q022,cpd11-20qn.pdf
P-4RCKGHQ,"Rockaway Operational Headquarters, SANDY4-50 and Sandy4-11",850,DEPT OF DESIGN & CONSTRUCTION,BEACHES AND BOARDWALKS,400,QUEENS,P-1018,16796,0,0,1170,0,0,0,0,1170,0,0,1170,0,0,0,0,1170,0,0,2340,0,0,0,0,2340,,,ROCKAWAY OPERATIONAL HEADQUARTERS,cpd11-20qn.pdf
PO79BMAHW,114TH PCT PLUMBING SYSTEM REPLACEMENT,850,DEPT OF DESIGN & CONSTRUCTION,POLICE FACILITIES,400,QUEENS,PO-0079,436,1721,85,0,0,0,0,0,1806,1721,85,0,0,0,0,0,1806,3442,170,0,0,0,0,0,3612,PROJECT DELAYED DUE TO UNFORESEEN SITE/FIELD CONDITION,,PLUMBING SYSTEM,cpd11-20qn.pdf
PV001SELM,LAH - Louis Armstrong House - Administration Facility,850,DEPT OF DESIGN & CONSTRUCTION,ESSENTIAL RECONSTRUCTION OF FACILITIES,403,QUEENS,PV-0001 PV-D001 PV-Q001 PV-0467,1265,1113,10,3082,0,0,0,0,4205,1113,10,3082,0,0,0,0,4205,2226,20,6164,0,0,0,0,8410,PROJECT DELAYED DUE TO BUDGETARY CONSTRAINTS,,SCOPE OF WORK INCLUDES,cpd11-20qn.pdf
PV040ELEV,FTH - Flushing Town Hall Elevator Replacement,850,DEPT OF DESIGN & CONSTRUCTION,ESSENTIAL RECONSTRUCTION OF FACILITIES,407,QUEENS,PV-Q040 PV-0040 PV-D040 PV-Q467,813,365,0,881,0,0,0,0,1246,365,0,881,0,0,0,0,1246,730,0,1762,0,0,0,0,2492,PROJECT DELAYED DUE TO CHANGES IN SCOPE/DESIGN,,FLUSHING TOWN HALL - ELEVATOR,cpd11-20qn.pdf
PV040HVAC,FTH - Flushing Town Hall HVAC System Replacement,850,DEPT OF DESIGN & CONSTRUCTION,ESSENTIAL RECONSTRUCTION OF FACILITIES,407,QUEENS,PV-Q040 PV-D040 PV-0040,809,0,244,0,1333,0,0,0,1577,0,244,0,1333,0,0,0,1577,0,488,0,2666,0,0,0,3154,PROJECT DELAYED DUE TO CHANGES IN SCOPE/DESIGN,,FLUSHING TOWN HALL - ROOFTOP AIR CONDITIONING UNIT,cpd11-20qn.pdf
PV272EDUC,QBG - Queens Botanical Garden Educ Bldg Renovation,850,DEPT OF DESIGN & CONSTRUCTION,ESSENTIAL RECONSTRUCTION OF FACILITIES,407,QUEENS,PV-Q272 PV-D272 PV-0272,20152,2728,400,1,22885,0,0,0,26014,2728,400,1,22885,0,0,0,26014,5456,800,2,45770,0,0,0,52028,PROJECT DELAYED DUE TO BUDGETARY CONSTRAINTS,,QUEENS BOTANICAL GARDEN - EDUCATION BUILDING,cpd11-20qn.pdf
PV272SITE,QBG - Site-wide Exterior Improvements,850,DEPT OF DESIGN & CONSTRUCTION,ESSENTIAL RECONSTRUCTION OF FACILITIES,,QUEENS,PV-D272 PV-0272,903,805,40,1,0,0,0,0,846,805,40,1,0,0,0,0,846,1610,80,2,0,0,0,0,1692,PROJECT DELAYED DUE TO BUDGETARY CONSTRAINTS,"43-50 MAIN STREET, QUEENS, NY",SITEWIDE LANDSCAPE IMPROVEMENTS.,cpd11-20qn.pdf
PV274CHLL,NYHOS - New York Hall of Science - Chiller Replacement,850,DEPT OF DESIGN & CONSTRUCTION,ESSENTIAL RECONSTRUCTION OF FACILITIES,407,QUEENS,PV-0274 PV-Q274 PV-D274,3083,765,31,5383,0,0,0,0,6179,765,31,5383,0,0,0,0,6179,1530,62,10766,0,0,0,0,12358,PROJECT DELAYED DUE TO BUDGETARY CONSTRAINTS,,NEW YORK HALL OF SCIENCE CHILLER REPLACEMENT,cpd11-20qn.pdf
PV274EXLT,NYHOS - NY Hall of Science Lighting for Outdoor Exhibits,850,DEPT OF DESIGN & CONSTRUCTION,ESSENTIAL RECONSTRUCTION OF FACILITIES,408,QUEENS,PV-Q274 PV-0274 PV-D467,1830,2211,100,205,748,0,0,0,3264,2211,100,205,748,0,0,0,3264,4422,200,410,1496,0,0,0,6528,PROJECT DELAYED DUE TO BUDGETARY CONSTRAINTS,,FUNDING FOR THE INSTALLATION OF LIGHTING FOR THE SCIENCE PLAYGROUND AND ROCKET PARK,cpd11-20qn.pdf
PV274GHIN,NYHOS - NY HALL OF SCIENCE - Great Hall Int. Systems Recon.,850,DEPT OF DESIGN & CONSTRUCTION,NEW TECHNOLOGY AND CONSTRUCTION,407,QUEENS,PV-D274 PV-Q274,4850,20751,0,4488,0,0,0,0,25239,20751,0,4488,0,0,0,0,25239,41502,0,8976,0,0,0,0,50478,PROJECT DELAYED DUE TO BUDGETARY CONSTRAINTS,47-01 111TH STREET CORONA NEW YORK,PROJECT SCOPE OF WORK IS THE INTERIOR RECONSTRUCTION OF THE 1964 WORLD FAIR GREAT HALL.,cpd11-20qn.pdf
PV274KITR,"NYHOS - NY Hall of Science,Great Hall, Kitchen & Restroom",850,DEPT OF DESIGN & CONSTRUCTION,ESSENTIAL RECONSTRUCTION OF FACILITIES,401,QUEENS,PV-Q274 PV-D274 PV-0274,2449,140,4281,0,0,0,0,0,4421,140,4281,0,0,0,0,0,4421,280,8562,0,0,0,0,0,8842,PROJECT DELAYED PENDING RELEASE OF NEW TECHNOLOGY,,SCOPE OF WORK IS THE RECONSTRUCTION OF THE GREAT HALL KITCHEN AND THERECONSTRUVTION,cpd11-20qn.pdf
PV291-QM2,QMA - Queen's Museum of Art Expansion Phase II,850,DEPT OF DESIGN & CONSTRUCTION,ESSENTIAL RECONSTRUCTION OF FACILITIES,,QUEENS,PV-Q291 PV-0291 PV-D291 PV-D467,2315,0,600,0,14138,0,0,0,14738,0,600,0,14138,0,0,0,14738,0,1200,0,28276,0,0,0,29476,PROJECT DELAYED DUE TO BUDGETARY CONSTRAINTS,,QMA,cpd11-20qn.pdf
PV291-QMX,QMA - Queens Museum of Art Expansion,850,DEPT OF DESIGN & CONSTRUCTION,ESSENTIAL RECONSTRUCTION OF FACILITIES,407 406,QUEENS,PV-Q291 PV-0291,32609,57101,0,283,0,0,0,0,57384,57101,0,283,0,0,0,0,57384,114202,0,566,0,0,0,0,114768,PROJECT DELAYED DUE TO BUDGETARY CONSTRAINTS,"NYC BUILDING FLUSHING MEADOWS CORONA PARK, CORONA NY 11368",EXPANSION,cpd11-20qn.pdf
PV501BOIL,PS1 - PS1 Boiler Replacement,850,DEPT OF DESIGN & CONSTRUCTION,ESSENTIAL RECONSTRUCTION OF FACILITIES,,QUEENS,PV-Q501 PV-0501 PV-D501 PV-Q467,1000,880,2910,0,0,0,0,0,3790,880,2910,0,0,0,0,0,3790,1760,5820,0,0,0,0,0,7580,PROJECT DELAYED DUE TO BUDGETARY CONSTRAINTS,,REPLACEMENT OF TWO BOILERS AT PS1,cpd11-20qn.pdf
PW293QBLV,120-55 QUEENS BLVD - FIRE ALARM,850,DEPT OF DESIGN & CONSTRUCTION,LEGAL MANDATES AND CORRECTION OF UNSAFE CONDITIONS,401,QUEENS,PW-0293,3119,967,11112,45,0,0,0,0,12124,967,11112,45,0,0,0,0,12124,1934,22224,90,0,0,0,0,24248,,,120-55 QUEENS BLVD - FIRE ALARM,cpd11-20qn.pdf
PW77417DA,120-55 QUEENS BLVD.- QUEENS DA TRAINING ROOM,850,DEPT OF DESIGN & CONSTRUCTION,REHABILITATION OF CITY-OWNED OFFICE SPACE,401,QUEENS,PW-0077,1705,829,103,2439,0,0,0,0,3371,829,103,2439,0,0,0,0,3371,1658,206,4878,0,0,0,0,6742,PROJECT DELAYED DUE TO BUDGETARY CONSTRAINTS,,120-55 QUEENS BLVD.- QUEENS DA TRAINING ROOM,cpd11-20qn.pdf
PW77417P2,"120-55 QUEENS BLVD - PLAZA, STEPS AND ENTRANCE",850,DEPT OF DESIGN & CONSTRUCTION,REHABILITATION OF CITY-OWNED OFFICE SPACE,400 409,QUEENS,PW-0077,3940,100,4500,1997,0,0,0,0,6597,100,4500,1997,0,0,0,0,6597,200,9000,3994,0,0,0,0,13194,PROJECT DELAYED DUE TO BUDGETARY CONSTRAINTS,,"REPAIRS AND REPLACEMENT OF GRANITE PAVE CRACKED, DISPLACEMENT OF GRANITE, CONCRETE",cpd11-20qn.pdf
PW77ELEV,120-55 QUEENS BLVD. ELEVATOR MODERNIZATION,850,DEPT OF DESIGN & CONSTRUCTION,REHABILITATION OF CITY-OWNED OFFICE SPACE,401,QUEENS,PW-0077,1300,0,0,232,2085,0,0,0,2317,0,0,232,2085,0,0,0,2317,0,0,464,4170,0,0,0,4634,PROJECT DELAYED DUE TO BUDGETARY CONSTRAINTS,,SQ FT,cpd11-20qn.pdf
PWD99WNY1,CENTER FOR THE WOMEN OF NEW YORK,850,DEPT OF DESIGN & CONSTRUCTION,MISCELLANEOUS CONSTRUCTION,400,QUEENS,P-D019 P-Q245,1100,4092,266,0,0,0,0,0,4358,4092,266,0,0,0,0,0,4358,8184,532,0,0,0,0,0,8716,PROJECT DELAYED PENDING RESOLUTION OF LEGAL ISSUES,,RECONSTRUCTION,cpd11-20qn.pdf
PWQ077AT2,120-55 QUEENS BLVD- QUEENS BOROUGH HALL ATRIUM,850,DEPT OF DESIGN & CONSTRUCTION,REHABILITATION OF CITY-OWNED OFFICE SPACE,401,QUEENS,PW-0077 PW-Q077,21854,19394,98,25,0,0,0,0,19517,19394,98,25,0,0,0,0,19517,38788,196,50,0,0,0,0,39034,PROJECT DELAYED DUE TO BUDGETARY CONSTRAINTS,,120-55 QUEENS BVLD- QUEENS BOROUGH HALL ATRIUM,cpd11-20qn.pdf
QED-1000,WATER MAIN WORK IN VARIOUS LOCATIONS PROJECT Q2006-04,850,DEPT OF DESIGN & CONSTRUCTION,TRUNK AND DISTRIBUTION MAIN REPLACEMENT,408,QUEENS,WM-0001,4900,8644,224,0,0,0,0,0,8868,8644,224,0,0,0,0,0,8868,17288,448,0,0,0,0,0,17736,PROJECT DELAYED DUE TO UNFORESEEN SITE/FIELD CONDITION,,WATER MAIN WORK IN VARIOUS LOCATIONS PROJECT Q2006-04,cpd11-20qn.pdf
QED1002,WATER MAIN WORK IN VARIOUS LOCATIONS PROJ Q2007-05,850,DEPT OF DESIGN & CONSTRUCTION,TRUNK AND DISTRIBUTION MAIN EXTENSION,406,QUEENS,SE-1000 WM-0006,16900,30115,358,0,0,0,0,0,30473,30115,358,0,0,0,0,0,30473,60230,716,0,0,0,0,0,60946,PROJECT DELAYED DUE TO UNFORESEEN SITE/FIELD CONDITION,,WATER MAIN WORK IN VARIOUS LOCATIONS PROJ Q2007-05,cpd11-20qn.pdf
QED1005,DIST WATER MAIN REPLACEMENT LONG ISLAND CITY,850,DEPT OF DESIGN & CONSTRUCTION,TRUNK AND DISTRIBUTION MAIN REPLACEMENT,401,QUEENS,WM-0001,11600,38957,611,65,0,0,0,0,39633,38957,611,65,0,0,0,0,39633,77914,1222,130,0,0,0,0,79266,PROJECT DELAYED DUE TO UNFORESEEN SITE/FIELD CONDITION,,"DIST WATER MAIN REPLACEMENT LONG ISLAND CITY , ASTORIA AT VARIOUS LOCATIONS",cpd11-20qn.pdf
QED-1007,New Trunk Water Main in Rockaway Beach Blvd (SANDHW12),850,DEPT OF DESIGN & CONSTRUCTION,TRUNK AND DISTRIBUTION MAIN REPLACEMENT,414,QUEENS,WM-0006 SE-0200Q SE-0002Q WM-0001,4994,28226,437,130,0,0,0,0,28793,28226,437,130,0,0,0,0,28793,56452,874,260,0,0,0,0,57586,PROJECT DELAYED DUE TO UNFORESEEN SITE/FIELD CONDITION,,NEW TRUNK WATER MAIN IN ROCKAWAY BEACH BLVD. B/W B 59 STREET AND B 49STREET,cpd11-20qn.pdf
QED-1008,3WT-TRUNK MAIN CONNECTION IN 54 ST,850,DEPT OF DESIGN & CONSTRUCTION,TRUNK AND DISTRIBUTION MAIN REPLACEMENT,400 401 402 405,QUEENS,WM-0006 TF-0502 SE-0002Q,60985,10498,147,0,0,0,0,0,10645,10498,147,0,0,0,0,0,10645,20996,294,0,0,0,0,0,21290,PROJECT DELAYED DUE TO CHANGES IN SCOPE/DESIGN,,3WT-TRUNK MAIN CONNECTION IN 54 ST,cpd11-20qn.pdf
QED1014,Rehabilitation of Astoria Water Trunk Main by Lining,850,DEPT OF DESIGN & CONSTRUCTION,AUGMENTATION OF WATER SUPPLY SYSTEMS,401,QUEENS,WM-0006 HW-0200,3300,30293,1233,6,0,0,0,0,31532,30293,1233,6,0,0,0,0,31532,60586,2466,12,0,0,0,0,63064,PROJECT DELAYED DUE TO BUDGETARY CONSTRAINTS,,REHABILITATION OF ASTORIA WATER TRUNK MAIN BY LINING IN 41ST STREET BETWEEN 25TH AVENUE,cpd11-20qn.pdf
QED-1022,Replcmnt of Water Mains in Former Jamaica Water Supply Area,850,DEPT OF DESIGN & CONSTRUCTION,TRUNK AND DISTRIBUTION MAIN REPLACEMENT,409,QUEENS,WM-0001,24725,32217,2567,0,0,0,0,0,34784,32217,2567,0,0,0,0,0,34784,64434,5134,0,0,0,0,0,69568,,,"REPLCMNT OF WATER MAINS IN FORMER JAMAICA WATER SUPPLY AREA, VARIOUSLOCATIONS.",cpd11-20qn.pdf
QED-1023A,"Distribution WM replacement, Onderdonk Ave, Qns",850,DEPT OF DESIGN & CONSTRUCTION,TRUNK AND DISTRIBUTION MAIN REPLACEMENT,405,QUEENS,WM-0001,14031,21952,73,0,0,0,0,0,22025,21952,73,0,0,0,0,0,22025,43904,146,0,0,0,0,0,44050,,,"DISTRIBUTION WM REPLAC. ONDERDONK AVE B/T METROPOLITAN AVE & BLEEKER ST, QNS",cpd11-20qn.pdf
QED-1023B,"Distr & Trunk WM Replacement Cypress Ave, Queens (Joint Bid)",850,DEPT OF DESIGN & CONSTRUCTION,TRUNK AND DISTRIBUTION MAIN REPLACEMENT,405,QUEENS,WM-0006 SE-0002Q HW-0200,26150,46639,939,0,0,0,0,0,47578,46639,939,0,0,0,0,0,47578,93278,1878,0,0,0,0,0,95156,,,"DISTRIBUTION & TRUNK REPLACEMENT CYPRESS AVE B/T WIILLOUGHBY AVE & HIMROD ST, QNS",cpd11-20qn.pdf
QED-1027,Replacement of Dist WM in 222nd St,850,DEPT OF DESIGN & CONSTRUCTION,TRUNK AND DISTRIBUTION MAIN REPLACEMENT,413,QUEENS,WM-0001 SE-0200Q,34476,790,0,0,0,37315,0,0,38105,790,0,0,0,37315,0,0,38105,1580,0,0,0,74630,0,0,76210,PROJECT DELAYED DUE TO UNFORESEEN SITE/FIELD CONDITION,,"REPLACEMENT OF DIST WM IN 222ND ST BETWEEN JAMAICA AVE AND HEMPSTEAD AVE, ETC. JAMAICA",cpd11-20qn.pdf
QED-1030,"Water Main & Sewer Work, Beach Channel Drive Area (SANDHW11)",850,DEPT OF DESIGN & CONSTRUCTION,TRUNK AND DISTRIBUTION MAIN REPLACEMENT,400,QUEENS,SE-0002Q WM-0001,7540,7614,1070,0,0,0,0,0,8684,7614,1070,0,0,0,0,0,8684,15228,2140,0,0,0,0,0,17368,PROJECT DELAYED DUE TO BUDGETARY CONSTRAINTS,OF BEACH CHANNEL DRIVE FROM BEACH 124TH STREET TO BEACH 116TH STREET IN ROCKAWAY,WM AND SW -BEACH CHANNEL DRIVE FROM BEACH 124TH STREET TO BEACH 116THSTREET IN,cpd11-20qn.pdf
QED-1036,Water Main Replacement in Queens Blvd,850,DEPT OF DESIGN & CONSTRUCTION,TRUNK AND DISTRIBUTION MAIN REPLACEMENT,406,QUEENS,TF-0002,6894,747,0,40,0,0,0,0,787,747,0,40,0,0,0,0,787,1494,0,80,0,0,0,0,1574,,,"WATER MAIN REPLACEMENT IN QUEENS BLVD FROM 63RD RD. TO 69TH AVENUE, ETC",cpd11-20qn.pdf
QED-1037,"WM Replacement in South Conduit Ave, Queens",850,DEPT OF DESIGN & CONSTRUCTION,TRUNK AND DISTRIBUTION MAIN REPLACEMENT,413,QUEENS,WM-0001,12076,8089,591,0,0,0,0,0,8680,8089,591,0,0,0,0,0,8680,16178,1182,0,0,0,0,0,17360,PROJECT DELAYED DUE TO UNFORESEEN SITE/FIELD CONDITION,,"WM REPLACEMENT IN SOUTH CONDUIT AVE BETWEEN 124TH ST AND 134TH ST, ETC QUEENS",cpd11-20qn.pdf
QED-1042A,Watermain replacement & sewer repair on Queens Blvd-HWQ1190A,850,DEPT OF DESIGN & CONSTRUCTION,AUGMENTATION OF WATER SUPPLY SYSTEMS,402,QUEENS,WM-0006 SE-0002Q WM-0001,46661,0,71,0,87136,0,0,0,87207,0,71,0,87136,0,0,0,87207,0,142,0,174272,0,0,0,174414,,,WATERMAIN REPLACEMENT AND SEWER REPAIR ON QUEENS BLVD FROM 48TH STREET TO 73RD,cpd11-20qn.pdf
QED-1044,Replacement of Water Mains in Beach 108th Street (SANDR04),850,DEPT OF DESIGN & CONSTRUCTION,AUGMENTATION OF WATER SUPPLY SYSTEMS,414,QUEENS,WM-0001 SE-0200Q,3428,3668,4546,0,0,0,0,0,8214,3668,4546,0,0,0,0,0,8214,7336,9092,0,0,0,0,0,16428,PROJECT DELAYED DUE TO CHANGES IN SCOPE/DESIGN,,REPLACEMENT OF WATER MAINS IN BEACH 108TH STREET BETWEEN BEACH CHANNEL DRIVE AND,cpd11-20qn.pdf
QED-1045,Schl Safety Prog 4 - Replmt of WM 16th Ave bwtn Bell & 212st,850,DEPT OF DESIGN & CONSTRUCTION,AUGMENTATION OF WATER SUPPLY SYSTEMS,407,QUEENS,WM-0001,122,0,122,0,0,0,0,0,122,0,122,0,0,0,0,0,122,0,244,0,0,0,0,0,244,PROJECT DELAYED DUE TO UNFORESEEN SITE/FIELD CONDITION,,SCHOOL SAFETY PROG 4 - REPLACEMENT OF WATER MAIN IN 16TH AVE BETWEEN BELL BOULEVARD &,cpd11-20qn.pdf
QED-1049,Rplmnt WM at 111 St btw 45th & Corona Ave (HWD10311),850,DEPT OF DESIGN & CONSTRUCTION,REPLACEMENT OR AUGMENTATION OF EXISTING SYSTEMS,400,QUEENS,SE-0002Q WM-0001,5974,0,0,5974,0,0,0,0,5974,0,0,5974,0,0,0,0,5974,0,0,11948,0,0,0,0,11948,,,REPLACEMENT OF DISTRIBUTION WATER MAIN AT 111TH STREET BETWEEN 45TH AVENUE AND CORONA,cpd11-20qn.pdf
QED-1051,Water Main Replacement in Maspeth Avenue,850,DEPT OF DESIGN & CONSTRUCTION,AUGMENTATION OF WATER SUPPLY SYSTEMS,401,QUEENS,WM-0001,3221,200,0,0,0,4580,0,0,4780,200,0,0,0,4580,0,0,4780,400,0,0,0,9160,0,0,9560,,,TO REPLACE AGEING AND UNDERSIZED WATER MAIN PIPES IN ADDITION TO IMPROVING WATER,cpd11-20qn.pdf
QED-976,SEQ - Trunk Water Main in Francis Lewis Blvd (HWQ976),850,DEPT OF DESIGN & CONSTRUCTION,TRUNK AND DISTRIBUTION MAIN EXTENSION,413,QUEENS,SE-0200Q SE-0002Q TF-0502 HW-0001Q WM-0006 TF-0002,38249,58369,2378,0,0,0,0,0,60747,58369,2378,0,0,0,0,0,60747,116738,4756,0,0,0,0,0,121494,PROJECT DELAYED DUE TO CHANGES IN SCOPE/DESIGN,TRUNK MAIN IN FRANCIS LEWIS BLVD - 90 AV TO 99 AV,TRUNK MAIN IN FRANCIS LEWIS BLVD - 90 AV TO 99 AV,cpd11-20qn.pdf
QED-990,NEW TRUNK & DISTR WMS IN VERMONT PL B/T CYPRESS & JR,850,DEPT OF DESIGN & CONSTRUCTION,TRUNK AND DISTRIBUTION MAIN EXTENSION,405,QUEENS,WM-0006 WM-0001,6813,26880,0,254,0,0,0,0,27134,26880,0,254,0,0,0,0,27134,53760,0,508,0,0,0,0,54268,PROJECT DELAYED DUE TO UNFORESEEN SITE/FIELD CONDITION,,"NEW TRUNK & DISTR WMS IN VERMONT PL B/T CYPRESS & JACKIE ROBINSON PARKWAY, ETC",cpd11-20qn.pdf
QED-991,"New WM, Trunk Main Ext, 33 Ave & Francis Lewis Blvd, Queens",850,DEPT OF DESIGN & CONSTRUCTION,TRUNK AND DISTRIBUTION MAIN EXTENSION,407 411,QUEENS,WM-0006 SE-0002Q HW-0200 WM-0001 SE-0200Q TF-0502,44838,74807,15271,0,0,0,0,1500,91578,74807,15271,0,0,0,0,1500,91578,149614,30542,0,0,0,0,3000,183156,PROJECT DELAYED DUE TO UNFORESEEN SITE/FIELD CONDITION,,"NEW WM, EXTEND TRUNK MAINS, UPGRADE 33RRD, 37TH & 38 AVE-FRANCIS LEWIS BLVD & UTOPIA",cpd11-20qn.pdf
QED-996,WATER MAIN IN VARIOUS LOCATIONS. PROJECT Q2005-16,850,DEPT OF DESIGN & CONSTRUCTION,TRUNK AND DISTRIBUTION MAIN EXTENSION,408,QUEENS,HW-0200 WM-0001,6100,14166,75,0,0,0,0,0,14241,14166,75,0,0,0,0,0,14241,28332,150,0,0,0,0,0,28482,PROJECT DELAYED DUE TO UNFORESEEN SITE/FIELD CONDITION,,WATER MAIN IN VARIOUS LOCATIONS. PROJECT Q2005-16,cpd11-20qn.pdf
QEDA-003,Accelerated Distribution WM Replacement & Sewer Rehab - QNS,850,DEPT OF DESIGN & CONSTRUCTION,TRUNK AND DISTRIBUTION MAIN REPLACEMENT,400,QUEENS,SE-0200Q,17175,25395,521,0,0,0,0,0,25916,25395,521,0,0,0,0,0,25916,50790,1042,0,0,0,0,0,51832,PROJECT DELAYED DUE TO UNFORESEEN SITE/FIELD CONDITION,,"ACCELERATED DISTRIBUTION WATER MAIN REPLCMNT & SEWER REBHAB/REPLCMNT,QUEENS",cpd11-20qn.pdf
S136-383K,QUEENS 5/5A HVAC,850,DEPT OF DESIGN & CONSTRUCTION,GARAGES AND FACILITIES,405,QUEENS,S-0136,5150,6325,425,0,0,0,0,0,6750,6325,425,0,0,0,0,0,6750,12650,850,0,0,0,0,0,13500,PROJECT DELAYED DUE TO UNFORESEEN SITE/FIELD CONDITION,,HVAC REPLACEMENT,cpd11-20qn.pdf
S136-423,Queens 11/13 FLOOR SLAB REPLACEMENT,850,DEPT OF DESIGN & CONSTRUCTION,GARAGES AND FACILITIES,411,QUEENS,S-0136 PU-0025,11250,6170,4762,59300,0,0,0,0,70232,6170,4762,59300,0,0,0,0,70232,12340,9524,118600,0,0,0,0,140464,PROJECT DELAYED DUE TO CHANGES IN SCOPE/DESIGN,,FLOOR SLAB REPLACEMENT,cpd11-20qn.pdf
S136-438,QUEENS 7 GARAGE REHABILITATION,850,DEPT OF DESIGN & CONSTRUCTION,GARAGES AND FACILITIES,407,QUEENS,S-0136,28680,21968,807,2742,0,0,0,0,25517,21968,807,2742,0,0,0,0,25517,43936,1614,5484,0,0,0,0,51034,PROJECT DELAYED DUE TO CHANGES IN SCOPE/DESIGN,,REHABILITATION OF QUEENS 7 GARAGE,cpd11-20qn.pdf
SAND1187,"Recon of Norton Drive - Hurricane Sandy (HWQ1187, SEQ200595)",850,DEPT OF DESIGN & CONSTRUCTION,PRIMARY STREET RECONSTRUCTION,400,QUEENS,HW-0001Q,1732,42,0,0,0,0,0,152,194,42,0,0,0,0,0,152,194,84,0,0,0,0,0,304,388,PROJECT DELAYED DUE TO UNFORESEEN SITE/FIELD CONDITION,RECONSTRUCTION OF NORTON DRIVE - HURRICANE SANDY,RECONSTRUCTION OF NORTON DRIVE - HURRICANE SANDY,cpd11-20qn.pdf
SANDBROAD,SANDY DAMAGES BROAD CHANNEL BRANCH LIBRARY,850,DEPT OF DESIGN & CONSTRUCTION,RECONSTRUCTION NECESSARY TO MAINTAIN FACILITIES,414,QUEENS,LQ-0122,1095,52,0,0,0,0,0,0,52,52,0,0,0,0,0,0,52,104,0,0,0,0,0,0,104,PROJECT DELAYED DUE TO UNFORESEEN SITE/FIELD CONDITION,,HURRICANE SANDY RELATED DAMAGES AT BROAD CHANNEL BRANCH LIBRARY,cpd11-20qn.pdf
SANDELEC5,"100 the precint electrical system replacement, Sandy",850,DEPT OF DESIGN & CONSTRUCTION,POLICE FACILITIES,414,QUEENS,PO-0079,1802,1608,277,0,0,0,0,0,1885,1608,277,0,0,0,0,0,1885,3216,554,0,0,0,0,0,3770,PROJECT DELAYED PENDING RESOLUTION OF LEGAL ISSUES,,"100 THE PRECINT ELECTRICAL SYSTEM REPLACEMENT, SANDY",cpd11-20qn.pdf
SANDHW10,Reconstruction of Willets Point - Hurricane Sandy,850,DEPT OF DESIGN & CONSTRUCTION,PRIMARY STREET RECONSTRUCTION,400,QUEENS,HW-0001Q,5825,25,0,0,0,0,0,448,473,25,0,0,0,0,0,448,473,50,0,0,0,0,0,896,946,PROJECT DELAYED DUE TO CHANGES IN SCOPE/DESIGN,RECONSTRUCTION OF WILLETS POINT - HURRICANE SANDY,RECONSTRUCTION OF WILLETS POINT - HURRICANE SANDY,cpd11-20qn.pdf
SANDHW11,Recon of Beach Channel Drive - Hurricane Sandy (QED-1030),850,DEPT OF DESIGN & CONSTRUCTION,PRIMARY STREET RECONSTRUCTION,400,QUEENS,HW-0001Q F-0001,12427,3920,983,1676,1071,0,0,0,7650,3920,983,1676,1071,0,0,0,7650,7840,1966,3352,2142,0,0,0,15300,PROJECT DELAYED DUE TO BUDGETARY CONSTRAINTS,RECONSTRUCTION OF BEACH CHANNEL DRIVE - HURRICANE SANDY,RECONSTRUCTION OF BEACH CHANNEL DRIVE - HURRICANE SANDY,cpd11-20qn.pdf
SANDHW12,Reconstruction of Edgemere - Hurricane Sandy (QED-1007),850,DEPT OF DESIGN & CONSTRUCTION,PRIMARY STREET RECONSTRUCTION,400,QUEENS,HW-0001Q,5392,2715,5,2,0,0,0,0,2722,2715,5,2,0,0,0,0,2722,5430,10,4,0,0,0,0,5444,PROJECT DELAYED DUE TO UNFORESEEN SITE/FIELD CONDITION,RECONSTRUCTION OF EDGEMERE - HURRICANE SANDY,RECONSTRUCTION OF EDGEMERE - HURRICANE SANDY,cpd11-20qn.pdf
SANDHW13,Reconstruction of Rockaway Beach - Hurricane Sandy (QED-982),850,DEPT OF DESIGN & CONSTRUCTION,PRIMARY STREET RECONSTRUCTION,400,QUEENS,HW-0001Q TF-0502 HW-0200 F-0001,14603,5497,1559,0,0,524,0,899,8479,5497,1559,0,0,524,0,899,8479,10994,3118,0,0,1048,0,1798,16958,PROJECT DELAYED DUE TO UNFORESEEN SITE/FIELD CONDITION,RECONSTRUCTION OF ROCKAWAY BEACH - HURRICANE SANDY,RECONSTRUCTION OF ROCKAWAY BEACH - HURRICANE SANDY,cpd11-20qn.pdf
SANDHW24,WHEN AND WHERE HURRICANE SANDY - QUEENS,850,DEPT OF DESIGN & CONSTRUCTION,PRIMARY STREET RECONSTRUCTION,400,QUEENS,WM-0001 HW-D103 HW-0001Q,22186,7693,1,0,0,296,0,843,8833,7693,1,0,0,296,0,843,8833,15386,2,0,0,592,0,1686,17666,PROJECT DELAYED DUE TO UNFORESEEN SITE/FIELD CONDITION,WHEN AND WHERE HURRICANE SANDY - QUEENS,RECONSTRUCTION OF ROCKAWAY - HURRICANE SANDY,cpd11-20qn.pdf
SANDHW26,Reconstruction of East 10th Road - Hurricane Sandy,850,DEPT OF DESIGN & CONSTRUCTION,PRIMARY STREET RECONSTRUCTION,400,QUEENS,HW-0001Q,620,0,0,0,0,0,0,44,44,0,0,0,0,0,0,44,44,0,0,0,0,0,0,88,88,PROJECT DELAYED DUE TO CHANGES IN SCOPE/DESIGN,RECONSTRUCTION OF EAST 10TH ROAD - HURRICANE SANDY,RECONSTRUCTION OF EAST 10TH ROAD - HURRICANE SANDY,cpd11-20qn.pdf
SANDR02,FAR ROCKAWAY BUSINESS DISTRICT IMPROVEMENTS (SE-830),850,DEPT OF DESIGN & CONSTRUCTION,PRIMARY STREET RECONSTRUCTION,400 414,QUEENS,HW-0944 HW-0001Q,2400,18030,0,0,0,9140,0,0,27170,18030,0,0,0,9140,0,0,27170,36060,0,0,0,18280,0,0,54340,PROJECT DELAYED DUE TO UNFORESEEN SITE/FIELD CONDITION,FAR ROCKAWAY IMPROVEMENTS BUSINESS DISTRICT,FAR ROCKAWAY IMPROVEMENTS BUSINESS DISTRICT,cpd11-20qn.pdf
SANDR04,Beach 108th Streetscape Improvements (QED-1044),850,DEPT OF DESIGN & CONSTRUCTION,PRIMARY STREET RECONSTRUCTION,400,QUEENS,TF-0502 HW-0001Q,8200,2975,4090,386,0,0,5864,0,13315,2975,4090,386,0,0,5864,0,13315,5950,8180,772,0,0,11728,0,26630,PROJECT DELAYED DUE TO BUDGETARY CONSTRAINTS,BEACH 108TH STREETSCAPE IMPROVEMENTS,BEACH 108TH STREETSCAPE IMPROVEMENTS,cpd11-20qn.pdf
SANDY4-30,"Tide Gate - FEMA 406 In-Kind, HMP & 428 Conduit HBPED800Q",850,DEPT OF DESIGN & CONSTRUCTION,NEIGHBORHOOD PARKS AND PLAYGROUNDS,400,QUEENS,P-1018,1311,21,0,0,113,0,0,0,134,21,0,0,113,0,0,0,134,42,0,0,226,0,0,0,268,PROJECT DELAYED DUE TO UNFORESEEN SITE/FIELD CONDITION,,"TIDE GATE - FEMA 406 IN-KIND, HMP & 428 CONDUIT",cpd11-20qn.pdf
SANDY4-31,Tide Gate - 404 HMGP HBPED800Q,850,DEPT OF DESIGN & CONSTRUCTION,NEIGHBORHOOD PARKS AND PLAYGROUNDS,400,QUEENS,P-1018,5962,444,0,0,1379,0,0,0,1823,444,0,0,1379,0,0,0,1823,888,0,0,2758,0,0,0,3646,PROJECT DELAYED DUE TO UNFORESEEN SITE/FIELD CONDITION,,TIDE GATE - 404 HMGP,cpd11-20qn.pdf
SANDY4-50,SANDY-Rockaway Operational Headquarters Reconstruction,850,DEPT OF DESIGN & CONSTRUCTION,BEACHES AND BOARDWALKS,400,QUEENS,P-1018,18876,150,0,0,0,0,0,0,150,150,0,0,0,0,0,0,150,300,0,0,0,0,0,0,300,PROJECT DELAYED DUE TO BUDGETARY CONSTRAINTS,,SANDY-ROCKAWAY OPERATIONAL HEADQUARTERS RECONSTRUCTION,cpd11-20qn.pdf
SE-785,STORM SEWER IN 110 AV - SUTPHIN BLVD AND 173 ST,850,DEPT OF DESIGN & CONSTRUCTION,REPLACEMENT OF CHRONICALLY FAILING COMPONENTS,412,QUEENS,SE-0785,10202,9032,35,0,0,0,0,0,9067,9032,35,0,0,0,0,0,9067,18064,70,0,0,0,0,0,18134,PROJECT DELAYED DUE TO UNFORESEEN SITE/FIELD CONDITION,STORM SEWER IN 110 AV - SUTPHIN BLVD AND 173 ST,STORM SEWER IN 110 AV - SUTPHIN BLVD AND 173 ST,cpd11-20qn.pdf
SE-789B-3,B 63 ST - BAYFIELD AV & ROCKAWAY FWAY (SOMMERVILLE III),850,DEPT OF DESIGN & CONSTRUCTION,EXTENSIONS TO ACCOMMODATE NEW DEVELOPMENT,414,QUEENS,SE-0789 WM-0001,6190,0,0,0,4065,0,535,0,4600,0,0,0,4065,0,535,0,4600,0,0,0,8130,0,1070,0,9200,PROJECT DELAYED DUE TO CHANGES IN SCOPE/DESIGN,B 63 ST - BAYFIELD AV & ROCKAWAY FWAY (SOMMERVILLE III),B 63 ST - BAYFIELD AV & ROCKAWAY FWAY (SOMMERVILLE III),cpd11-20qn.pdf
SE-795,Storm & Sani Sewer in Chandler St - Nameoke Av & Battery Rd,850,DEPT OF DESIGN & CONSTRUCTION,EXTENSIONS TO ACCOMMODATE NEW DEVELOPMENT,414,QUEENS,SE-0200Q SE-0002Q WM-0001 F-0001,7163,30673,284,0,0,0,0,0,30957,30673,284,0,0,0,0,0,30957,61346,568,0,0,0,0,0,61914,PROJECT DELAYED DUE TO UNFORESEEN SITE/FIELD CONDITION,,"STORM & SANITARY SEWER IN CHANDLER ST- NAMEOKE AV&BATTERY RD, WATERMAIN WORK.",cpd11-20qn.pdf
SE-807,Storm & San Sewers in 20th Ave b/t 126 St & US Bulkhead Line,850,DEPT OF DESIGN & CONSTRUCTION,PROGRAMMATIC REPLACEMENT AND RECONSTRUCTION,407,QUEENS,SE-0002Q,18910,129110,1939,0,0,0,0,0,131049,129110,1939,0,0,0,0,0,131049,258220,3878,0,0,0,0,0,262098,,,"STORM & SAN SEWERS IN 20TH AVE B/T126 ST & US BULKHEAD LINE, ETC WATER MAIN WORKS.",cpd11-20qn.pdf
SE-809,STORM & SAN SEWERS IN N.B WHITESTONE EXPWY SERV RD PHASE 1,850,DEPT OF DESIGN & CONSTRUCTION,PROGRAMMATIC REPLACEMENT AND RECONSTRUCTION,407,QUEENS,SE-0200Q,18869,81787,71,0,0,0,0,0,81858,81787,71,0,0,0,0,0,81858,163574,142,0,0,0,0,0,163716,PROJECT DELAYED DUE TO UNFORESEEN SITE/FIELD CONDITION,,"PHASE 1, STORM & SAN SEWERS IN N.B WHITESTONE EXPWY SERV RD B/T 25TH AV & FLUSHING RIVER,",cpd11-20qn.pdf
SE-810,"STORM & SAN SWR, WILLET PT BLVD WHITESTONE AREA PHASE 2",850,DEPT OF DESIGN & CONSTRUCTION,PROGRAMMATIC REPLACEMENT AND RECONSTRUCTION,407,QUEENS,WM-0001 SE-0002Q SE-0944 SE-0200Q,13279,81984,1333,4891,0,0,0,0,88208,81984,1333,4891,0,0,0,0,88208,163968,2666,9782,0,0,0,0,176416,PROJECT DELAYED DUE TO UNFORESEEN SITE/FIELD CONDITION,,"WHITESTONE AREA PHASE 2 STORM & SAN SWR, WILLET PT BLVD (25TH AVENUE)BETWEEN 149TH",cpd11-20qn.pdf
SE-811,"STORM & SAN SWR, N.B. WHITESTONE EXPWY SERV RD PHASE 3",850,DEPT OF DESIGN & CONSTRUCTION,PROGRAMMATIC REPLACEMENT AND RECONSTRUCTION,407,QUEENS,EP-0007 HW-0001Q HW-0200 SE-1000 SE-0200Q SE-0002Q SE-0944 TF-0002 TF-0502,11333,2218,63923,0,0,0,0,0,66141,2218,63923,0,0,0,0,0,66141,4436,127846,0,0,0,0,0,132282,PROJECT DELAYED DUE TO BUDGETARY CONSTRAINTS,,"WHITESTONE AREA PHASE 3, STORM & SAN SWR, N.B. WHITESTONE EXPWY SERV RD BETWEEN 15TH",cpd11-20qn.pdf
SE-823,"SEQ - 229th Street Laurelton Area - Part 1, Phase A (HWQ823)",850,DEPT OF DESIGN & CONSTRUCTION,REPLACEMENT OR AUGMENTATION OF EXISTING SYSTEMS,413,QUEENS,SE-0200Q SE-0002Q,19793,84368,396,0,0,0,0,0,84764,84368,396,0,0,0,0,0,84764,168736,792,0,0,0,0,0,169528,PROJECT DELAYED DUE TO BUDGETARY CONSTRAINTS,,"HI LEVEL STRM & COMB SWRS IN 229 ST, BTW 145 & 147 AVES. SE QUEENS LAURELTON AREA",cpd11-20qn.pdf
SE-824,"SEQ - 230th Place Laurelton Area - Part 1, Phase B",850,DEPT OF DESIGN & CONSTRUCTION,REPLACEMENT OR AUGMENTATION OF EXISTING SYSTEMS,413,QUEENS,SE-0200Q SE-0002Q WM-0001,105667,1320,0,0,0,0,0,121155,122475,1320,0,0,0,0,0,121155,122475,2640,0,0,0,0,0,242310,244950,PROJECT DELAYED DUE TO UNFORESEEN SITE/FIELD CONDITION,,"SOUTH-EAST QUEENS LAURELTON AREA PART 1 PHASE B. STORM, SANITARY AND COMBINES SEWERS",cpd11-20qn.pdf
SE-825,"SEQ - Laurelton Area - Part 1, Phase C",850,DEPT OF DESIGN & CONSTRUCTION,REPLACEMENT OR AUGMENTATION OF EXISTING SYSTEMS,413,QUEENS,SE-0200Q SE-0002Q WM-0001,74335,300,0,0,0,0,0,112857,113157,300,0,0,0,0,0,112857,113157,600,0,0,0,0,0,225714,226314,PROJECT DELAYED DUE TO BUDGETARY CONSTRAINTS,,"SOUTH-EAST QUEENS LAURELTON AREA PART 1 PHASE C. STORM, SANITARY AND COMBINED SEWERS",cpd11-20qn.pdf
SE-829,"NDF -- Storm and Sanitary Sewers in Brundwick Ave, Queens",850,DEPT OF DESIGN & CONSTRUCTION,REPLACEMENT OR AUGMENTATION OF EXISTING SYSTEMS,414,QUEENS,SE-0200Q SE-0002Q WM-0001,20701,0,0,0,0,0,30865,0,30865,0,0,0,0,0,30865,0,30865,0,0,0,0,0,61730,0,61730,PROJECT DELAYED DUE TO BUDGETARY CONSTRAINTS,,STORM AND SANIRTATY SEWERS IN BRUNDWICK AVE BETWEEN DOUGHTY BLVD. AND NAMEOKE AVE.,cpd11-20qn.pdf
SE-842A,"SEQ - Storm, Sanitary Sewers & WM in 225th Street",850,DEPT OF DESIGN & CONSTRUCTION,REPLACEMENT OF CHRONICALLY FAILING COMPONENTS,413,QUEENS,SE-0200Q SE-0002Q WM-0001,58431,1140,0,0,0,0,0,65477,66617,1140,0,0,0,0,0,65477,66617,2280,0,0,0,0,0,130954,133234,PROJECT DELAYED DUE TO UNFORESEEN SITE/FIELD CONDITION,,"STRM, SAN SWERS & WM 225ST & B/T 145RD & 149AVE QNS",cpd11-20qn.pdf
SE-842A1,SEQ - Storm Sewer Outlet in 224th Street,850,DEPT OF DESIGN & CONSTRUCTION,REPLACEMENT OR AUGMENTATION OF EXISTING SYSTEMS,413,QUEENS,SE-0200Q EP-0007,95416,4102,579,93138,0,0,0,0,97819,4102,579,93138,0,0,0,0,97819,8204,1158,186276,0,0,0,0,195638,PROJECT DELAYED DUE TO UNFORESEEN SITE/FIELD CONDITION,,STORM SEWER OUTLET IN 224TH STREET BETWEEN 149TH AVE AND A POINT APPROXIMATELY 200 FEET,cpd11-20qn.pdf
SE-842B,SEQ - Storm & Sanitary Sewers & WM Work in 224th Street,850,DEPT OF DESIGN & CONSTRUCTION,AUGMENTATION OF WATER SUPPLY SYSTEMS,413,QUEENS,SE-0200Q SE-0002Q WM-0001,35618,282,0,0,0,0,0,57107,57389,282,0,0,0,0,0,57107,57389,564,0,0,0,0,0,114214,114778,PROJECT DELAYED DUE TO UNFORESEEN SITE/FIELD CONDITION,,STORM & SANITARY & W/M WORK IN 224TH STREET B/W 146TH AVENUE AND SOUTH CONDUIT AVENUE,cpd11-20qn.pdf
SE-850,"SEQ - Storm & Sani Sewers, Force Main & WM in Liverpool St.",850,DEPT OF DESIGN & CONSTRUCTION,REPLACEMENT OR AUGMENTATION OF EXISTING SYSTEMS,412,QUEENS,SE-0002Q SE-0200Q WM-0001,79001,125,0,0,0,0,0,41673,41798,125,0,0,0,0,0,41673,41798,250,0,0,0,0,0,83346,83596,PROJECT DELAYED DUE TO CHANGES IN SCOPE/DESIGN,,"STRM, SAN SWRS, FORCE MAIN AND WM IN LIVERPOOL ST. B/T SHORE AVE AND 119 AVE",cpd11-20qn.pdf
SE-859,"Combined Sewer Replmnt & WM work 70 st & calamus ave, Qns",850,DEPT OF DESIGN & CONSTRUCTION,REPLACEMENT OF CHRONICALLY FAILING COMPONENTS,402,QUEENS,HW-0200 SE-1000 TF-0002 TF-0502 SE-0002Q,32854,112557,164,0,0,0,0,0,112721,112557,164,0,0,0,0,0,112721,225114,328,0,0,0,0,0,225442,,,"OMBINED SEWER REPLACEMENT & WATER MAIN WORK 70TH ST & CALAMUS AVE, QNS",cpd11-20qn.pdf
SE-860,"Combined Swr Replac & WM work 71st, QNS",850,DEPT OF DESIGN & CONSTRUCTION,REPLACEMENT OF CHRONICALLY FAILING COMPONENTS,402,QUEENS,SE-0002Q HW-0200 WM-0001 EP-0007 TF-0002 TF-0502,59467,1627,8,7,56048,0,0,0,57690,1627,8,7,56048,0,0,0,57690,3254,16,14,112096,0,0,0,115380,,,"COMBINED SEWER REPLACEMENT & WATER MAIN WORK 71ST & JUNIPER VALLEY BLVD, QNS",cpd11-20qn.pdf
SE-862,SEQ - Storm & Sanitary Sewer Replcmnt/Ext. 146 Ave (HWQ662G),850,DEPT OF DESIGN & CONSTRUCTION,REPLACEMENT OR AUGMENTATION OF EXISTING SYSTEMS,413,QUEENS,SE-0200Q WM-0001 SE-0002Q WM-0006,80778,2097,0,0,0,98,0,84057,86252,2097,0,0,0,98,0,84057,86252,4194,0,0,0,196,0,168114,172504,PROJECT DELAYED DUE TO UNFORESEEN SITE/FIELD CONDITION,,STORM AND SANITARY SEWER REPLACEMENT AND EXTENSIONS AND WM WORK IN 146TH AVE,cpd11-20qn.pdf
SE-885,SEQ - 150th St Spine,850,DEPT OF DESIGN & CONSTRUCTION,REPLACEMENT OR AUGMENTATION OF EXISTING SYSTEMS,413,QUEENS,SE-0200Q,50976,1111,0,0,0,49380,0,0,50491,1111,0,0,0,49380,0,0,50491,2222,0,0,0,98760,0,0,100982,PROJECT DELAYED DUE TO UNFORESEEN SITE/FIELD CONDITION,,NEW STORM SEWER OUTLET AT BERGEN BASIN,cpd11-20qn.pdf
SE-885A,SEQ - 150th St Spine,850,DEPT OF DESIGN & CONSTRUCTION,REPLACEMENT OR AUGMENTATION OF EXISTING SYSTEMS,412 413,QUEENS,SE-0200Q,3940,8221,100000,0,0,0,0,99864,208085,8221,100000,0,0,0,0,99864,208085,16442,200000,0,0,0,0,199728,416170,PROJECT DELAYED DUE TO UNFORESEEN SITE/FIELD CONDITION,,"TRUNK STORM SEWER 150TH STREET SPINE THAT GOES THROUGH JFK, QUEENS",cpd11-20qn.pdf
SE-886,"NDF -- Storm & Sanitary Sewers in Beach Channel Drive, Qns",850,DEPT OF DESIGN & CONSTRUCTION,EXTENSIONS TO ACCOMMODATE NEW DEVELOPMENT,414,QUEENS,SE-0200Q SE-0002Q WM-0001,12883,148,0,0,12883,0,0,0,13031,148,0,0,12883,0,0,0,13031,296,0,0,25766,0,0,0,26062,PROJECT DELAYED DUE TO UNFORESEEN SITE/FIELD CONDITION,,"STORM & SANITARY SEWERS, WM WORK, ETC IN BEACH CHANNEL DR BETWEEN REGINA AVE &",cpd11-20qn.pdf
SE-887,"NDF -- Storm & Sanitary Sewers, WM work in Cornaga Ave, Qns",850,DEPT OF DESIGN & CONSTRUCTION,REPLACEMENT OR AUGMENTATION OF EXISTING SYSTEMS,414,QUEENS,SE-0200Q SE-0002Q WM-0001,25148,629,0,0,0,0,0,25148,25777,629,0,0,0,0,0,25148,25777,1258,0,0,0,0,0,50296,51554,PROJECT DELAYED DUE TO UNFORESEEN SITE/FIELD CONDITION,,"STORM & SANITARY SEWERS, WM WORK IN CORNAGA AVE BETWEEN MOTT AVE & BEACH CHANNEL",cpd11-20qn.pdf
SE-889,SEQ - New Storm Sewer N. Conduit Ave,850,DEPT OF DESIGN & CONSTRUCTION,REPLACEMENT OR AUGMENTATION OF EXISTING SYSTEMS,412,QUEENS,SE-0200Q SE-0002Q WM-0001 WM-0006,112349,568,0,0,0,0,112142,0,112710,568,0,0,0,0,112142,0,112710,1136,0,0,0,0,224284,0,225420,PROJECT DELAYED DUE TO UNFORESEEN SITE/FIELD CONDITION,,NEW STRM SWR N. CONDUIT AV -BAISLY BLVD S TO GUY BREWER BLVD,cpd11-20qn.pdf
SEQ002539,SEQ - Storm & Sanitary Sewers in 111th Ave (HWQ002539),850,DEPT OF DESIGN & CONSTRUCTION,REPLACEMENT OR AUGMENTATION OF EXISTING SYSTEMS,413,QUEENS,SE-0005,25689,23305,0,3736,0,0,0,0,27041,23305,0,3736,0,0,0,0,27041,46610,0,7472,0,0,0,0,54082,PROJECT DELAYED DUE TO BUDGETARY CONSTRAINTS,,STORM AND SANITARY SEWERS IN 111TH AVE BETWEEN COLFAX ST AND 204TH ST; ETC.,cpd11-20qn.pdf
SEQ002583,SANITARY SEWERS IN B 54 ST - ALMEDA AV & B CHANNEL DR,850,DEPT OF DESIGN & CONSTRUCTION,REPLACEMENT OF CHRONICALLY FAILING COMPONENTS,414,QUEENS,SE-0002Q WM-0001,436,0,0,0,0,0,0,436,436,0,0,0,0,0,0,436,436,0,0,0,0,0,0,872,872,PROJECT DELAYED DUE TO CHANGES IN SCOPE/DESIGN,SANITARY SEWERS IN B 54 ST - ALMEDA AV & B CHANNEL DR,SANITARY SEWERS IN B 54 ST - ALMEDA AV & B CHANNEL DR,cpd11-20qn.pdf
SEQ002693,Combined Sewer and Water Main Replacements at Penelope Ave.,850,DEPT OF DESIGN & CONSTRUCTION,REPLACEMENT OR AUGMENTATION OF EXISTING SYSTEMS,405,QUEENS,SE-0002Q SE-1000,8838,36100,1287,0,0,0,0,0,37387,36100,1287,0,0,0,0,0,37387,72200,2574,0,0,0,0,0,74774,PROJECT DELAYED DUE TO UNFORESEEN SITE/FIELD CONDITION,,COMBINED SEWER AND WATERMAIN REPLACEMENTS AT PENELOPE AVE. B/T 71STREET AND 74TH,cpd11-20qn.pdf
SEQ002700,REHABILITATION OF COMBINED SEWER AND WATER MAIN,850,DEPT OF DESIGN & CONSTRUCTION,REPLACEMENT OR AUGMENTATION OF EXISTING SYSTEMS,405,QUEENS,SE-0002Q WM-0001,4893,40,0,0,0,5382,0,0,5422,40,0,0,0,5382,0,0,5422,80,0,0,0,10764,0,0,10844,PROJECT DELAYED DUE TO CHANGES IN SCOPE/DESIGN,,REHABILITATION OF COMBINED SEWER AND WATER MAIN IN 73RD PLACE AREA INMIDDLE VILLAGE,cpd11-20qn.pdf
SEQ002709,Combined Sewer Installation in 45th Avenue,850,DEPT OF DESIGN & CONSTRUCTION,REPLACEMENT OR AUGMENTATION OF EXISTING SYSTEMS,407,QUEENS,SE-0002Q,1350,3077,986,0,0,0,0,0,4063,3077,986,0,0,0,0,0,4063,6154,1972,0,0,0,0,0,8126,,,"COMBINED SEWER INSTALLATION IN 45TH AVENUE BETWEEN 163RD STREET AND 166ST, ETC,",cpd11-20qn.pdf
SEQ002710,Combined sewer replcmnt & water main work in Selfridge St.,850,DEPT OF DESIGN & CONSTRUCTION,REPLACEMENT OF CHRONICALLY FAILING COMPONENTS,406,QUEENS,SE-0002Q WM-0001,6391,580,0,0,5811,0,0,0,6391,580,0,0,5811,0,0,0,6391,1160,0,0,11622,0,0,0,12782,PROJECT DELAYED DUE TO UNFORESEEN SITE/FIELD CONDITION,,COMBINED SEWER REPLCMNT & WATER MAIN WORK IN SELFRIDGE ST. BET METROPOLITAN AVE &,cpd11-20qn.pdf
SEQ002711,Combilned Sewer in Main Street betwwen 40th Road and 41 St.,850,DEPT OF DESIGN & CONSTRUCTION,REPLACEMENT OR AUGMENTATION OF EXISTING SYSTEMS,407,QUEENS,SE-0002Q,278,0,278,0,0,0,0,0,278,0,278,0,0,0,0,0,278,0,556,0,0,0,0,0,556,,,"COMBILNED SEWER IN MAIN STREET BETWWEN 40TH ROAD AND 41 ST., QUEENS.",cpd11-20qn.pdf
SEQ200426,STORM SEWERS IN B 54 ST - ALMEDA AV & B CHANNEL DR,850,DEPT OF DESIGN & CONSTRUCTION,REPLACEMENT OF CHRONICALLY FAILING COMPONENTS,414,QUEENS,SE-0200Q,101,0,0,101,0,0,0,0,101,0,0,101,0,0,0,0,101,0,0,202,0,0,0,0,202,PROJECT DELAYED DUE TO CHANGES IN SCOPE/DESIGN,STORM SEWERS IN B 54 ST - ALMEDA AV & B CHANNEL DR,STORM SEWERS IN B 54 ST - ALMEDA AV & B CHANNEL DR,cpd11-20qn.pdf
SEQ200463,Storm & San Sewers in College point b/t 9 av & US Bulkhead,850,DEPT OF DESIGN & CONSTRUCTION,REPLACEMENT OR AUGMENTATION OF EXISTING SYSTEMS,407,QUEENS,SE-0004 WM-0001,4511,20442,350,0,0,0,0,0,20792,20442,350,0,0,0,0,0,20792,40884,700,0,0,0,0,0,41584,PROJECT DELAYED DUE TO UNFORESEEN SITE/FIELD CONDITION,,STORM & SAN SEWERS IN COLLEGE POINT B/T 9 AV & US BULKHEAD,cpd11-20qn.pdf
SEQ200467,STRM & SAN SWRS IN 14 AV B/T 115 ST & US BULKHEAD LINE,850,DEPT OF DESIGN & CONSTRUCTION,REPLACEMENT OR AUGMENTATION OF EXISTING SYSTEMS,407,QUEENS,SE-0004 SE-0002Q WM-0001,7417,90,0,0,0,8158,0,0,8248,90,0,0,0,8158,0,0,8248,180,0,0,0,16316,0,0,16496,PROJECT DELAYED DUE TO BUDGETARY CONSTRAINTS,,STRM & SAN SWRS IN 14 AV B/T 115 ST & US BULKHEAD LINE,cpd11-20qn.pdf
SEQ200489,"STRM SWR & W/M IN 202 ST B/T 118 AV & LINDEN BLVD, ETC...",850,DEPT OF DESIGN & CONSTRUCTION,EXTENSIONS TO ACCOMMODATE NEW DEVELOPMENT,412,QUEENS,SE-0200Q SE-0002Q WM-0001 EP-0007,2535,7803,691,0,0,0,0,0,8494,7803,691,0,0,0,0,0,8494,15606,1382,0,0,0,0,0,16988,PROJECT DELAYED DUE TO BUDGETARY CONSTRAINTS,,"STRM SWR & W/M IN 202 ST B/T 118 AV & LINDEN BLVD, FRANCIS LEWIS BLVD B/T 115 DR & LINDEN",cpd11-20qn.pdf
SEQ200490,"Storm Sewer in 95th Street, Queens",850,DEPT OF DESIGN & CONSTRUCTION,EXTENSIONS TO ACCOMMODATE NEW DEVELOPMENT,410,QUEENS,SE-0200Q,1202,15605,656,0,0,0,0,0,16261,15605,656,0,0,0,0,0,16261,31210,1312,0,0,0,0,0,32522,PROJECT DELAYED DUE TO UNFORESEEN SITE/FIELD CONDITION,,"STRM SWR IN 95TH STREET B/T 160TH AVENUE & 162ND AVENUE, ETC",cpd11-20qn.pdf
SEQ200491,"STRM EXT IN FERN PLACE B/T POLHEMUS AV & 108 RD, ETC....",850,DEPT OF DESIGN & CONSTRUCTION,EXTENSIONS TO ACCOMMODATE NEW DEVELOPMENT,412,QUEENS,SE-0200Q SE-0002Q WM-0001 EP-0007 HW-0200 TF-0502,2737,5324,523,0,0,0,0,0,5847,5324,523,0,0,0,0,0,5847,10648,1046,0,0,0,0,0,11694,PROJECT DELAYED DUE TO UNFORESEEN SITE/FIELD CONDITION,,"STRM EXT IN FERN PLACE B/T POLHEMUS AV & 108 RD, ETC....",cpd11-20qn.pdf
SEQ200492,"Storm sewer extension and san. replacement @ 41st avenue,",850,DEPT OF DESIGN & CONSTRUCTION,REPLACEMENT OR AUGMENTATION OF EXISTING SYSTEMS,411 407,QUEENS,SE-0200Q,3685,9960,273,0,0,0,0,0,10233,9960,273,0,0,0,0,0,10233,19920,546,0,0,0,0,0,20466,,,"STORM SEWER EXTENSION AND SAN. REPLACEMENT @ 41ST AVENUE, BET 233RD ST AND 235TH ST. ,",cpd11-20qn.pdf
SEQ200506,"STORM, SANITARY SEWERS AND WATER MAIN IN 93 AVENUE",850,DEPT OF DESIGN & CONSTRUCTION,REPLACEMENT OR AUGMENTATION OF EXISTING SYSTEMS,412,QUEENS,HW-0200 SE-0200Q,1812,3278,63,0,0,0,0,0,3341,3278,63,0,0,0,0,0,3341,6556,126,0,0,0,0,0,6682,PROJECT DELAYED DUE TO UNFORESEEN SITE/FIELD CONDITION,,"STORM, SANITARY SEWERS AND WATER MAIN IN 93 AVENUE BETWEEN 199 STREETAND 201 STREET;",cpd11-20qn.pdf
SEQ200519,SEQ - Brookville-Edgewood Triangle West - Phase II (HWQ724B),850,DEPT OF DESIGN & CONSTRUCTION,EXTENSIONS TO ACCOMMODATE NEW DEVELOPMENT,413,QUEENS,SE-0200Q WM-0001 SE-0002Q SE-0005,10475,2305,17,0,59087,0,0,0,61409,2305,17,0,59087,0,0,0,61409,4610,34,0,118174,0,0,0,122818,PROJECT DELAYED DUE TO UNFORESEEN SITE/FIELD CONDITION,,"BROOKVILLE- EDGEWOOD TRIANGLE, WEST (HWQ-724B PAHSE II) STORM AND SANITARY SEWERS IN",cpd11-20qn.pdf
SEQ200524,"Storm & Sanitary Sewers in B. 21st Street, Queens",850,DEPT OF DESIGN & CONSTRUCTION,PROGRAMMATIC REPLACEMENT AND RECONSTRUCTION,414,QUEENS,SE-0200Q SE-0002Q WM-0001,6816,22586,1463,162,0,0,0,0,24211,22586,1463,162,0,0,0,0,24211,45172,2926,324,0,0,0,0,48422,PROJECT DELAYED DUE TO UNFORESEEN SITE/FIELD CONDITION,,STRM & SAN SWR IN B. 21 ST B/T NEW HAVEN AV & ELK COURTS,cpd11-20qn.pdf
SEQ200529,SEQ - Storm & Combined Sewers in 130th Road (Joint Bid),850,DEPT OF DESIGN & CONSTRUCTION,EXTENSIONS TO ACCOMMODATE NEW DEVELOPMENT,413,QUEENS,SE-0004 HW-0001Q SE-0944 SE-0002Q,4033,17745,1409,1004,0,0,0,0,20158,17745,1409,1004,0,0,0,0,20158,35490,2818,2008,0,0,0,0,40316,PROJECT DELAYED DUE TO BUDGETARY CONSTRAINTS,,STORM & COMB SWRS IN 130TH RD B/T 244 ST & BROOKLVILLE BLVD,cpd11-20qn.pdf
SEQ200531,"SEQ - Storm Sewer Ext in 239th Street, Queens (Joint Bid)",850,DEPT OF DESIGN & CONSTRUCTION,EXTENSIONS TO ACCOMMODATE NEW DEVELOPMENT,413,QUEENS,SE-0200Q SE-0944,8048,11777,3,2252,0,0,0,0,14032,11777,3,2252,0,0,0,0,14032,23554,6,4504,0,0,0,0,28064,PROJECT DELAYED DUE TO BUDGETARY CONSTRAINTS,,STORM SEWER EXT @ 239 ST B/T 87 AV AND 88 AV,cpd11-20qn.pdf
SEQ200536,SEQ - Storm Sewer & Water Main in 182nd Street,850,DEPT OF DESIGN & CONSTRUCTION,REPLACEMENT OF CHRONICALLY FAILING COMPONENTS,412,QUEENS,SE-0200Q WM-0001 SE-1000 HW-0200,1025,3106,1562,0,0,0,0,0,4668,3106,1562,0,0,0,0,0,4668,6212,3124,0,0,0,0,0,9336,PROJECT DELAYED DUE TO UNFORESEEN SITE/FIELD CONDITION,,STORM SEWER AND WATER MAIN IN 182ND STREET BETW. HILLSIDE AVE AND 90TH AVE.,cpd11-20qn.pdf
SEQ200547,SEQ - Storm Sewer in Commonwealth Blvd,850,DEPT OF DESIGN & CONSTRUCTION,REPLACEMENT OR AUGMENTATION OF EXISTING SYSTEMS,413,QUEENS,SE-0200Q WM-0001,5590,154,0,0,0,0,0,9254,9408,154,0,0,0,0,0,9254,9408,308,0,0,0,0,0,18508,18816,PROJECT DELAYED DUE TO UNFORESEEN SITE/FIELD CONDITION,,STORM SEWER IN,cpd11-20qn.pdf
SEQ200553,Combined & HLSS & WM Work in Lefferts Blvd,850,DEPT OF DESIGN & CONSTRUCTION,REPLACEMENT OF CHRONICALLY FAILING COMPONENTS,408 409,QUEENS,HW-0200 SE-0004,4105,2153,4,0,922,0,0,0,3079,2153,4,0,922,0,0,0,3079,4306,8,0,1844,0,0,0,6158,,,1.COMB.&HIGH LEVEL STORM SEWER & WM WORK IN LEFFERTS BLVD. BETWEEN METROPOLITAN AVE,cpd11-20qn.pdf
SEQ200558,Install of storm SE & replacement of sanitary SE & dist.WM,850,DEPT OF DESIGN & CONSTRUCTION,REPLACEMENT OR AUGMENTATION OF EXISTING SYSTEMS,400,QUEENS,SE-0200Q SE-0002Q WM-0001,7229,289,268,6283,0,0,0,0,6840,289,268,6283,0,0,0,0,6840,578,536,12566,0,0,0,0,13680,,,INSTALLATION OF STORM SEWERS AND REPLACEMENT OF SANITARY SEWERS AND DISTRIBUTION,cpd11-20qn.pdf
SEQ200562,SEQ - Storm Sewer & WM Work in 158th Street (HWQ121B3),850,DEPT OF DESIGN & CONSTRUCTION,EXTENSIONS TO ACCOMMODATE NEW DEVELOPMENT,412,QUEENS,SE-0200Q SE-1000 WM-0001 SE-0002Q EP-0007,291,300,0,16754,0,0,0,0,17054,300,0,16754,0,0,0,0,17054,600,0,33508,0,0,0,0,34108,PROJECT DELAYED DUE TO UNFORESEEN SITE/FIELD CONDITION,,"STORM EXT, REPLACE & WM WORK, 158 ST B/T 110 & 116 AVE, QNS",cpd11-20qn.pdf
SEQ200569,"Construction of Storm Sewers in 204th Street, Queens.",850,DEPT OF DESIGN & CONSTRUCTION,REPLACEMENT OR AUGMENTATION OF EXISTING SYSTEMS,411,QUEENS,SE-0002Q,784,5758,0,109,0,0,0,0,5867,5758,0,109,0,0,0,0,5867,11516,0,218,0,0,0,0,11734,,,"CONSTRUCTION OF STORM SEWERS IN 204TH STREET, QUEENS.",cpd11-20qn.pdf
SEQ200578,"SEQ - Storm & San Sewers, WM Work in Foch Blvd (HWQ200578)",850,DEPT OF DESIGN & CONSTRUCTION,REPLACEMENT OR AUGMENTATION OF EXISTING SYSTEMS,412,QUEENS,SE-0200Q,12935,20288,720,0,0,0,0,0,21008,20288,720,0,0,0,0,0,21008,40576,1440,0,0,0,0,0,42016,PROJECT DELAYED DUE TO UNFORESEEN SITE/FIELD CONDITION,,1-STORM & SANITARY SEWERS & WM IN FOCH BLVD B/T MERRICK BLVD. & 166THST. 2-STORM SEWER,cpd11-20qn.pdf
SEQ200584,SEQ-Storm and Sanitary Sewers in 119th Road,850,DEPT OF DESIGN & CONSTRUCTION,EXTENSIONS TO ACCOMMODATE NEW DEVELOPMENT,412,QUEENS,SE-0200Q SE-0002Q WM-0001,7345,13977,439,0,0,0,0,0,14416,13977,439,0,0,0,0,0,14416,27954,878,0,0,0,0,0,28832,PROJECT DELAYED DUE TO UNFORESEEN SITE/FIELD CONDITION,,"STORM AND SANTITARY SEWERS IN 119TH ROAD BETWEEN 180TH STREET AND 177TH PLACE, ETC.",cpd11-20qn.pdf
SEQ200586,Broad Channel,850,DEPT OF DESIGN & CONSTRUCTION,EXTENSIONS TO ACCOMMODATE NEW DEVELOPMENT,414,QUEENS,SE-0200Q SE-0002Q WM-0001,25000,38758,13404,0,0,0,0,0,52162,38758,13404,0,0,0,0,0,52162,77516,26808,0,0,0,0,0,104324,PROJECT DELAYED DUE TO UNFORESEEN SITE/FIELD CONDITION,,BROAD CHANNEL,cpd11-20qn.pdf
SEQ200595,"Westbourne Ave-Norton Drive Recon (HWQ1187, SAND1187)",850,DEPT OF DESIGN & CONSTRUCTION,REPLACEMENT OR AUGMENTATION OF EXISTING SYSTEMS,414,QUEENS,WM-0001 SE-0200Q,16200,0,0,0,0,0,116,16084,16200,0,0,0,0,0,116,16084,16200,0,0,0,0,0,232,32168,32400,PROJECT DELAYED DUE TO UNFORESEEN SITE/FIELD CONDITION,,INSTALLATION AND REPLACEMENT OF STORM SEWERS ALONG NORTON DRIVE BETWEEN COLDSPRING,cpd11-20qn.pdf
SEQ200596,SEQ - Storm Sewer Installation & WM in 183rd Street,850,DEPT OF DESIGN & CONSTRUCTION,REPLACEMENT OR AUGMENTATION OF EXISTING SYSTEMS,412,QUEENS,HW-0200 SE-0200Q SE-0002Q WM-0001,9494,11728,979,894,0,0,0,0,13601,11728,979,894,0,0,0,0,13601,23456,1958,1788,0,0,0,0,27202,PROJECT DELAYED DUE TO BUDGETARY CONSTRAINTS,,"STORM SEWER & WATER MAIN REPLACEMENT IN 183 ST B/T 90TH & JAMAICA AVENUE, QUEENS",cpd11-20qn.pdf
SEQ201BN9,"Reconstruction of Existing Sewers, North Queens",850,DEPT OF DESIGN & CONSTRUCTION,REPLACEMENT OF CHRONICALLY FAILING COMPONENTS,400,QUEENS,SE-0002Q EP-0007,6700,17770,1791,0,0,0,0,0,19561,17770,1791,0,0,0,0,0,19561,35540,3582,0,0,0,0,0,39122,PROJECT DELAYED DUE TO UNFORESEEN SITE/FIELD CONDITION,,"RECONSTRUCTION OF EXISTING SEWERS, NORTH QUEENS",cpd11-20qn.pdf
SEQBS11,"Reconstruction of Existing Sewers, South Queens",850,DEPT OF DESIGN & CONSTRUCTION,REPLACEMENT OR AUGMENTATION OF EXISTING SYSTEMS,400,QUEENS,SE-0002Q EP-0007,8550,75,9756,0,0,0,0,0,9831,75,9756,0,0,0,0,0,9831,150,19512,0,0,0,0,0,19662,,,"RECONSTRUCTION OF EXISTING SEWERS, SOUTH QUEENS",cpd11-20qn.pdf
SEQNS001,SEQ - Sewer When & Where Contract in SE Queens,850,DEPT OF DESIGN & CONSTRUCTION,REPLACEMENT OR AUGMENTATION OF EXISTING SYSTEMS,412 413,QUEENS,SE-0002Q WM-0001 SE-1000 SE-0200Q,27500,38752,141,0,0,0,0,0,38893,38752,141,0,0,0,0,0,38893,77504,282,0,0,0,0,0,77786,PROJECT DELAYED DUE TO UNFORESEEN SITE/FIELD CONDITION,,"SEWER WHEN &NWHERE CONTRACT IN SE QUEENS TO INCLUDE, STORM , SANITARYAND COMBIND",cpd11-20qn.pdf
SEQNS002,SEQ - Sewer When & Where Contract in SE Queens,850,DEPT OF DESIGN & CONSTRUCTION,REPLACEMENT OR AUGMENTATION OF EXISTING SYSTEMS,400,QUEENS,SE-0200Q,25570,12965,151,0,0,0,0,0,13116,12965,151,0,0,0,0,0,13116,25930,302,0,0,0,0,0,26232,PROJECT DELAYED DUE TO BUDGETARY CONSTRAINTS,,"STORM, SANITARY,COMBINED SEWERS, WATER MAIN WORK, BORNING, SURGEY, GEOTECHNICAL",cpd11-20qn.pdf
SEQNS003,SEQ - Sewer When & Where Contract in SE Queens (HWQ1195),850,DEPT OF DESIGN & CONSTRUCTION,REPLACEMENT OR AUGMENTATION OF EXISTING SYSTEMS,412 413,QUEENS,SE-0200Q SE-0002Q SE-0005 WM-0001,28900,2268,0,0,0,0,0,28900,31168,2268,0,0,0,0,0,28900,31168,4536,0,0,0,0,0,57800,62336,PROJECT DELAYED DUE TO CHANGES IN SCOPE/DESIGN,,"STORM, SANITARY,COMBINED SEWERS, WATER MAIN WORK, BORNING, SURGEY, GEOTECHNICAL",cpd11-20qn.pdf
SEQNS004,SEQ -SEWER WHEN & WHERE CONTRACT IN S.E. QNS,850,DEPT OF DESIGN & CONSTRUCTION,REPLACEMENT OR AUGMENTATION OF EXISTING SYSTEMS,412 413,QUEENS,SE-0200Q SE-0002Q WM-0001 SE-0005 SE-1000 SE-0944,25000,800,0,0,0,24487,0,0,25287,800,0,0,0,24487,0,0,25287,1600,0,0,0,48974,0,0,50574,PROJECT DELAYED DUE TO UNFORESEEN SITE/FIELD CONDITION,,"STORM SEWERS ANSD ADDTIONAL WORK AS NEEDED, SE QUEENS.",cpd11-20qn.pdf
SEQNS005,SEQ - Sewer When & Where Contract in SE Queens,850,DEPT OF DESIGN & CONSTRUCTION,REPLACEMENT OR AUGMENTATION OF EXISTING SYSTEMS,412 413,QUEENS,SE-0200Q SE-0002Q WM-0001,25000,1400,0,0,0,0,0,25000,26400,1400,0,0,0,0,0,25000,26400,2800,0,0,0,0,0,50000,52800,PROJECT DELAYED DUE TO UNFORESEEN SITE/FIELD CONDITION,,"STORM SEWERS ANSD ADDTIONAL WORK AS NEEDED, SE QUEENS.",cpd11-20qn.pdf
SEQNS006,SEQ - Neighborhood Storm Sewer Extensions,850,DEPT OF DESIGN & CONSTRUCTION,REPLACEMENT OR AUGMENTATION OF EXISTING SYSTEMS,412 413,QUEENS,SE-0005,24932,0,0,0,0,0,0,3250,3250,0,0,0,0,0,0,3250,3250,0,0,0,0,0,0,6500,6500,PROJECT DELAYED DUE TO UNFORESEEN SITE/FIELD CONDITION,,"STORM, SANITARY,COMBINED SEWERS, WATER MAIN WORK SE QUEENS",cpd11-20qn.pdf
SEQPGRD1,Southeast Queens Priority Grids -- Group 1 (DOTSEQ01),850,DEPT OF DESIGN & CONSTRUCTION,PRIMARY STREET RECONSTRUCTION,400,QUEENS,HW-0001Q,18154,1614,0,1291,0,0,18387,0,21292,1614,0,1291,0,0,18387,0,21292,3228,0,2582,0,0,36774,0,42584,PROJECT DELAYED DUE TO UNFORESEEN SITE/FIELD CONDITION,,SOUTHEAST QUEENS PRIORITY GRIDS 01-10,cpd11-20qn.pdf
SEQPGRD2,Southeast Queens Priority Grids -- Group 2 (DOTSEQ02),850,DEPT OF DESIGN & CONSTRUCTION,PRIMARY STREET RECONSTRUCTION,400,QUEENS,HW-0001Q,12837,1390,0,0,0,1972,28316,0,31678,1390,0,0,0,1972,28316,0,31678,2780,0,0,0,3944,56632,0,63356,PROJECT DELAYED DUE TO BUDGETARY CONSTRAINTS,,SOUTHEAST QUEENS PRIORITY GRIDS 11-20,cpd11-20qn.pdf
TF18-2012,"QUEENSBORO HALL MUNICIPAL PARKING GARAGE, QUEENS",850,DEPT OF DESIGN & CONSTRUCTION,"Parking Meters, Lots, and Garages",400 409,QUEENS,TF-0018,2710,16688,80,0,0,0,0,0,16768,16688,80,0,0,0,0,0,16768,33376,160,0,0,0,0,0,33536,PROJECT DELAYED DUE TO BUDGETARY CONSTRAINTS,,QUEENSBORO HALL MUNICIPAL PARKING GARAGE,cpd11-20qn.pdf
TLCWOOD,TLC - NEW OFFICE FACILITY - 24-55 BQE WEST,850,DEPT OF DESIGN & CONSTRUCTION,RENOVATION OF OTHER CITY-OWNED FACILITIES,401,QUEENS,PW-0077 PU-0025 WP-0169,36000,9453,134554,3456,0,0,0,0,147463,9453,134554,3456,0,0,0,0,147463,18906,269108,6912,0,0,0,0,294926,PROJECT DELAYED DUE TO CHANGES IN SCOPE/DESIGN,,NEW FACILITY,cpd11-20qn.pdf
ACEHHC902,HHC - -Energy Upgrades at Queens Hospital N Building,856,DEPT OF CITYWIDE ADMIN SERVS,"BUILDING CONSTRUCTION, RECONSTRUCTION OR RETROFIT",401,QUEENS,PU-0025,2783,0,2783,0,0,0,0,0,2783,0,2783,0,0,0,0,0,2783,0,5566,0,0,0,0,0,5566,,,ENERGY UPGRADES AT QUEENS HOSPITAL N BUILDING,cpd11-20qn.pdf
CO296EV,125-01 QUEENS BLVD.- ELEVATORS,856,DEPT OF CITYWIDE ADMIN SERVS,RECONSTRUCTION/RENOVATION OF COURT FACILITIES,409,QUEENS,CO-0296,25978,0,0,1358,0,0,24120,0,25478,0,0,1358,0,0,24120,0,25478,0,0,2716,0,0,48240,0,50956,,,125-01 QUEENS BLVD.- ELEVATORS,cpd11-20qn.pdf
CO296FA,125-01 QUEENS BLVD.- FIRE ALARMS,856,DEPT OF CITYWIDE ADMIN SERVS,RECONSTRUCTION/RENOVATION OF COURT FACILITIES,409,QUEENS,CO-0296,2989,0,0,350,0,2600,0,0,2950,0,0,350,0,2600,0,0,2950,0,0,700,0,5200,0,0,5900,PROJECT DELAYED DUE TO CHANGES IN SCOPE/DESIGN,,125-01 QUEENS BLVD. - FIRE ALARMS,cpd11-20qn.pdf
CO298CHIL,151-20 JAMAICA AVE.- CHILLER REPLACEMENT,856,DEPT OF CITYWIDE ADMIN SERVS,RECONSTRUCTION/RENOVATION OF COURT FACILITIES,412,QUEENS,CO-0298,1689,0,0,0,0,149,1385,0,1534,0,0,0,0,149,1385,0,1534,0,0,0,0,298,2770,0,3068,,,SQ FT,cpd11-20qn.pdf
CO299CHIL,89-17 SUTPHIN BLVD.- CHILLER REPLACEMENT,856,DEPT OF CITYWIDE ADMIN SERVS,RECONSTRUCTION/RENOVATION OF COURT FACILITIES,412,QUEENS,CO-0299,2694,0,0,0,0,2435,0,0,2435,0,0,0,0,2435,0,0,2435,0,0,0,0,4870,0,0,4870,,,SQ FT,cpd11-20qn.pdf
CO300415A,DASNY - 88-11 SUTPHIN BLVD.- RENOVATION,856,DEPT OF CITYWIDE ADMIN SERVS,CONSTRUCTION OF NEW COURT FACILITIES,412,QUEENS,CO-0300,55978,9364,0,687,0,0,0,0,10051,9364,0,687,0,0,0,0,10051,18728,0,1374,0,0,0,0,20102,PROJECT DELAYED DUE TO CHANGES IN SCOPE/DESIGN,"88-11 SUTPHIN BLVD. QUEENS, NY 11435",INTERIOR RENOVATIONS; ELECTRICAL & HVAC DISTRIBUTION; INITIAL OUTFITTING OF NEWLY,cpd11-20qn.pdf
CO300FIRE,88-11 SUTPHIN BLVD. FIRE ALARM SYSTEM UPGRADE,856,DEPT OF CITYWIDE ADMIN SERVS,RECONSTRUCTION/RENOVATION OF COURT FACILITIES,412,QUEENS,CO-0300,4030,0,0,1116,0,0,14928,0,16044,0,0,1116,0,0,14928,0,16044,0,0,2232,0,0,29856,0,32088,PROJECT DELAYED DUE TO BUDGETARY CONSTRAINTS,,88-11 SUTPHIN BLVD.FIRE ALARM SYSTEM UPGRADE,cpd11-20qn.pdf
CO300RF,88-11 SUTPHIN BOULEVARD - ROOF,856,DEPT OF CITYWIDE ADMIN SERVS,RECONSTRUCTION/RENOVATION OF COURT FACILITIES,412,QUEENS,CO-0300,376,0,0,0,0,31,310,0,341,0,0,0,0,31,310,0,341,0,0,0,0,62,620,0,682,,,88-11 SUTPHIN BOULEVARD - ROOF,cpd11-20qn.pdf
EO26-0069,NYPD - 101st Precinct,856,DEPT OF CITYWIDE ADMIN SERVS,"BUILDING CONSTRUCTION, RECONSTRUCTION OR RETROFIT",401,QUEENS,PU-0025,300,0,0,168,0,0,0,0,168,0,0,168,0,0,0,0,168,0,0,336,0,0,0,0,336,PROJECT DELAYED DUE TO CHANGES IN SCOPE/DESIGN,,101ST PRECINCT,cpd11-20qn.pdf
EO26-0070,NYPD - 106th Precinct,856,DEPT OF CITYWIDE ADMIN SERVS,"BUILDING CONSTRUCTION, RECONSTRUCTION OR RETROFIT",401,QUEENS,PU-0025,300,0,0,300,0,0,0,0,300,0,0,300,0,0,0,0,300,0,0,600,0,0,0,0,600,PROJECT DELAYED DUE TO CHANGES IN SCOPE/DESIGN,,0,cpd11-20qn.pdf
EO26-0071,NYPD - 108TH PRECINCT,856,DEPT OF CITYWIDE ADMIN SERVS,"BUILDING CONSTRUCTION, RECONSTRUCTION OR RETROFIT",401,QUEENS,PU-0025,300,0,0,244,0,0,0,0,244,0,0,244,0,0,0,0,244,0,0,488,0,0,0,0,488,PROJECT DELAYED DUE TO CHANGES IN SCOPE/DESIGN,,IA/SQ,cpd11-20qn.pdf
EO26-0087,DPR - LOST BATTALION HALL RECREATION CENTER,856,DEPT OF CITYWIDE ADMIN SERVS,"BUILDING CONSTRUCTION, RECONSTRUCTION OR RETROFIT",401,QUEENS,PU-0025,400,0,0,400,0,0,0,0,400,0,0,400,0,0,0,0,400,0,0,800,0,0,0,0,800,PROJECT DELAYED DUE TO CHANGES IN SCOPE/DESIGN,,IA/SQ,cpd11-20qn.pdf
EO26-0090,QPL - McGOLDRICK COMMUNITY LIBRARY,856,DEPT OF CITYWIDE ADMIN SERVS,"BUILDING CONSTRUCTION, RECONSTRUCTION OR RETROFIT",401,QUEENS,PU-0025,500,0,0,126,0,0,0,0,126,0,0,126,0,0,0,0,126,0,0,252,0,0,0,0,252,PROJECT DELAYED DUE TO CHANGES IN SCOPE/DESIGN,,IA/SQ,cpd11-20qn.pdf
EO26-0091,QPL - OZONE PARK COMMUNITY LIBRARY,856,DEPT OF CITYWIDE ADMIN SERVS,"BUILDING CONSTRUCTION, RECONSTRUCTION OR RETROFIT",401,QUEENS,PU-0025,500,0,0,500,0,0,0,0,500,0,0,500,0,0,0,0,500,0,0,1000,0,0,0,0,1000,PROJECT DELAYED DUE TO CHANGES IN SCOPE/DESIGN,,IA/SQ,cpd11-20qn.pdf
HL82WAREH,DOHMH - Relocation Warehouse from 540 Kingsland Ave Brooklyn,856,DEPT OF CITYWIDE ADMIN SERVS,CLINIC RENOVATION AND REHABILITATION,,QUEENS,HL-0082,1988,1787,201,0,0,0,0,0,1988,1787,201,0,0,0,0,0,1988,3574,402,0,0,0,0,0,3976,PROJECT DELAYED DUE TO CHANGES IN SCOPE/DESIGN,,"ADDING PROPOSED DESIGN FOR NEW OFFICES, CONFERENCE ROOMS & STORAGE LAYOUT, NEW LED",cpd11-20qn.pdf
HR25QCRT,151-20 Jamaica Ave 4th floor,856,DEPT OF CITYWIDE ADMIN SERVS,SOCIAL SERVICES BUILDINGS,,QUEENS,HR-0025,1921,148,0,787,0,0,0,0,935,148,0,787,0,0,0,0,935,296,0,1574,0,0,0,0,1870,PROJECT DELAYED DUE TO CHANGES IN SCOPE/DESIGN,,,cpd11-20qn.pdf
PO79QTP,NYPD - COLLEGE POINT TOW POUND,856,DEPT OF CITYWIDE ADMIN SERVS,POLICE FACILITIES,400,QUEENS,PO-0079,3670,4368,5897,0,0,0,0,0,10265,4368,5897,0,0,0,0,0,10265,8736,11794,0,0,0,0,0,20530,PROJECT DELAYED DUE TO CHANGES IN SCOPE/DESIGN,,COLLEGE POINT TOW POUND,cpd11-20qn.pdf
PW326DAQ3,DA QUEENS - CYBER CRIME UNIT,856,DEPT OF CITYWIDE ADMIN SERVS,RENOVATION OF LEASED SPACE,407,QUEENS,PW-0326,2676,2247,429,0,0,0,0,0,2676,2247,429,0,0,0,0,0,2676,4494,858,0,0,0,0,0,5352,,,SQFT,cpd11-20qn.pdf
PW326DAQ4,DA QUEENS - SUPREME COURT TRIAL BUREAU,856,DEPT OF CITYWIDE ADMIN SERVS,RENOVATION OF LEASED SPACE,409,QUEENS,PW-0326,7748,3063,0,0,0,0,0,4685,7748,3063,0,0,0,0,0,4685,7748,6126,0,0,0,0,0,9370,15496,PROJECT DELAYED DUE TO CHANGES IN SCOPE/DESIGN,,SQFT,cpd11-20qn.pdf
PW326DAQ5,DA QUEENS - ECONOMIC CRIMES UNIT,856,DEPT OF CITYWIDE ADMIN SERVS,RENOVATION OF LEASED SPACE,409,QUEENS,PW-0326,2681,2504,178,0,0,0,0,0,2682,2504,178,0,0,0,0,0,2682,5008,356,0,0,0,0,0,5364,,,SQ FT,cpd11-20qn.pdf
PW326DDC8,"DDC - RENEWAL AT 30-30 THOMSON AVE, LIC",856,DEPT OF CITYWIDE ADMIN SERVS,RENOVATION OF LEASED SPACE,401,QUEENS,PW-0326,1629,0,1629,0,0,0,0,0,1629,0,1629,0,0,0,0,0,1629,0,3258,0,0,0,0,0,3258,,47 AVE. NOT THOMPSON AVE,DDC - 101 TYRELLAN AVENUE SI EXPANSION,cpd11-20qn.pdf
PW326DOF4,"DOF - 144-06 94TH AVENUE, QUEENS - LEASE RENEWAL",856,DEPT OF CITYWIDE ADMIN SERVS,RENOVATION OF LEASED SPACE,401,QUEENS,PW-0326,2214,81,16357,0,0,0,0,0,16438,81,16357,0,0,0,0,0,16438,162,32714,0,0,0,0,0,32876,PROJECT DELAYED DUE TO CHANGES IN SCOPE/DESIGN,,"DOF LEASE RENEWAL FOR 144-06 94TH AVENUE, QUEENS",cpd11-20qn.pdf
PW326EV,DOHMH - 2 GOTHAM CHARGING STATION INFRASTRUCTURE,856,DEPT OF CITYWIDE ADMIN SERVS,RENOVATION OF LEASED SPACE,401,QUEENS,PW-0308,375,0,0,375,0,0,0,0,375,0,0,375,0,0,0,0,375,0,0,750,0,0,0,0,750,,,SQ FT,cpd11-20qn.pdf
PW326RAQ,LAW DEPT - RAISE THE AGE - QUEENS,856,DEPT OF CITYWIDE ADMIN SERVS,RENOVATION OF LEASED SPACE,401,QUEENS,PW-0326,4500,0,4500,0,0,0,0,0,4500,0,4500,0,0,0,0,0,4500,0,9000,0,0,0,0,0,9000,,,LAW DEPT - RAISE THE AGE - QUEENS,cpd11-20qn.pdf
PW326TLQ3,TLC -31-00 47 AVE QUEENS,856,DEPT OF CITYWIDE ADMIN SERVS,RENOVATION OF LEASED SPACE,401,QUEENS,PW-0326,1141,0,0,0,0,1141,0,0,1141,0,0,0,0,1141,0,0,1141,0,0,0,0,2282,0,0,2282,PROJECT DELAYED DUE TO BUDGETARY CONSTRAINTS,,TLC -31-0047 AVE QUEENS -EXPANSION,cpd11-20qn.pdf
PW77417SW,120-55 QUEENS BLVD.- SITE WORK,856,DEPT OF CITYWIDE ADMIN SERVS,REHABILITATION OF CITY-OWNED OFFICE SPACE,409,QUEENS,PW-0077,4841,405,0,5244,0,0,0,0,5649,405,0,5244,0,0,0,0,5649,810,0,10488,0,0,0,0,11298,PROJECT DELAYED DUE TO CHANGES IN SCOPE/DESIGN,,120-55 QUEENS BLVD - SITE WORK,cpd11-20qn.pdf
PW77417TU,120-55 QUEENS BOULEVARD- CODE COMPLIANT TOILET UPGRADES,856,DEPT OF CITYWIDE ADMIN SERVS,REHABILITATION OF CITY-OWNED OFFICE SPACE,401,QUEENS,PW-0077,4400,0,0,400,0,0,4000,0,4400,0,0,400,0,0,4000,0,4400,0,0,800,0,0,8000,0,8800,PROJECT DELAYED DUE TO BUDGETARY CONSTRAINTS,,CODE COMPLIANT TOILET UPGRADES,cpd11-20qn.pdf
PWD78415A,88-11 SUTPHIN BLVD.- FACADE RESTORATION,856,DEPT OF CITYWIDE ADMIN SERVS,REHABILITATION OF COURT BUILDINGS,400 412,QUEENS,PW-D078,125,0,0,0,0,0,0,110,110,0,0,0,0,0,0,110,110,0,0,0,0,0,0,220,220,PROJECT DELAYED DUE TO BUDGETARY CONSTRAINTS,,QUEENS SUPREME COURT FACADE RESTORATION,cpd11-20qn.pdf
PWQ77QBH2,120-55 QUEENS BLVD.- RENOVATIONS,856,DEPT OF CITYWIDE ADMIN SERVS,REHABILITATION OF CITY-OWNED OFFICE SPACE,401,QUEENS,PW-Q077,186,0,0,0,0,0,186,0,186,0,0,0,0,0,186,0,186,0,0,0,0,0,372,0,372,PROJECT DELAYED DUE TO BUDGETARY CONSTRAINTS,,QUEENS BORO HALL--RENOVATIONS,cpd11-20qn.pdf
PWQ77R213,120-55 QUEENS BLVD- QUEENS BORO HALL RENOVATIONS,856,DEPT OF CITYWIDE ADMIN SERVS,REHABILITATION OF CITY-OWNED OFFICE SPACE,401,QUEENS,PW-0077,847,0,0,0,0,0,0,448,448,0,0,0,0,0,0,448,448,0,0,0,0,0,0,896,896,PROJECT DELAYED DUE TO BUDGETARY CONSTRAINTS,,120-55 QUEENS BLVD- QUEENS BORO HALL RENOVATIONS-TOPOGRAPHY,cpd11-20qn.pdf
RE25VERN,PLATFORM / BULKHEAD REPLACEMENT,856,DEPT OF CITYWIDE ADMIN SERVS,REHABILITATION OF WATERFRONT PROPERTIES,401,QUEENS,RE-0025,492,0,0,0,492,0,0,0,492,0,0,0,492,0,0,0,492,0,0,0,984,0,0,0,984,,,PLATFORM / BULKHEAD REPLACEMENT,cpd11-20qn.pdf
SCACIP04,CAPACITY NEW SCHOOL - DSF0000866092 @ Q472,856,DEPT OF CITYWIDE ADMIN SERVS,"BUILDING CONSTRUCTION, RECONSTRUCTION OR RETROFIT",400,QUEENS,PU-0025,8000,0,0,8000,0,0,0,0,8000,0,0,8000,0,0,0,0,8000,0,0,16000,0,0,0,0,16000,,,"CAPACITY NEW SCHOOL - DSF0000866092 @ Q472 , 3079 SEATS",cpd11-20qn.pdf
SCACIP07,Q075 - SYSTEM REPLACEMENT,856,DEPT OF CITYWIDE ADMIN SERVS,"BUILDING CONSTRUCTION, RECONSTRUCTION OR RETROFIT",401,QUEENS,PU-0025,500,0,0,500,0,0,0,0,500,0,0,500,0,0,0,0,500,0,0,1000,0,0,0,0,1000,,,Q075 - SYSTEM REPLACEMENT,cpd11-20qn.pdf
SOLARPQL1,DCAS PQL Round 1 (EME) DCAS PQL Round 1 (EME),856,DEPT OF CITYWIDE ADMIN SERVS,"BUILDING CONSTRUCTION, RECONSTRUCTION OR RETROFIT",401,QUEENS,PU-0025,3400,0,0,3400,0,0,0,0,3400,0,0,3400,0,0,0,0,3400,0,0,6800,0,0,0,0,6800,,,DCAS PQL ROUND 1 (EME),cpd11-20qn.pdf
UNIONHALL,ACS - WORKFORCE INSTITUTE UNION HALL,856,DEPT OF CITYWIDE ADMIN SERVS,SOCIAL SERVICE BUILDINGS,400,QUEENS,CS-0003,18003,3928,2109,3291,0,0,0,0,9328,3928,2109,3291,0,0,0,0,9328,7856,4218,6582,0,0,0,0,18656,,,CONSTRUCTION AND FURNITURE AT WORKFORCE INSTITUTE,cpd11-20qn.pdf
LNCA17THL,TODT HILL - New Lighting,037,NEW YORK PUBLIC LIBRARY,ESSENTIAL RECONSTRUCTION OF FACILITIES,500,RICHMOND,LN-D008,700,0,0,0,0,634,0,0,634,0,0,0,0,634,0,0,634,0,0,0,0,1268,0,0,1268,,,TODT HILL,cpd11-20si.pdf
LNCM15STB,South Beach - New Roof,037,NEW YORK PUBLIC LIBRARY,ESSENTIAL RECONSTRUCTION OF FACILITIES,500,RICHMOND,LN-D008,200,0,0,0,22,178,0,0,200,0,0,0,22,178,0,0,200,0,0,0,44,356,0,0,400,,,ROOF,cpd11-20si.pdf
LNEM17RTW,RICHMONDTOWN - HVAC System Replacement,037,NEW YORK PUBLIC LIBRARY,ESSENTIAL RECONSTRUCTION OF FACILITIES,500,RICHMOND,LN-D008 LN-0008,1200,0,0,0,0,627,0,475,1102,0,0,0,0,627,0,475,1102,0,0,0,0,1254,0,950,2204,,,RICHMONDTOWN,cpd11-20si.pdf
LNRA17NDP,NEW DORP - HVAC System Replacement,037,NEW YORK PUBLIC LIBRARY,ESSENTIAL RECONSTRUCTION OF FACILITIES,502,RICHMOND,LN-R001 LN-D008 LN-0008,700,0,534,0,3275,0,0,0,3809,0,534,0,3275,0,0,0,3809,0,1068,0,6550,0,0,0,7618,PROJECT DELAYED DUE TO BUDGETARY CONSTRAINTS,,NYPL - NEW DORP BRANCH,cpd11-20si.pdf
LNRA17WNB,WEST NEW BRIGHTON - ADA-compliant Elevators,037,NEW YORK PUBLIC LIBRARY,ACCESS FOR THE HANDICAPPED,501,RICHMOND,LN-R001 LN-D008,1000,0,406,0,0,500,0,0,906,0,406,0,0,500,0,0,906,0,812,0,0,1000,0,0,1812,PROJECT DELAYED DUE TO BUDGETARY CONSTRAINTS,,NYPL - WEST BRIGHTON BRANCH,cpd11-20si.pdf
LNRA18GCK,Great Kills - ADA-compliant Restrooms,037,NEW YORK PUBLIC LIBRARY,ACCESS FOR THE HANDICAPPED,503,RICHMOND,LN-R001,350,0,350,0,0,0,0,0,350,0,350,0,0,0,0,0,350,0,700,0,0,0,0,0,700,,,NYPL-GREAT KILLS-ADA COMPLIANT RESTROOMS,cpd11-20si.pdf
LNRA18RCH,Richmondtown - New Boiler,037,NEW YORK PUBLIC LIBRARY,IMPROVEMENTS TO EXISTING FACILITIES,502,RICHMOND,LN-R001,600,0,600,0,0,0,0,0,600,0,600,0,0,0,0,0,600,0,1200,0,0,0,0,0,1200,,,NYPL-RICHMONDTOWN BRANCH-NEW BOILER,cpd11-20si.pdf
ST001-021,Science Lecture Room,042,CITY UNIVERSITY,MISCELLANEOUS RECONSTRUCTION,500,RICHMOND,HN-D300,615,0,615,0,0,0,0,0,615,0,615,0,0,0,0,0,615,0,1230,0,0,0,0,0,1230,,,SCIENCE LECTURE ROOM,cpd11-20si.pdf
ST030-015,Support Center for High Performance Computer,042,CITY UNIVERSITY,MISCELLANEOUS RECONSTRUCTION,500,RICHMOND,HN-D300,350,353,-3,0,100,0,0,0,450,353,-3,0,100,0,0,0,450,706,-6,0,200,0,0,0,900,PROJECT DELAYED DUE TO CHANGES IN SCOPE/DESIGN,,SUPPORT CENTER FOR HIGH PERFORMANCE COMPUTER,cpd11-20si.pdf
ST032-015,Media Culture Screening Room,042,CITY UNIVERSITY,MISCELLANEOUS RECONSTRUCTION,500,RICHMOND,HN-D300 HN-D005,510,479,148,0,0,0,0,0,627,479,148,0,0,0,0,0,627,958,296,0,0,0,0,0,1254,PROJECT DELAYED DUE TO CHANGES IN SCOPE/DESIGN,,MEDIA CULTURE SCREENING ROOM,cpd11-20si.pdf
ST034-016,High Performance Computer Center,042,CITY UNIVERSITY,MISCELLANEOUS RECONSTRUCTION,500,RICHMOND,HN-D300,125,0,0,0,125,0,0,0,125,0,0,0,125,0,0,0,125,0,0,0,250,0,0,0,250,PROJECT DELAYED DUE TO CHANGES IN SCOPE/DESIGN,,HIGH PERFORMANCE CENTER,cpd11-20si.pdf
ST038-018,Reconstruction of Baseball Field,042,CITY UNIVERSITY,MISCELLANEOUS RECONSTRUCTION,,RICHMOND,HN-R300 HN-D300,3150,0,4054,0,0,0,0,0,4054,0,4054,0,0,0,0,0,4054,0,8108,0,0,0,0,0,8108,,,RECONSTRUCTION OF BASEBALL FIELD,cpd11-20si.pdf
ST039-019,Maker Space Lab,042,CITY UNIVERSITY,MISCELLANEOUS RECONSTRUCTION,500 502,RICHMOND,HN-R001 HN-D300,1350,202,0,98,1050,0,0,0,1350,202,0,98,1050,0,0,0,1350,404,0,196,2100,0,0,0,2700,PROJECT DELAYED DUE TO BUDGETARY CONSTRAINTS,,MAKER SPACE LAB,cpd11-20si.pdf
ST041-020,Room Conversion for the Genomic Research Center,042,CITY UNIVERSITY,MISCELLANEOUS RECONSTRUCTION,500,RICHMOND,HN-D300 HN-R001,1250,0,0,0,1250,0,0,0,1250,0,0,0,1250,0,0,0,1250,0,0,0,2500,0,0,0,2500,,,ROOM CONVERSION FOR THE GENOMIC RESEARCH CENTER,cpd11-20si.pdf
PO79120AC,120TH PCT - NEW HVAC SYSTEM,056,POLICE DEPARTMENT,POLICE FACILITIES,500 501,RICHMOND,PO-0079,400,1387,556,556,0,0,0,0,2499,1387,556,556,0,0,0,0,2499,2774,1112,1112,0,0,0,0,4998,PROJECT DELAYED DUE TO CHANGES IN SCOPE/DESIGN,,NEW HVAC SYSTEM,cpd11-20si.pdf
F175MC152,Multi-Component Renovations - EC152,057,FIRE DEPARTMENT,NEW FACILITIES AND RENOVATIONS,501,RICHMOND,F-0175,7613,870,0,0,3295,3436,0,0,7601,870,0,0,3295,3436,0,0,7601,1740,0,0,6590,6872,0,0,15202,PROJECT DELAYED DUE TO BUDGETARY CONSTRAINTS,,MULTI-COMPONENT RENOVATIONS - EC152,cpd11-20si.pdf
F175MC159,Multi-Component Renovations - EC159,057,FIRE DEPARTMENT,NEW FACILITIES AND RENOVATIONS,502,RICHMOND,F-0175,5295,560,0,4947,0,0,0,0,5507,560,0,4947,0,0,0,0,5507,1120,0,9894,0,0,0,0,11014,,,MULTI-COMPONENT RENOVATIONS - EC159,cpd11-20si.pdf
F175SEWER,New Sewer Main and Pumping Station - Outside Plant Garage,057,FIRE DEPARTMENT,NEW FACILITIES AND RENOVATIONS,500,RICHMOND,F-0175,837,532,0,50,0,0,0,0,582,532,0,50,0,0,0,0,582,1064,0,100,0,0,0,0,1164,,,NEW SEWER MAIN - OUTSIDE PLANT GARAGE,cpd11-20si.pdf
FD175G161,Generator - EC161,057,FIRE DEPARTMENT,NEW FACILITIES AND RENOVATIONS,502,RICHMOND,F-D175 F-0175,802,93,708,0,0,0,0,0,801,93,708,0,0,0,0,0,801,186,1416,0,0,0,0,0,1602,PROJECT DELAYED DUE TO BUDGETARY CONSTRAINTS,,GENERATOR - EC161,cpd11-20si.pdf
FD175G165,Generator - EC165,057,FIRE DEPARTMENT,NEW FACILITIES AND RENOVATIONS,502,RICHMOND,F-D175 F-0175,679,109,610,0,0,0,0,0,719,109,610,0,0,0,0,0,719,218,1220,0,0,0,0,0,1438,PROJECT DELAYED DUE TO BUDGETARY CONSTRAINTS,,GENERATOR - EC165,cpd11-20si.pdf
FD175W154,WINDOW REPLACEMENT - EC154,057,FIRE DEPARTMENT,NEW FACILITIES AND RENOVATIONS,502,RICHMOND,F-D175,406,370,0,0,0,0,0,35,405,370,0,0,0,0,0,35,405,740,0,0,0,0,0,70,810,PROJECT DELAYED DUE TO BUDGETARY CONSTRAINTS,,WINDOW REPLACEMENT - EC154,cpd11-20si.pdf
FD175W166,WINDOW REPLACEMENT - EC166,057,FIRE DEPARTMENT,NEW FACILITIES AND RENOVATIONS,502,RICHMOND,F-D175,469,432,0,0,0,0,0,36,468,432,0,0,0,0,0,36,468,864,0,0,0,0,0,72,936,PROJECT DELAYED DUE TO BUDGETARY CONSTRAINTS,,WINDOW REPLACEMENT - EC166,cpd11-20si.pdf
FR175G166,Generator - EC166,057,FIRE DEPARTMENT,NEW FACILITIES AND RENOVATIONS,,RICHMOND,F-R175 F-0175,614,58,556,0,0,0,0,0,614,58,556,0,0,0,0,0,614,116,1112,0,0,0,0,0,1228,PROJECT DELAYED DUE TO BUDGETARY CONSTRAINTS,,INSTALLATION OF NEW BUILDING GENERATOR AT EC166.,cpd11-20si.pdf
HH115HOBU,HOSPITALITY HOUSE BUILDING UPGRADE,071,DEPT OF HOMELESS SERVICES,SHELTERS FOR HOMELESS FAMILIES,501,RICHMOND,HH-0115,2250,0,0,180,0,2070,0,0,2250,0,0,180,0,2070,0,0,2250,0,0,360,0,4140,0,0,4500,,,HOSPITALITY HOUSE BUILDING UPGRADE,cpd11-20si.pdf
PV175CLOV,SIZ - Staten Island Zoo Clove Road Restoration,126,DEPARTMENT OF CULTURAL AFFAIRS,ESSENTIAL RECONSTRUCTION OF FACILITIES,501,RICHMOND,PV-R175 PV-0175 PV-D175,5332,0,3118,619,0,5121,0,0,8858,0,3118,619,0,5121,0,0,8858,0,6236,1238,0,10242,0,0,17716,PROJECT DELAYED DUE TO CHANGES IN SCOPE/DESIGN,,STATEN ISLAND ZOO,cpd11-20si.pdf
PV302BPH2,SIIAS - Building B at SHCC Phase 2,126,DEPARTMENT OF CULTURAL AFFAIRS,ESSENTIAL RECONSTRUCTION OF FACILITIES,501,RICHMOND,PV-D302,0,0,0,0,125,0,0,0,125,0,0,0,125,0,0,0,125,0,0,0,250,0,0,0,250,,,RENOVATION PH2,cpd11-20si.pdf
PV341CAR2,SIHS - Carriage Barn Phase 2,126,DEPARTMENT OF CULTURAL AFFAIRS,ESSENTIAL RECONSTRUCTION OF FACILITIES,,RICHMOND,PV-0341,1112,0,0,0,0,988,0,0,988,0,0,0,0,988,0,0,988,0,0,0,0,1976,0,0,1976,,"441 CLARKE AVENUE, STATEN ISLAND",PHASE II OF CONSTRUCTION WORK ON CARRIAGE BARN STRUCTURES.,cpd11-20si.pdf
PV341GALL,SIHS - Gallery Renovation,126,DEPARTMENT OF CULTURAL AFFAIRS,ESSENTIAL RECONSTRUCTION OF FACILITIES,503,RICHMOND,PV-D341,450,0,0,0,0,450,0,0,450,0,0,0,0,450,0,0,450,0,0,0,0,900,0,0,900,,,GALLERY,cpd11-20si.pdf
PV341SIPA,SIHS - Security System and Security Gates,126,DEPARTMENT OF CULTURAL AFFAIRS,CAPITAL EQUIPMENT,502,RICHMOND,PV-R341 PV-0341 PV-D341 PV-0467,2154,0,506,0,0,1538,0,0,2044,0,506,0,0,1538,0,0,2044,0,1012,0,0,3076,0,0,4088,,,,cpd11-20si.pdf
PV490CPSD,SHCC - Snug Harbor CPSD,126,DEPARTMENT OF CULTURAL AFFAIRS,ESSENTIAL RECONSTRUCTION OF FACILITIES,501,RICHMOND,PV-D490,0,0,0,0,0,3125,0,0,3125,0,0,0,0,3125,0,0,3125,0,0,0,0,6250,0,0,6250,,,CPSD,cpd11-20si.pdf
PV490-GOV,SHCC - SNUG HARBOR - Governor's House Exterior Renovation,126,DEPARTMENT OF CULTURAL AFFAIRS,ESSENTIAL RECONSTRUCTION OF FACILITIES,501,RICHMOND,PV-0490,1000,0,0,0,0,0,0,0,0,0,0,0,0,0,0,0,0,0,0,0,0,0,0,0,0,,,RENOVATION,cpd11-20si.pdf
PV490-K,SHCC - SNUG HARBOR - BLDG K Matrons House,126,DEPARTMENT OF CULTURAL AFFAIRS,ESSENTIAL RECONSTRUCTION OF FACILITIES,501,RICHMOND,PV-R490 PV-D490,1628,0,1028,0,0,300,0,0,1328,0,1028,0,0,300,0,0,1328,0,2056,0,0,600,0,0,2656,PROJECT DELAYED DUE TO CHANGES IN SCOPE/DESIGN,,BLDG K MATRONS HOUSE,cpd11-20si.pdf
ANNADALE,Annadale Road Streetscape Project - Infrastructure Reno,801,DEPT OF SMALL BUSINESS SERVICES,MISCELLANEOUS,500 503,RICHMOND,ED-D384,1855,0,0,0,0,0,0,1855,1855,0,0,0,0,0,0,1855,1855,0,0,0,0,0,0,3710,3710,PROJECT DELAYED DUE TO CHANGES IN SCOPE/DESIGN,,ANNADALE ROAD STREETSCAPE PROJECT - INFRASTRUCTURE RENOVATIONS,cpd11-20si.pdf
C5215AB2,St. George Ferry Terminal,801,DEPT OF SMALL BUSINESS SERVICES,RECONSTRUCTION OF FERRY TERMINAL FACILITIES,501,RICHMOND,FA-0021,159617,132197,0,120,0,0,0,0,132317,132197,0,120,0,0,0,0,132317,264394,0,240,0,0,0,0,264634,PROJECT DELAYED DUE TO CHANGES IN SCOPE/DESIGN,STATEN ISLAND,ST GEORGE PHASE II IMPROVEMENT,cpd11-20si.pdf
CMETENT,OCME Relocation of Disaster Cache Equipment to Fresh Kills,801,DEPT OF SMALL BUSINESS SERVICES,OCME,501,RICHMOND,HL-0083,4160,3309,849,0,0,0,0,0,4158,3309,849,0,0,0,0,0,4158,6618,1698,0,0,0,0,0,8316,PROJECT DELAYED DUE TO CHANGES IN SCOPE/DESIGN,,"RELOCATION OF OCME DISASTER CACHE RESPONSE EQUIPMENT TO FRESH KILLS, STATEN ISLAND",cpd11-20si.pdf
FORESTAVE,FOREST AVENUE,801,DEPT OF SMALL BUSINESS SERVICES,MISCELLANEOUS,500,RICHMOND,ED-0075,2500,0,0,0,0,0,2500,0,2500,0,0,0,0,0,2500,0,2500,0,0,0,0,0,5000,0,5000,PROJECT DELAYED DUE TO CHANGES IN SCOPE/DESIGN,,FOREST AVE REALIGNMENT,cpd11-20si.pdf
GE-343,Replacement of Siphons b/t Brooklyn & SI,801,DEPT OF SMALL BUSINESS SERVICES,TRUNK AND DISTRIBUTION MAIN REPLACEMENT,501,RICHMOND,WM-0006,74150,140169,2740,0,0,0,0,0,142909,140169,2740,0,0,0,0,0,142909,280338,5480,0,0,0,0,0,285818,PROJECT DELAYED DUE TO CHANGES IN SCOPE/DESIGN,,REPLACEMENT OF THE SIPHONS WHICH RUN BETWEEN BROOKLYN AND STATEN ISLAND,cpd11-20si.pdf
HIFNSW,HIF - New Stapleton Waterfront,801,DEPT OF SMALL BUSINESS SERVICES,MISCELLANEOUS,500,RICHMOND,ED-0075,60000,0,0,0,0,0,0,60000,60000,0,0,0,0,0,0,60000,60000,0,0,0,0,0,0,120000,120000,PROJECT DELAYED DUE TO CHANGES IN SCOPE/DESIGN,,HIF - NEW STAPLETON WATERFRONT,cpd11-20si.pdf
HOMEPORT2,Stapleton Waterfront Phase II & III,801,DEPT OF SMALL BUSINESS SERVICES,MISCELLANEOUS,500,RICHMOND,ED-0075 P-1018,95000,21808,2000,0,0,6500,0,70850,101158,21808,2000,0,0,6500,0,70850,101158,43616,4000,0,0,13000,0,141700,202316,PROJECT DELAYED DUE TO CHANGES IN SCOPE/DESIGN,,STAPLETON WATERFRONT PHASE II & III,cpd11-20si.pdf
HWRLASEWF,Lipsett Avenue Street End (Waterfront),801,DEPT OF SMALL BUSINESS SERVICES,MISCELLANEOUS ENERGY EFFICIENCY AND SUSTAINABILITY,500,RICHMOND,PU-0200,900,0,0,0,0,0,900,0,900,0,0,0,0,0,900,0,900,0,0,0,0,0,1800,0,1800,PROJECT DELAYED DUE TO CHANGES IN SCOPE/DESIGN,LIPSETT AVENUE STREET END (WATERFRONT),LIPSETT AVENUE STREET END (WATERFRONT),cpd11-20si.pdf
LIGHTHOUS,National Lighthouse Museum,801,DEPT OF SMALL BUSINESS SERVICES,MISCELLANEOUS,500 501,RICHMOND,ED-D075,8456,6221,0,0,0,250,0,0,6471,6221,0,0,0,250,0,0,6471,12442,0,0,0,500,0,0,12942,PROJECT DELAYED DUE TO CHANGES IN SCOPE/DESIGN,,,cpd11-20si.pdf
LNC018CHA,CHARLESTON - Site Acquisition and New Branch Construction,801,DEPT OF SMALL BUSINESS SERVICES,EXPANSION AND CONSTRUCTION OF FACILITIES,503,RICHMOND,LN-0008 LN-D002 LN-D008 LN-R001 PU-0025,11103,10893,4809,1075,0,0,0,0,16777,10893,4809,1075,0,0,0,0,16777,21786,9618,2150,0,0,0,0,33554,PROJECT DELAYED DUE TO CHANGES IN SCOPE/DESIGN,,CHARLESTON - SITE ACQUISITION AND NEW BRANCH CONSTRUCTION,cpd11-20si.pdf
LNEA16PRT,PORT RICHMOND,801,DEPT OF SMALL BUSINESS SERVICES,ESSENTIAL RECONSTRUCTION OF FACILITIES,500,RICHMOND,LN-0008 LN-D008 LN-R001,20000,0,18283,0,0,0,0,0,18283,0,18283,0,0,0,0,0,18283,0,36566,0,0,0,0,0,36566,PROJECT DELAYED DUE TO CHANGES IN SCOPE/DESIGN,,PORT RICHMOND,cpd11-20si.pdf
PWDSIBPCT,Van for the Staten Island Borough President's Clean Team --,801,DEPT OF SMALL BUSINESS SERVICES,MISCELLANEOUS,500,RICHMOND,PW-D308,50,0,0,0,50,0,0,0,50,0,0,0,50,0,0,0,50,0,0,0,100,0,0,0,100,PROJECT DELAYED DUE TO CHANGES IN SCOPE/DESIGN,,VAN FOR THE STATEN ISLAND BOROUGH PRESIDENT'S CLEAN TEAM -- VAN PURCHASE,cpd11-20si.pdf
RCBBALLPK,RICHMOND COUNTY BANK BALLPARK AT ST. GEORGE,801,DEPT OF SMALL BUSINESS SERVICES,MISCELLANEOUS,500,RICHMOND,ED-D075,1750,0,0,0,0,1750,0,0,1750,0,0,0,0,1750,0,0,1750,0,0,0,0,3500,0,0,3500,PROJECT DELAYED DUE TO CHANGES IN SCOPE/DESIGN,,RICHMOND COUNTY BANK BALLPARK AT ST. GEORGE--RENOVATIONS OF BALLPARK,cpd11-20si.pdf
SANDEDCG5,Tompkinsville Esplanade - FEMA 428 Group 5,801,DEPT OF SMALL BUSINESS SERVICES,MISCELLANEOUS,500,RICHMOND,ED-0075,670,0,0,0,670,0,0,0,670,0,0,0,670,0,0,0,670,0,0,0,1340,0,0,0,1340,PROJECT DELAYED DUE TO CHANGES IN SCOPE/DESIGN,,TOMPKINSVILLE ESPLANADE - FEMA 428 GROUP 5,cpd11-20si.pdf
SANDG1HP,FEMA 428 G1 - Homeport Pier,801,DEPT OF SMALL BUSINESS SERVICES,MISCELLANEOUS,500,RICHMOND,ED-0075,13489,0,0,0,0,0,0,0,0,0,0,0,0,0,0,0,0,0,0,0,0,0,0,0,0,PROJECT DELAYED DUE TO CHANGES IN SCOPE/DESIGN,,FEMA 428 G1 - HOMEPORT PIER,cpd11-20si.pdf
SANDG1HS,FEMA 428 G1 - Homeport Substation,801,DEPT OF SMALL BUSINESS SERVICES,MISCELLANEOUS,500,RICHMOND,ED-0075,3808,0,0,0,0,0,0,0,0,0,0,0,0,0,0,0,0,0,0,0,0,0,0,0,0,PROJECT DELAYED DUE TO CHANGES IN SCOPE/DESIGN,,FEMA 428 G1 - HOMEPORT SUBSTATION,cpd11-20si.pdf
SANDG4DOC,FEMA 428 G4- DOCKBUILDERS,801,DEPT OF SMALL BUSINESS SERVICES,MISCELLANEOUS,500,RICHMOND,ED-0075 FA-0021,31250,0,250,46591,0,0,0,0,46841,0,250,46591,0,0,0,0,46841,0,500,93182,0,0,0,0,93682,PROJECT DELAYED DUE TO CHANGES IN SCOPE/DESIGN,,FEMA 428 GROUP 4 - DOCKBUILDERS,cpd11-20si.pdf
SANDHOME,Repairs to Homeport as a result of Hurricane Sandy,801,DEPT OF SMALL BUSINESS SERVICES,MISCELLANEOUS,500 501,RICHMOND,ED-0404,2175,0,0,0,218,0,0,0,218,0,0,0,218,0,0,0,218,0,0,0,436,0,0,0,436,PROJECT DELAYED DUE TO CHANGES IN SCOPE/DESIGN,,REPAIRS TO THE HOMEPORT PROJECT AS A RESULT OF DAMAGE CAUSED BY HURRICANE SANDY,cpd11-20si.pdf
SANDSIHP2,Stapleton Waterfront Phase II & III - Sandy Repairs,801,DEPT OF SMALL BUSINESS SERVICES,MISCELLANEOUS,500,RICHMOND,ED-0075,3408,0,0,0,341,0,0,0,341,0,0,0,341,0,0,0,341,0,0,0,682,0,0,0,682,PROJECT DELAYED DUE TO CHANGES IN SCOPE/DESIGN,,STAPLETON WATERFRONT PHASE II & III - FEMA RESILIENCY,cpd11-20si.pdf
SANDSMC,Hurricane Sandy - Saw Mill Creek Marsh Restoration,801,DEPT OF SMALL BUSINESS SERVICES,MISCELLANEOUS,500,RICHMOND,ED-0075,13000,10448,881,0,0,0,0,0,11329,10448,881,0,0,0,0,0,11329,20896,1762,0,0,0,0,0,22658,,,REHABILITATION OF SAW MILL CREEK IN STATEN ISLAND,cpd11-20si.pdf
SEAVIEW,FA - Seaview Senior Housing - Met Council,801,DEPT OF SMALL BUSINESS SERVICES,MISCELLANEOUS CONSTRUCTION,502,RICHMOND,PW-D005,53650,45263,0,3387,0,0,0,0,48650,45263,0,3387,0,0,0,0,48650,90526,0,6774,0,0,0,0,97300,PROJECT DELAYED DUE TO CHANGES IN SCOPE/DESIGN,,SEAVIEW SENIOR HOUSING,cpd11-20si.pdf
SIBULK,Sandy Staten Island Esplanade Emergency Bulkhead Work,801,DEPT OF SMALL BUSINESS SERVICES,MISCELLANEOUS,501,RICHMOND,ED-0409,2005,35,110,0,349,0,0,0,494,35,110,0,349,0,0,0,494,70,220,0,698,0,0,0,988,PROJECT DELAYED DUE TO CHANGES IN SCOPE/DESIGN,,STATEN ISLAND ESPLANADE EMERGENCY BULKHEAD WORK,cpd11-20si.pdf
SIESPLAND,Staten Island North Shore Esplanade,801,DEPT OF SMALL BUSINESS SERVICES,WATERFRONT DEVELOPMENT,501,RICHMOND,ED-0409,10543,6175,0,0,0,234,0,0,6409,6175,0,0,0,234,0,0,6409,12350,0,0,0,468,0,0,12818,PROJECT DELAYED DUE TO CHANGES IN SCOPE/DESIGN,"SI, NY 10301",INSTALLATION OF NEW PAVERS; CONCRETE & ASPHALT PAVING; BULKHEAD RECONSTRUCTION,cpd11-20si.pdf
SIHOMEPT,Staten Island Homeport Emergency Bulkhead Work,801,DEPT OF SMALL BUSINESS SERVICES,MISCELLANEOUS,501,RICHMOND,ED-0409,631,43,0,0,0,0,36,0,79,43,0,0,0,0,36,0,79,86,0,0,0,0,72,0,158,PROJECT DELAYED DUE TO CHANGES IN SCOPE/DESIGN,,STATEN ISLAND HOMEPORT EMERGENCY BULKHEAD WORK,cpd11-20si.pdf
SIOUTLET,Staten Island Empire Outlets,801,DEPT OF SMALL BUSINESS SERVICES,MISCELLANEOUS,500,RICHMOND,ED-0075,11800,11500,0,0,300,0,0,0,11800,11500,0,0,300,0,0,0,11800,23000,0,0,600,0,0,0,23600,PROJECT DELAYED DUE TO CHANGES IN SCOPE/DESIGN,,STATEN ISLAND EMPIRE OUTLETS,cpd11-20si.pdf
SIPIER1A,Staten Island Pier 1 Rehabilitation,801,DEPT OF SMALL BUSINESS SERVICES,PORT DEVELOPMENT,501,RICHMOND,ED-R075,2400,2148,0,0,0,615,0,0,2763,2148,0,0,0,615,0,0,2763,4296,0,0,0,1230,0,0,5526,PROJECT DELAYED DUE TO CHANGES IN SCOPE/DESIGN,,OFFSHORE PIER REHABILITATION,cpd11-20si.pdf
SIWHEEL,St. George Improvements,801,DEPT OF SMALL BUSINESS SERVICES,MISCELLANEOUS,501,RICHMOND,ED-R075,1000,0,0,0,0,0,0,1000,1000,0,0,0,0,0,0,1000,1000,0,0,0,0,0,0,2000,2000,PROJECT DELAYED DUE TO CHANGES IN SCOPE/DESIGN,,STATEN ISLAND WHEEL,cpd11-20si.pdf
STGRGEFIT,St. George Ferry Terminal - Fit Out,801,DEPT OF SMALL BUSINESS SERVICES,WATERFRONT DEVELOPMENT,500 501,RICHMOND,ED-R075,400,333,0,68,0,0,0,0,401,333,0,68,0,0,0,0,401,666,0,136,0,0,0,0,802,PROJECT DELAYED DUE TO CHANGES IN SCOPE/DESIGN,,ST. GEORGE FERRY TERMINAL FIT OUT,cpd11-20si.pdf
STGSECURE,St. George Ferry Terminal - Security,801,DEPT OF SMALL BUSINESS SERVICES,RECONSTRUCTION OF FERRY TERMINAL FACILITIES,501,RICHMOND,FA-0021 FA-0027,23350,13826,0,99,0,0,0,0,13925,13826,0,99,0,0,0,0,13925,27652,0,198,0,0,0,0,27850,PROJECT DELAYED DUE TO CHANGES IN SCOPE/DESIGN,,STG SECURITY IMPROVEMENTS,cpd11-20si.pdf
SVIEWDIAB,Sea View Diabetes Center,801,DEPT OF SMALL BUSINESS SERVICES,MISCELLANEOUS,500,RICHMOND,ED-0075,22800,0,3000,0,0,0,15960,5840,24800,0,3000,0,0,0,15960,5840,24800,0,6000,0,0,0,31920,11680,49600,PROJECT DELAYED DUE TO CHANGES IN SCOPE/DESIGN,,NEW DIABETES CENTER AT SEA VIEW,cpd11-20si.pdf
TOTTENCBD,Tottenville Central Business District,801,DEPT OF SMALL BUSINESS SERVICES,COMMERCIAL DEVELOPMENT,503,RICHMOND,PW-D005,1358,1159,0,0,0,0,100,0,1259,1159,0,0,0,0,100,0,1259,2318,0,0,0,0,200,0,2518,PROJECT DELAYED DUE TO CHANGES IN SCOPE/DESIGN,,,cpd11-20si.pdf
TRAVLIFT,Travis Avenue Lift Project -- Elevating section of Travis Av,801,DEPT OF SMALL BUSINESS SERVICES,MISCELLANEOUS,500,RICHMOND,ED-D075,1500,0,1500,0,0,0,1500,0,3000,0,1500,0,0,0,1500,0,3000,0,3000,0,0,0,3000,0,6000,PROJECT DELAYED DUE TO CHANGES IN SCOPE/DESIGN,,TRAVIS AVENUE LIFT PROJECT -- ELEVATING SECTION OF TRAVIS AVENUE TO PREVENT FLOODING,cpd11-20si.pdf
TRAVSIDEW,TRAVIS AVENUE ELEVATION - FOR SIDEWALK/WALKWAY TO NATURE PRE,801,DEPT OF SMALL BUSINESS SERVICES,MISCELLANEOUS,500,RICHMOND,ED-0075,2000,0,0,0,0,0,2000,0,2000,0,0,0,0,0,2000,0,2000,0,0,0,0,0,4000,0,4000,PROJECT DELAYED DUE TO CHANGES IN SCOPE/DESIGN,,TRAVIS AVENUE ELEVATION - FOR SIDEWALK/WALKWAY TO NATURE PRESERVE,cpd11-20si.pdf
YMCASOSH,YMCA South Shore - Staten Island,801,DEPT OF SMALL BUSINESS SERVICES,REHABILITATION OF NON-WATERFRONT PROPERTIES,500 503,RICHMOND,RE-0019,290,0,0,0,0,0,250,0,250,0,0,0,0,0,250,0,250,0,0,0,0,0,500,0,500,PROJECT DELAYED DUE TO CHANGES IN SCOPE/DESIGN,YMCA FACILITY.,CONSTRUCTION AT YMCA AT SOUTH SHORE.,cpd11-20si.pdf
HAM16NLSC,NEW LANE HOUSES - SECURITY CAMERAS AND DOORS,806,HOUSING PRESERVATION AND DEVEL,LOW TO MODERATE INCOME PUBLIC HOUSING UPGRADE,501,RICHMOND,HA-R001,700,0,500,0,0,0,0,0,500,0,500,0,0,0,0,0,500,0,1000,0,0,0,0,0,1000,PROJECT DELAYED DUE TO CHANGES IN SCOPE/DESIGN,,NEW LANE HOUSES - SECURITY CAMERAS AND DOORS,cpd11-20si.pdf
HAM16THSC,TODT HILL HOUSES SECURITY CAMERAS AND DOORS,806,HOUSING PRESERVATION AND DEVEL,LOW TO MODERATE INCOME PUBLIC HOUSING UPGRADE,502,RICHMOND,HA-R001,1800,1171,1729,0,0,0,0,0,2900,1171,1729,0,0,0,0,0,2900,2342,3458,0,0,0,0,0,5800,PROJECT DELAYED DUE TO CHANGES IN SCOPE/DESIGN,,TOD HILL HOUSES SECURITY CAMERAS AND DOORS,cpd11-20si.pdf
HAM16WBDR,WEST BRIGHTON HOUSES UPGRADING OF DOORS AND SECURITY CAMERAS,806,HOUSING PRESERVATION AND DEVEL,LOW TO MODERATE INCOME PUBLIC HOUSING UPGRADE,501,RICHMOND,HA-D001,3200,0,83,0,0,0,0,0,83,0,83,0,0,0,0,0,83,0,166,0,0,0,0,0,166,PROJECT DELAYED DUE TO CHANGES IN SCOPE/DESIGN,,UPGRADING OF DOORS AND SECURITY CAMERAS,cpd11-20si.pdf
HAM18CSLF,CASSIDY LAFAYETTE SECURITY CAMERAS,806,HOUSING PRESERVATION AND DEVEL,LOW TO MODERATE INCOME PUBLIC HOUSING UPGRADE,501,RICHMOND,HA-D001,2760,0,2760,0,0,0,0,0,2760,0,2760,0,0,0,0,0,2760,0,5520,0,0,0,0,0,5520,,,INSTALL SECURITY CAMERAS,cpd11-20si.pdf
HAM18NLAC,NEW LANE SHORES LUNCH ROOM AC,806,HOUSING PRESERVATION AND DEVEL,LOW TO MODERATE INCOME PUBLIC HOUSING CONSTRUCTION,501,RICHMOND,HA-D001,600,278,322,0,0,0,0,0,600,278,322,0,0,0,0,0,600,556,644,0,0,0,0,0,1200,,,AIR CONDITIONING,cpd11-20si.pdf
HAM18THGR,TODT HILL GROUNDS UPDATES,806,HOUSING PRESERVATION AND DEVEL,LOW TO MODERATE INCOME PUBLIC HOUSING UPGRADE,502,RICHMOND,HA-D001,500,0,500,0,0,0,0,0,500,0,500,0,0,0,0,0,500,0,1000,0,0,0,0,0,1000,,,UPDATE GROUNDS,cpd11-20si.pdf
HAM19BHLU,BERRY HOUSES INTERIOR LIGHTING,806,HOUSING PRESERVATION AND DEVEL,LOW TO MODERATE INCOME PUBLIC HOUSING UPGRADE,502,RICHMOND,HA-D001,100,0,100,0,0,0,0,0,100,0,100,0,0,0,0,0,100,0,200,0,0,0,0,0,200,,,INTERIOR LIGHTING-LIGHTING UPGRADES AT BERRY HOUSES,cpd11-20si.pdf
HAM19MHBC,MARINER HARBOR BASKETBALL COURTS,806,HOUSING PRESERVATION AND DEVEL,LOW TO MODERATE INCOME PUBLIC HOUSING UPGRADE,501,RICHMOND,HA-D001,393,0,393,0,0,0,0,0,393,0,393,0,0,0,0,0,393,0,786,0,0,0,0,0,786,,,"RENOVATION TO THE BASKETBALL COURT INCLUDING REPAVING THE COURT, NEW BASKETBALL POST,",cpd11-20si.pdf
HAM19THSS,TODT HILL HOUSES SPRINKLER SYSTEM,806,HOUSING PRESERVATION AND DEVEL,LOW TO MODERATE INCOME PUBLIC HOUSING UPGRADE,501,RICHMOND,HA-D001,500,0,50,0,0,0,0,0,50,0,50,0,0,0,0,0,50,0,100,0,0,0,0,0,100,,,INSTALL A BRAND-NEW LARGE CHILDRENS SPRINKLER SYSTEM,cpd11-20si.pdf
HAM20BHCC,BERRY HOUSES CAMERA UPGRADES,806,HOUSING PRESERVATION AND DEVEL,LOW TO MODERATE INCOME PUBLIC HOUSING UPGRADE,502,RICHMOND,HA-D001,200,0,200,0,0,0,0,0,200,0,200,0,0,0,0,0,200,0,400,0,0,0,0,0,400,,,BERRY HOUSES ON STATEN ISLAND CAMERA UPGRADES,cpd11-20si.pdf
HAM20SBLU,SOUTH BEACH HOUSES- LIGHTING UPGRADES,806,HOUSING PRESERVATION AND DEVEL,LOW TO MODERATE INCOME PUBLIC HOUSING UPGRADE,502,RICHMOND,HA-D001,200,0,200,0,0,0,0,0,200,0,200,0,0,0,0,0,200,0,400,0,0,0,0,0,400,PROJECT DELAYED DUE TO CHANGES IN SCOPE/DESIGN,,NEW YORK CITY HOUSING AUTHORITY - SOUTH BEACH HOUSES ON STATEN ISLAND-- SOUTH BEACH,cpd11-20si.pdf
HAM21MHTV,CCTV CAMERAS AT MARINERS HARBOR HOUSES,806,HOUSING PRESERVATION AND DEVEL,LOW TO MODERATE INCOME PUBLIC HOUSING UPGRADE,501,RICHMOND,HA-D001,0,0,650,0,0,0,0,0,650,0,650,0,0,0,0,0,650,0,1300,0,0,0,0,0,1300,,,NYCHA MARINERS HARBOR HOUSES - MARINERS,cpd11-20si.pdf
HAM21NLCI,CONCRETE INSTALLATION AT NEW LANE HOUSES,806,HOUSING PRESERVATION AND DEVEL,LOW TO MODERATE INCOME PUBLIC HOUSING UPGRADE,501,RICHMOND,HA-D001,0,0,205,0,0,0,0,0,205,0,205,0,0,0,0,0,205,0,410,0,0,0,0,0,410,,,NEW LANE HOUSES - CONCRETE INSTALLATION-,cpd11-20si.pdf
75200403,SEA VIEW,819,HEALTH AND HOSPITALS CORP,ROUTINE RECONSTRUCTION,500 501,RICHMOND,HO-D003,108,0,0,0,108,0,0,0,108,0,0,0,108,0,0,0,108,0,0,0,216,0,0,0,216,,"142 BRABANT STREET, STATEN ISLAND, NY 10303",RENOVATE AND UPDATE HHC CHILD HEALTH CLINIC AT MARINER'S HARBOR HOUSES.,cpd11-20si.pdf
75200902,SEAVIEW,819,HEALTH AND HOSPITALS CORP,ROUTINE RECONSTRUCTION,502,RICHMOND,HO-D003 HO-R001 HO-0214,3950,4012,498,0,0,0,0,0,4510,4012,498,0,0,0,0,0,4510,8024,996,0,0,0,0,0,9020,PROJECT DELAYED DUE TO CHANGES IN SCOPE/DESIGN,"460 BRIELLE AVENUE, STATEN ISLAND, N. Y. 10314",THEPURPOSE OF THIS PROJECT IS TO RENOVATE THE ISOLATION BUILDING AT SEAVIEW HOSPITAL,cpd11-20si.pdf
75201502,SEA VIEW,819,HEALTH AND HOSPITALS CORP,ROUTINE RECONSTRUCTION,502,RICHMOND,HO-0214,2233,2469,0,427,0,0,0,0,2896,2469,0,427,0,0,0,0,2896,4938,0,854,0,0,0,0,5792,PROJECT DELAYED DUE TO CHANGES IN SCOPE/DESIGN,"460 BRIELLE AVENUE, STATEN ISLAND, NY 10314",PROJECT WILL REPLACE FUEL TANK AND GENERATOR AT SEA VIEW HOSPITAL REHABILITATION,cpd11-20si.pdf
75202101,SEAVIEW,819,HEALTH AND HOSPITALS CORP,ROUTINE RECONSTRUCTION,,RICHMOND,HO-D003,400,0,400,0,0,0,0,0,400,0,400,0,0,0,0,0,400,0,800,0,0,0,0,0,800,,"460 BRIELLE AVENUE, STATEN ISLAND, NY 10314",RENOVATATE REH CENTER & HOME GRACE FOUNDATION,cpd11-20si.pdf
NCMCCSG,NEW CLOVE PS,826,DEPT ENVIRONMENTAL PROTECTION,WATER QUALITY PRESERVATION,500,RICHMOND,WM-0105,22000,1280,1000,0,15000,0,0,0,17280,1280,1000,0,15000,0,0,0,17280,2560,2000,0,30000,0,0,0,34560,,,REPLACE SWITCHGEARS A& MCCS AT NEW CLOVE PS,cpd11-20si.pdf
OB-125-L,RECONSTRUCTION OF SUBSTATION AT THE OAKWOOD BEACH WPCP,826,DEPT ENVIRONMENTAL PROTECTION,PLANT UPGRADING AND RECONSTRUCTION,500,RICHMOND,WP-0112,13350,8277,45,0,0,0,0,0,8322,8277,45,0,0,0,0,0,8322,16554,90,0,0,0,0,0,16644,PROJECT DELAYED DUE TO BUDGETARY CONSTRAINTS,"751 MILL ROAD STATEN ISLAND, N.Y. 10306",RECONSTRUCTION OF SUBSTATION AT THE OAKWOOD BEACH WPCP.,cpd11-20si.pdf
OB-133-L,SLUDGE THICKENING IMPROVEMENT @ OAKWOOD BEACH WPCP,826,DEPT ENVIRONMENTAL PROTECTION,PLANT UPGRADING AND RECONSTRUCTION,500,RICHMOND,WP-0112,26201,5468,-380,0,0,67478,0,0,72566,5468,-380,0,0,67478,0,0,72566,10936,-760,0,0,134956,0,0,145132,,"751 MILL ROAD STATEN ISLAND, NEW YORK 10306",SLUDGE THICKENING IMPROVEMENT AT OAKEOOD BEACH WPCP,cpd11-20si.pdf
OB-134-L,POWER DISTRIBUTION AT OAKWOOD BEACH WPCP,826,DEPT ENVIRONMENTAL PROTECTION,PLANT UPGRADING AND RECONSTRUCTION,500,RICHMOND,WP-0112,3920,6386,0,0,0,27500,0,0,33886,6386,0,0,0,27500,0,0,33886,12772,0,0,0,55000,0,0,67772,PROJECT DELAYED DUE TO BUDGETARY CONSTRAINTS,"751 MILL ROAD STATEN ISLAND, N.Y. 10306",POWER DISTRIBUTION AT OAKWOOD BEACH WPCP,cpd11-20si.pdf
OB-135-L,HEADWORKS AT OAKWOOD BEACH WPCP,826,DEPT ENVIRONMENTAL PROTECTION,PLANT UPGRADING AND RECONSTRUCTION,500,RICHMOND,WP-0112,18610,600,0,0,0,64995,0,0,65595,600,0,0,0,64995,0,0,65595,1200,0,0,0,129990,0,0,131190,PROJECT DELAYED DUE TO BUDGETARY CONSTRAINTS,"751 MILL ROAD, STATEN ISLAND NEW YORK 10306",HEADWORKS AT OAKWOOD BEACH WPCP,cpd11-20si.pdf
OB-136-L,INSTALLATION OF (2) MAIN TRANSFORMERS @ OAKWOOD BEACH WPCP,826,DEPT ENVIRONMENTAL PROTECTION,PLANT UPGRADING AND RECONSTRUCTION,500,RICHMOND,WP-0112,17676,4070,256,15000,20000,0,0,0,39326,4070,256,15000,20000,0,0,0,39326,8140,512,30000,40000,0,0,0,78652,,"751 MILL ROAD STATEN ISLAND, N.Y. 10306",INSTALLATION OF (2) MAIN TRANSFORMERS AT THE OAKWOOD BEACH WPCP,cpd11-20si.pdf
OB-149-L,UPGRADE FIRE ALARM SYSTEM @ OAKWOOD BEACH DEWATERING BLDG,826,DEPT ENVIRONMENTAL PROTECTION,PLANT UPGRADING AND RECONSTRUCTION,500,RICHMOND,WP-0112,2330,0,0,2000,0,0,0,0,2000,0,0,2000,0,0,0,0,2000,0,0,4000,0,0,0,0,4000,,"751 MILL ROAD STATEN ISLAND, N.Y. 10306",UPGRADE FIRE ALARM SYSTEM @ OAKWOOD BEACH DEWATERING BLDG,cpd11-20si.pdf
PR-132-L,RECONSTRUCTION OF SEA WALL/SLUDGE DOCK IMPROVEMENTS,826,DEPT ENVIRONMENTAL PROTECTION,PLANT UPGRADING AND RECONSTRUCTION,500,RICHMOND,WP-0112,3188,0,6306,0,0,34000,0,0,40306,0,6306,0,0,34000,0,0,40306,0,12612,0,0,68000,0,0,80612,PROJECT DELAYED DUE TO BUDGETARY CONSTRAINTS,,RECONSTRUCTION OF SEA WALL/SLUDGE DOCK IMPROVEMENTS,cpd11-20si.pdf
PR-134-L,RECONSTRUCT FINAL SETTLING SYSTEM EQUIPMENT @ PORT RICHMOND,826,DEPT ENVIRONMENTAL PROTECTION,PLANT UPGRADING AND RECONSTRUCTION,500,RICHMOND,WP-0112,6900,0,0,0,0,0,0,27500,27500,0,0,0,0,0,0,27500,27500,0,0,0,0,0,0,55000,55000,PROJECT DELAYED DUE TO BUDGETARY CONSTRAINTS,"RICHMOND TERRACE & BODINE STREET, STATEN ISLAND, N.Y. 10310",RECONSTRUCT FINAL SETTLING SYSTEM EQUIPMENT @ PORT RICHMOND,cpd11-20si.pdf
PR-135-L,RECONSTRUCT POWER DISTRIBUTION EQUIPMENT @ PORT RICHMOND,826,DEPT ENVIRONMENTAL PROTECTION,PLANT UPGRADING AND RECONSTRUCTION,500,RICHMOND,WP-0112,10620,2230,1,0,0,37500,0,0,39731,2230,1,0,0,37500,0,0,39731,4460,2,0,0,75000,0,0,79462,PROJECT DELAYED DUE TO BUDGETARY CONSTRAINTS,"RICHMOND TERRACE & BODINE STREET, STATEN ISLAND N.Y. 10310",RECONSTRUCT POWER DISTRIBUTION EQUIPMENT @ PORT RICHMOND WWTP,cpd11-20si.pdf
PR-138-L,RECONSTRUCT MAIN SEWAGE PUMP CONTROLS @ PORT RICHMOND WWTP,826,DEPT ENVIRONMENTAL PROTECTION,PLANT UPGRADING AND RECONSTRUCTION,500,RICHMOND,WP-0112,45322,4893,443,0,39850,0,0,0,45186,4893,443,0,39850,0,0,0,45186,9786,886,0,79700,0,0,0,90372,,"RICHMOND TERRACE & BODINE STREET, STATEN ISLAND, N.Y. 10310",RECONSTRUCT MAIN SEWAGE PUMP CONTROLS @ PORT RICHMOND WWTP,cpd11-20si.pdf
PR-140,TRC - Dechlorination Facilities at Port Richmond WWTP,826,DEPT ENVIRONMENTAL PROTECTION,CONSENT DECREE UPGRADING AND CONSTRUCTION,500,RICHMOND,WP-0282,28833,0,0,0,0,14590,0,0,14590,0,0,0,0,14590,0,0,14590,0,0,0,0,29180,0,0,29180,,,"INSTALLATION OF SODIUM BISULFITE STORAGE TANKS, EMERGENCY GRAVITY DRIP STORAGE TANK,",cpd11-20si.pdf
PR-144-L,RECONSTRUCT BLOWERS AND CONTROLS @ PORT RICHMOND WPCP,826,DEPT ENVIRONMENTAL PROTECTION,PLANT UPGRADING AND RECONSTRUCTION,500,RICHMOND,WP-0112,2975,0,0,0,2500,0,0,0,2500,0,0,0,2500,0,0,0,2500,0,0,0,5000,0,0,0,5000,,"RICHMOND TERRACE AND BODINE STREET, STATEN ISLAND, N.Y 10310",RECONSTRUCT BLOWERS AND CONTROLS @ PORT RICHMOND WPCP,cpd11-20si.pdf
PS-276,RECONSTRUCTION AT HANNAH STREET PUMPING STATION (BEDC),826,DEPT ENVIRONMENTAL PROTECTION,PLANT UPGRADING AND RECONSTRUCTION,500,RICHMOND,WP-0269,100225,13880,94062,0,0,0,0,0,107942,13880,94062,0,0,0,0,0,107942,27760,188124,0,0,0,0,0,215884,,"HANNAH STREET/MURRAY HULBERT AVENUE, STATEN ISLAND, N.Y. 10301",RECONSTRUCTION AT HANNAH STREET P.S. (BEDC),cpd11-20si.pdf
PS-295,RECONSTRUCTION AT MERSEREAU PUMPING STATION,826,DEPT ENVIRONMENTAL PROTECTION,PLANT UPGRADING AND RECONSTRUCTION,500,RICHMOND,WP-0269,8552,0,0,0,0,0,0,22000,22000,0,0,0,0,0,0,22000,22000,0,0,0,0,0,0,44000,44000,,RECONSTRUCTION AT MESEREAU PUMPING STATION,RECONSTRUCTION AT MESEREAU PUMPING STATION,cpd11-20si.pdf
PS-296,RECONSTRUCTION AT MELVIN PUMPING STATION,826,DEPT ENVIRONMENTAL PROTECTION,PLANT UPGRADING AND RECONSTRUCTION,500,RICHMOND,WP-0269,5000,0,0,5000,0,0,0,0,5000,0,0,5000,0,0,0,0,5000,0,0,10000,0,0,0,0,10000,,RECONSTRUCTION AT MELVIN PUMPING STATION,RECONSTRUCTION AT MELVIN PUMPING STATION,cpd11-20si.pdf
PS-317,RECONSTRUCT VICTORY BOULEVARD PUMPING STATION STATEN ISLAND,826,DEPT ENVIRONMENTAL PROTECTION,PLANT UPGRADING AND RECONSTRUCTION,500,RICHMOND,WP-0269,6000,0,0,0,0,0,12500,0,12500,0,0,0,0,0,12500,0,12500,0,0,0,0,0,25000,0,25000,,"VICTORY VLVD., NEAR CON ED TRAVIS POWER PLANT SOUTH OF WEST SHORE EXTRESSWAY, STATEN","RECONSTRUCTION OF VICTORY BOULEVARD PUMPING STATION STATEN ISLAND, NEW YORK",cpd11-20si.pdf
PS-322,"RECONSTRUCT MAYFLOWER AVENUE PUMPING STATION, STATEN ISLAND",826,DEPT ENVIRONMENTAL PROTECTION,PLANT UPGRADING AND RECONSTRUCTION,500,RICHMOND,WP-0269,5200,0,0,0,27500,0,0,0,27500,0,0,0,27500,0,0,0,27500,0,0,0,55000,0,0,0,55000,,"MAYFLOWER AVENUE AND SRTHUR KILL ROAD, STATEN ISLAND, NEW YORK, 10309","RECONSTRUCTION OF THE MAYFLOWER AVENUE PUMPING STATION, STATEN ISLAND, NEW YORK",cpd11-20si.pdf
PS-323,"RECONSTRUCT RICHMOND AVENUE PUMPING STATION, STATEN ISLAND",826,DEPT ENVIRONMENTAL PROTECTION,PLANT UPGRADING AND RECONSTRUCTION,500,RICHMOND,WP-0269,5200,0,0,0,0,0,44000,0,44000,0,0,0,0,0,44000,0,44000,0,0,0,0,0,88000,0,88000,,"RICHMOND AVENUE AND PROL PLACE, STATEN ISLAND, NEW YORK 10305","RECONSTRUCTION OF RICHMOND AVENUE PUMPING STATION, STATEN ISLAND, NEWYORK",cpd11-20si.pdf
RED-384,"TRUNK AND DISTRIBUTION WATER MAIN IN FRONT ST, SI",826,DEPT ENVIRONMENTAL PROTECTION,TRUNK AND DISTRIBUTION MAIN REPLACEMENT,501,RICHMOND,WM-0006 WM-0001,16997,0,0,0,0,16397,0,0,16397,0,0,0,0,16397,0,0,16397,0,0,0,0,32794,0,0,32794,PROJECT DELAYED DUE TO BUDGETARY CONSTRAINTS,,"TRUNK AND DISTRIBUTION WATER MAIN IN FRONT ST FROM HANNAH STREET TO VANDERBILT AVENUE,",cpd11-20si.pdf
RED-392,WM rplcmt in Bay St between Slosson Ter & Minthorne St SI,826,DEPT ENVIRONMENTAL PROTECTION,AUGMENTATION OF WATER SUPPLY SYSTEMS,501,RICHMOND,SE-0002R WM-0001,9005,0,0,0,0,8753,0,0,8753,0,0,0,0,8753,0,0,8753,0,0,0,0,17506,0,0,17506,,,WATER MAIN REPLACEMENT IN BAY STREET BETWEEN SLOSSON TERRACE TO MINTHORNE STREET,cpd11-20si.pdf
SANDOB,RECONS OF THE OAKWOOD BEACH WPCP DUE TO HURRICANE SANDY,826,DEPT ENVIRONMENTAL PROTECTION,PLANT UPGRADING AND RECONSTRUCTION,500,RICHMOND,WP-0112,1277,0,350,0,0,0,0,5904,6254,0,350,0,0,0,0,5904,6254,0,700,0,0,0,0,11808,12508,PROJECT DELAYED DUE TO BUDGETARY CONSTRAINTS,,RECONSTRUCTION OF THE OAKWOOD BEACH WATER POLLUTION CONTROL PLANT DUETO HURRICANE,cpd11-20si.pdf
SER002334,"NDF - Rplcmt 6"" sanitary sewers & distribution wtr mains SI",826,DEPT ENVIRONMENTAL PROTECTION,AUGMENTATION OF WATER SUPPLY SYSTEMS,501,RICHMOND,SE-0002R WM-0001,41366,0,0,0,0,37296,0,0,37296,0,0,0,0,37296,0,0,37296,0,0,0,0,74592,0,0,74592,,,"REPLACEMENT OF 6"" SANITARY SEWERS AND DISTRIBUTION WATER MAINS IN LONGVIEW ROAD",cpd11-20si.pdf
SER200256,Extension & Replacmt of San Sewers in Victory Blvd SI,826,DEPT ENVIRONMENTAL PROTECTION,REPLACEMENT OR AUGMENTATION OF EXISTING SYSTEMS,502,RICHMOND,SE-0200R SE-0002R,16608,0,0,0,16608,0,0,0,16608,0,0,0,16608,0,0,0,16608,0,0,0,33216,0,0,0,33216,,,EXTENSION AND REPLACEMENT OF STORM AND SANITARY SEWERS IN VICTORY BLVD.. NOSTRAND,cpd11-20si.pdf
SIBB2-OAK,STATEN ISLAND BLUEBELT - OAKWOOD BEACH,826,DEPT ENVIRONMENTAL PROTECTION,BLUEBELT PROGRAM,500 503,RICHMOND,SE-0716,6814,9679,2846,0,0,0,2972,0,15497,9679,2846,0,0,0,2972,0,15497,19358,5692,0,0,0,5944,0,30994,PROJECT DELAYED DUE TO BUDGETARY CONSTRAINTS,,LAND ACQUISITION FOR THE DEVELOPMENT OF BLUEBELT TYPE STORM SEWERS IN THE OAKWOOD,cpd11-20si.pdf
S136-366G,S I Compost Bagging Building,827,DEPARTMENT OF SANITATION,SOLID WASTE MANAGEMENT,500,RICHMOND,S-0136,895,0,895,0,0,0,0,0,895,0,895,0,0,0,0,0,895,0,1790,0,0,0,0,0,1790,,,CONSTRUCT COMPOST BAGGING BUILDING INCLUDING BAGGING EQUIPMENT,cpd11-20si.pdf
S136-367C,Parking Lot Paving,827,DEPARTMENT OF SANITATION,GARAGES AND FACILITIES,,RICHMOND,S-0136,439,0,136,0,0,0,0,0,136,0,136,0,0,0,0,0,136,0,272,0,0,0,0,0,272,,,PARKING LOT,cpd11-20si.pdf
S136-374P,STATEN ISLAND 2 BOILER REPLACEMENT,827,DEPARTMENT OF SANITATION,GARAGES AND FACILITIES,502,RICHMOND,S-0136,1414,0,101,1165,0,0,0,0,1266,0,101,1165,0,0,0,0,1266,0,202,2330,0,0,0,0,2532,,,BOILER REPLACEMENT,cpd11-20si.pdf
S136-380B,Staten Island Garage 3 Boiler Replacement,827,DEPARTMENT OF SANITATION,GARAGES AND FACILITIES,501,RICHMOND,S-0136,1723,1401,81,0,0,0,0,0,1482,1401,81,0,0,0,0,0,1482,2802,162,0,0,0,0,0,2964,,,REPLACE BOILERS,cpd11-20si.pdf
C5219FM5,STATEN ISLAND FMF FACILITY UTILITIES UPGRADES X823.48,841,DEPARTMENT OF TRANSPORTATION,FERRY MAINTENANCE FACILITY CONSTRUCTION,501,RICHMOND,FA-0026,5280,2646,443,0,0,0,0,0,3089,2646,443,0,0,0,0,0,3089,5292,886,0,0,0,0,0,6178,PROJECT DELAYED DUE TO BUDGETARY CONSTRAINTS,,"HVAC, ELECTRICAL SYSTEM REPAIR",cpd11-20si.pdf
C5517B,DOCKBUILDING HARDWOOD TIMBER,841,DEPARTMENT OF TRANSPORTATION,RECONSTRUCTION OF FERRY TERMINAL FACILITIES,500 501,RICHMOND,FA-0021,1727,4453,534,866,900,989,1506,1000,10248,4453,534,866,900,989,1506,1000,10248,8906,1068,1732,1800,1978,3012,2000,20496,PROJECT DELAYED DUE TO BUDGETARY CONSTRAINTS,CITYWIDE,HARDWOOD TIMBER REPAIR AT FERRY FACILITIES,cpd11-20si.pdf
C5588,REPLACEMENT OF OIL BARGE #5,841,DEPARTMENT OF TRANSPORTATION,RECONSTRUCTION OF FERRY BOATS,500 501,RICHMOND,FA-0313,8050,0,0,0,0,0,0,8050,8050,0,0,0,0,0,0,8050,8050,0,0,0,0,0,0,16100,16100,PROJECT DELAYED DUE TO BUDGETARY CONSTRAINTS,,OIL BARGE#5 REPLACE,cpd11-20si.pdf
C5590,DRYDOCK MOLINARI FERRY BOATS,841,DEPARTMENT OF TRANSPORTATION,RECONSTRUCTION OF FERRY BOATS,500 501,RICHMOND,FA-0313,22550,17418,1826,2259,0,0,0,0,21503,17418,1826,2259,0,0,0,0,21503,34836,3652,4518,0,0,0,0,43006,PROJECT DELAYED DUE TO BUDGETARY CONSTRAINTS,,DRYDOCK F/BOATS,cpd11-20si.pdf
FABLDG45R,Building 45 Rehabilitation,841,DEPARTMENT OF TRANSPORTATION,RECONSTRUCTION OF FERRY TERMINAL FACILITIES,500,RICHMOND,FA-0021,1985,791,7748,0,0,0,0,0,8539,791,7748,0,0,0,0,0,8539,1582,15496,0,0,0,0,0,17078,PROJECT DELAYED DUE TO BUDGETARY CONSTRAINTS,,REHABILITATION OF BUILDING 45,cpd11-20si.pdf
FAFUELFC,Fuel Facility Centrifuge,841,DEPARTMENT OF TRANSPORTATION,FERRY MAINTENANCE FACILITY CONSTRUCTION,500,RICHMOND,FA-0026,125,0,186,0,0,0,0,0,186,0,186,0,0,0,0,0,186,0,372,0,0,0,0,0,372,,,FUEL FACILITY CENTRIFUGE,cpd11-20si.pdf
FASGTRCN,St.George Ferry Terminal Waterfront Remediation,841,DEPARTMENT OF TRANSPORTATION,RECONSTRUCTION OF FERRY TERMINAL FACILITIES,500,RICHMOND,FA-0021,20458,85,0,1000,0,0,0,9115,10200,85,0,1000,0,0,0,9115,10200,170,0,2000,0,0,0,18230,20400,,,SGT FERRY TERMINAL BULKHEAD RECONSTRUCTION,cpd11-20si.pdf
FASGTRHB,SGT Terminal Brick Facade Rehabilitation,841,DEPARTMENT OF TRANSPORTATION,RECONSTRUCTION OF FERRY TERMINAL FACILITIES,500,RICHMOND,FA-0021,750,0,0,0,0,0,50,700,750,0,0,0,0,0,50,700,750,0,0,0,0,0,100,1400,1500,PROJECT DELAYED DUE TO BUDGETARY CONSTRAINTS,,SGT TERMINAL BRICK FACADE REHABILITATION,cpd11-20si.pdf
FASTGCCTV,STG Terminal CCTV Upgrade,841,DEPARTMENT OF TRANSPORTATION,RECONSTRUCTION OF FERRY TERMINAL FACILITIES,500,RICHMOND,FA-0021,1500,0,1657,0,0,0,0,0,1657,0,1657,0,0,0,0,0,1657,0,3314,0,0,0,0,0,3314,PROJECT DELAYED DUE TO BUDGETARY CONSTRAINTS,,STG TERMINAL CCTV UPGRADE,cpd11-20si.pdf
FAUREABRG,SIF Diesel Exhaust Fluid (DEF) Storage & Distribution,841,DEPARTMENT OF TRANSPORTATION,RECONSTRUCTION OF FERRY TERMINAL FACILITIES,500,RICHMOND,FA-0021,1500,298,1202,0,0,0,0,0,1500,298,1202,0,0,0,0,0,1500,596,2404,0,0,0,0,0,3000,,,STATEN ISLAND FERRY UREA BARGE,cpd11-20si.pdf
FBENVCOM,Ferryboat Environmental Compliance Upgrades,841,DEPARTMENT OF TRANSPORTATION,RECONSTRUCTION OF FERRY TERMINAL FACILITIES,500,RICHMOND,FA-0021,5500,391,928,0,0,0,0,2059,3378,391,928,0,0,0,0,2059,3378,782,1856,0,0,0,0,4118,6756,PROJECT DELAYED DUE TO BUDGETARY CONSTRAINTS,,ENVIRONMENTAL COMPLIANCE UPGRADES,cpd11-20si.pdf
FERRYR1SG,"Construction of Ferryrack at Slip1, St. George Terminal",841,DEPARTMENT OF TRANSPORTATION,RECONSTRUCTION OF FERRY TERMINAL FACILITIES,500,RICHMOND,FA-0021,23680,0,0,12464,7220,3996,0,0,23680,0,0,12464,7220,3996,0,0,23680,0,0,24928,14440,7992,0,0,47360,PROJECT DELAYED DUE TO BUDGETARY CONSTRAINTS,,CONSTRUCTION OF FERRYRACK SLIP1 SGT,cpd11-20si.pdf
FERRYR3SG,"Construction of Ferryrack at Slip3, St. George Terminal",841,DEPARTMENT OF TRANSPORTATION,RECONSTRUCTION OF FERRY TERMINAL FACILITIES,500,RICHMOND,FA-0021,7770,0,570,900,6300,0,0,0,7770,0,570,900,6300,0,0,0,7770,0,1140,1800,12600,0,0,0,15540,PROJECT DELAYED DUE TO BUDGETARY CONSTRAINTS,,"CONSTRUCTION OF FERRYRACK AT SLIP3, ST. GEORGE TERMINAL",cpd11-20si.pdf
FERRYRACK,CONSTRUCTION OF FERRY RACK,841,DEPARTMENT OF TRANSPORTATION,RECONSTRUCTION OF FERRY TERMINAL FACILITIES,500 501,RICHMOND,FA-0021,15500,2674,0,325,675,16873,0,6969,27516,2674,0,325,675,16873,0,6969,27516,5348,0,650,1350,33746,0,13938,55032,PROJECT DELAYED DUE TO BUDGETARY CONSTRAINTS,,CONST OF NEW FERRY RACK ST.GEORGE/WHITEHALL,cpd11-20si.pdf
FMFVARNR,FMF Vehicle Access Ramps and Nose Upgrade,841,DEPARTMENT OF TRANSPORTATION,RECONSTRUCTION OF FERRY TERMINAL FACILITIES,500,RICHMOND,FA-0026,4000,508,0,406,0,0,0,0,914,508,0,406,0,0,0,0,914,1016,0,812,0,0,0,0,1828,PROJECT DELAYED DUE TO BUDGETARY CONSTRAINTS,,RAMPS AND NOSE RACK UPGARDE,cpd11-20si.pdf
FVESSGANR,Facility/Vessel Gangways Replacement/Upgrade,841,DEPARTMENT OF TRANSPORTATION,RECONSTRUCTION OF FERRY TERMINAL FACILITIES,500,RICHMOND,FA-0021,3300,287,325,0,0,460,0,1228,2300,287,325,0,0,460,0,1228,2300,574,650,0,0,920,0,2456,4600,PROJECT DELAYED DUE TO BUDGETARY CONSTRAINTS,,GANGWAY REPLACEMENT,cpd11-20si.pdf
HBR249730,BR OVER DAM OVER NORTH END CLOVE LAKE BIN 2249730,841,DEPARTMENT OF TRANSPORTATION,FAIR BRIDGES,500,RICHMOND,P-0508 P-1018,7062,0,440,274,0,815,5704,0,7233,0,440,274,0,815,5704,0,7233,0,880,548,0,1630,11408,0,14466,PROJECT DELAYED DUE TO BUDGETARY CONSTRAINTS,,BR OVER DAM OVER NORTH END CLOVE LAKE BIN 2249730,cpd11-20si.pdf
HBRA24925,BETHEL AVE PED BRIDGE BIN,841,DEPARTMENT OF TRANSPORTATION,FAIR BRIDGES,500,RICHMOND,HB-0215 HB-1012,8129,1820,170,452,0,0,0,0,2442,1820,170,452,0,0,0,0,2442,3640,340,904,0,0,0,0,4884,,BETHEL AVE PED BRIDGE BIN,BETHEL AVE PED BRIDGE,cpd11-20si.pdf
HBRA24939,CEDARVIEW AVE PED BRIDGE BIN,841,DEPARTMENT OF TRANSPORTATION,FAIR BRIDGES,500,RICHMOND,HB-1012 HB-4939,9819,1688,0,253,8823,0,0,0,10764,1688,0,253,8823,0,0,0,10764,3376,0,506,17646,0,0,0,21528,,CEDARVIEW AVE PED BRIDGE BIN,CEDARVIEW AVE PED BRIDGE BIN,cpd11-20si.pdf
HBRA24982,ARTHUR KILL RD/ ARTHUR KILL STREAM BIN#2249820,841,DEPARTMENT OF TRANSPORTATION,FAIR BRIDGES,500,RICHMOND,HB-4982,10350,699,0,682,9350,0,0,0,10731,699,0,682,9350,0,0,0,10731,1398,0,1364,18700,0,0,0,21462,,ARTHUR KILL RD/ ARTHUR KILL STREAM BIN#2249820,ARTHUR KILL RD/ ARTHUR KILL STREAM BIN#2249820,cpd11-20si.pdf
HBRSGFT17,ARMAJANI STRUCTURE,841,DEPARTMENT OF TRANSPORTATION,BRIDGE LIFE EXTENSION AND MISCELLANEOUS WORK,500,RICHMOND,PV-0467,2701,422,0,0,0,0,1100,0,1522,422,0,0,0,0,1100,0,1522,844,0,0,0,0,2200,0,3044,,,ARMAJANI STRUCTURE,cpd11-20si.pdf
HWD104-07,North Bridge Street/South Bridge Street - Construction,841,DEPARTMENT OF TRANSPORTATION,PRIMARY STREET RECONSTRUCTION,500,RICHMOND,HW-0001R,1000,0,0,0,0,0,500,0,500,0,0,0,0,0,500,0,500,0,0,0,0,0,1000,0,1000,PROJECT DELAYED DUE TO BUDGETARY CONSTRAINTS,NORTH BRIDGE STREET/SOUTH BRIDGE STREET - CONSTRUCTION OF A CONNECTORROAD,NORTH BRIDGE STREET/SOUTH BRIDGE STREET - CONSTRUCTION OF A CONNECTORROAD,cpd11-20si.pdf
HWD104-08,Victory CPI,841,DEPARTMENT OF TRANSPORTATION,PRIMARY STREET RECONSTRUCTION,500,RICHMOND,HW-D104,200,0,0,0,0,0,200,0,200,0,0,0,0,0,200,0,200,0,0,0,0,0,400,0,400,PROJECT DELAYED DUE TO BUDGETARY CONSTRAINTS,VICTORY CPI,VICTORY CPI,cpd11-20si.pdf
HWD104-09,Pleasant Plains Park and Ride,841,DEPARTMENT OF TRANSPORTATION,PRIMARY STREET RECONSTRUCTION,500,RICHMOND,HW-D104,2895,0,0,0,4000,2895,0,0,6895,0,0,0,4000,2895,0,0,6895,0,0,0,8000,5790,0,0,13790,PROJECT DELAYED DUE TO BUDGETARY CONSTRAINTS,,"PLEASANT PLAINS PARK AND RIDE FY19 SECTION 254 RESO ADD $895,000 CM BORELLI",cpd11-20si.pdf
HWD104-10,Sidewalks along Forest Hill Rd btw Ashworth and Ballfield,841,DEPARTMENT OF TRANSPORTATION,PRIMARY STREET RECONSTRUCTION,500,RICHMOND,HW-D200,2000,0,0,0,0,0,2000,0,2000,0,0,0,0,0,2000,0,2000,0,0,0,0,0,4000,0,4000,PROJECT DELAYED DUE TO BUDGETARY CONSTRAINTS,NYC PARKS DEPARTMENT - SIDEWALKS ALONG FOREST HILL ROAD BETWEEN ASHWORTH AVENUE AND,NYC PARKS DEPARTMENT - SIDEWALKS ALONG FOREST HILL ROAD BETWEEN ASHWORTH AVENUE AND,cpd11-20si.pdf
HWD104-11,Christopher Lane Extension,841,DEPARTMENT OF TRANSPORTATION,PRIMARY STREET RECONSTRUCTION,500,RICHMOND,HW-D104,4000,0,0,0,0,4000,0,0,4000,0,0,0,0,4000,0,0,4000,0,0,0,0,8000,0,0,8000,PROJECT DELAYED DUE TO BUDGETARY CONSTRAINTS,CHRISTOPHER LANE EXTENSION,CHRISTOPHER LANE EXTENSION,cpd11-20si.pdf
HWR00513,Street Widening in the 50th Council District,841,DEPARTMENT OF TRANSPORTATION,PRIMARY STREET RECONSTRUCTION,500,RICHMOND,HW-D104,1500,0,0,0,0,1500,0,0,1500,0,0,0,0,1500,0,0,1500,0,0,0,0,3000,0,0,3000,PROJECT DELAYED DUE TO BUDGETARY CONSTRAINTS,STREET WIDENING IN THE 50TH COUNCIL DISTRICT,STREET WIDENING IN THE 50TH COUNCIL DISTRICT,cpd11-20si.pdf
HWR700,St George-Richmond Terrace Intersection Improvements,841,DEPARTMENT OF TRANSPORTATION,PRIMARY STREET RECONSTRUCTION,500,RICHMOND,HW-0001R,11300,0,1010,0,0,11300,0,0,12310,0,1010,0,0,11300,0,0,12310,0,2020,0,0,22600,0,0,24620,PROJECT DELAYED DUE TO BUDGETARY CONSTRAINTS,ST GEORGE-RICHMOND TERRANCE INTERSECTION IMPROVEMENTS,ST GEORGE-RICHMOND TERRANCE INTERSECTION IMPROVEMENTS,cpd11-20si.pdf
HWR703,Bay Street Area Safety Improvements,841,DEPARTMENT OF TRANSPORTATION,PRIMARY STREET RECONSTRUCTION,500,RICHMOND,HW-0001R,15316,0,2497,0,2188,13128,0,0,17813,0,2497,0,2188,13128,0,0,17813,0,4994,0,4376,26256,0,0,35626,,,BAY STREET AREA SAFETY IMPROVEMENTS,cpd11-20si.pdf
HWR72017,Richmond Ave Ped Safety,841,DEPARTMENT OF TRANSPORTATION,PRIMARY STREET RECONSTRUCTION,500,RICHMOND,HW-R005,250,0,250,0,0,0,0,0,250,0,250,0,0,0,0,0,250,0,500,0,0,0,0,0,500,PROJECT DELAYED DUE TO BUDGETARY CONSTRAINTS,,RICHMOND AVE PEDESTRIAN SAFETY FOR THE INTERSECTION OF RICHMOND AVE AND FOREST HILL,cpd11-20si.pdf
HWR920,Huguenot Park N Ride,841,DEPARTMENT OF TRANSPORTATION,PRIMARY STREET RECONSTRUCTION,,RICHMOND,HW-0001R,500,0,0,0,0,0,0,500,500,0,0,0,0,0,0,500,500,0,0,0,0,0,0,1000,1000,PROJECT DELAYED DUE TO BUDGETARY CONSTRAINTS,,HUGUENOT PARK N RIDE,cpd11-20si.pdf
HWR921,Mid Island Blue Belt Street Reconstruction,841,DEPARTMENT OF TRANSPORTATION,PRIMARY STREET RECONSTRUCTION,500,RICHMOND,HW-0988,24000,0,0,0,0,0,24000,0,24000,0,0,0,0,0,24000,0,24000,0,0,0,0,0,48000,0,48000,PROJECT DELAYED DUE TO BUDGETARY CONSTRAINTS,MID ISLAND BLUE BELT STREET RECONSTRUCTION,MID ISLAND BLUE BELT STREET RECONSTRUCTION,cpd11-20si.pdf
HWS2021R,PRIOR NOTICE SIDEWALK - STATEN ISLAND,841,DEPARTMENT OF TRANSPORTATION,SIDEWALK RECONSTRUCTION,500,RICHMOND,HW-0200 P-1331,2239,0,1282,0,0,0,0,0,1282,0,1282,0,0,0,0,0,1282,0,2564,0,0,0,0,0,2564,,PRIOR NOTICE SIDEWALKS - STATEN ISLAND,PRIOR NOTICE SIDEWALKS - STATEN ISLAND,cpd11-20si.pdf
HWSCD50,Sidewalk Construction in Council District 50,841,DEPARTMENT OF TRANSPORTATION,PRIMARY STREET RECONSTRUCTION,500,RICHMOND,HW-D104,3000,0,0,0,0,3000,0,0,3000,0,0,0,0,3000,0,0,3000,0,0,0,0,6000,0,0,6000,PROJECT DELAYED DUE TO BUDGETARY CONSTRAINTS,SIDEWALK CONSTRUCTION/RECONSTRUCTION IN COUNCIL DISTRICT 50,SIDEWALK CONSTRUCTION/RECONSTRUCTION IN COUNCIL DISTRICT 50,cpd11-20si.pdf
ITSKOREAN,Intelligent Transportation Systems on Korean Vet Pky X501.65,841,DEPARTMENT OF TRANSPORTATION,SIGNAL INSTALLATION AND COMPUTERIZATION,500,RICHMOND,TF-0001,2069,302,112,0,0,0,0,0,414,302,112,0,0,0,0,0,414,604,224,0,0,0,0,0,828,PROJECT DELAYED DUE TO BUDGETARY CONSTRAINTS,,PIN X501.65 IMPLEMENTING AN ITS SYSTEM (SMART ZONES) ALONG THE KOREANWAR VETERANS,cpd11-20si.pdf
SANDRF09,FMF Emergency Generator Installation,841,DEPARTMENT OF TRANSPORTATION,FERRY MAINTENANCE FACILITY CONSTRUCTION,500,RICHMOND,FA-0026,1131,573,2,0,0,0,31,0,606,573,2,0,0,0,31,0,606,1146,4,0,0,0,62,0,1212,PROJECT DELAYED DUE TO BUDGETARY CONSTRAINTS,,INSTALLATION OF EMERGENCY GENERATOR AT FMF,cpd11-20si.pdf
SANDSIFMF,SIF FACILITIES RESTORATION & REPLACEMENT - HURRICANE SANDY,841,DEPARTMENT OF TRANSPORTATION,RECONSTRUCTION OF FERRY TERMINAL FACILITIES,500,RICHMOND,FA-0021,1541,130,0,0,53,275,0,0,458,130,0,0,53,275,0,0,458,260,0,0,106,550,0,0,916,PROJECT DELAYED DUE TO BUDGETARY CONSTRAINTS,SIF FACILITIES RESTORATION & REPLACEMENT - HURRICANE SANDY,SIF FACILITIES RESTORATION & REPLACEMENT - HURRICANE SANDY,cpd11-20si.pdf
STGTELPAN,St. George Terminal Electrical Panel Upgrade,841,DEPARTMENT OF TRANSPORTATION,RECONSTRUCTION OF FERRY TERMINAL FACILITIES,500,RICHMOND,FA-0021,1300,607,0,0,0,694,0,0,1301,607,0,0,0,694,0,0,1301,1214,0,0,0,1388,0,0,2602,PROJECT DELAYED DUE TO BUDGETARY CONSTRAINTS,,STG TERMINAL ELEC PANEL UPGRADE,cpd11-20si.pdf
STGTROOF,Reconstruction of St.George Terminal Roof,841,DEPARTMENT OF TRANSPORTATION,RECONSTRUCTION OF FERRY TERMINAL FACILITIES,500,RICHMOND,FA-0021,4400,550,773,0,0,5686,0,0,7009,550,773,0,0,5686,0,0,7009,1100,1546,0,0,11372,0,0,14018,PROJECT DELAYED DUE TO BUDGETARY CONSTRAINTS,,RECON OF ST GEORGE TERMINAL ROOF,cpd11-20si.pdf
STGWIRERP,"ST. GEORGE FERRY SLIPS WIRE ROPES, X823.66",841,DEPARTMENT OF TRANSPORTATION,RECONSTRUCTION OF FERRY TERMINAL FACILITIES,500 501,RICHMOND,FA-0021,2750,1853,126,0,0,0,0,24,2003,1853,126,0,0,0,0,24,2003,3706,252,0,0,0,0,48,4006,PROJECT DELAYED DUE TO BUDGETARY CONSTRAINTS,ST. GEORGE FERRY SLIPS WIRE ROPES,ST. GEORGE FERRY SLIPS WIRE ROPES,cpd11-20si.pdf
TFD503-07,GREAT KILLS MUNICIPAL PARKING LOT LIGHTING,841,DEPARTMENT OF TRANSPORTATION,INSTALLATION OF LAMPPOSTS AND LUMINAIRES,500 502 503,RICHMOND,TF-D503,60,0,0,0,0,60,0,0,60,0,0,0,0,60,0,0,60,0,0,0,0,120,0,0,120,PROJECT DELAYED DUE TO BUDGETARY CONSTRAINTS,TRAFFIC CONTROL ISLAND,TRAFFIC CONTROL ISLAND,cpd11-20si.pdf
TFR0103,Smart Lights-various locations Staten Island,841,DEPARTMENT OF TRANSPORTATION,SIGNAL INSTALLATION AND COMPUTERIZATION,500,RICHMOND,TF-0001,850,888,0,372,0,0,0,0,1260,888,0,372,0,0,0,0,1260,1776,0,744,0,0,0,0,2520,PROJECT DELAYED DUE TO BUDGETARY CONSTRAINTS,SMART LIGHTS-VARIOUS LOCATION STATEN ISLAND,TO PURCHASE AND TO INSTALL SMART LIGHTS AT VARIOUS INTERSECTIONS ON STATEN ISLAND,cpd11-20si.pdf
HWPLZ001R,Van Name/Van Pelt Plaza,846,DEPT OF PARKS AND RECREATION,PRIMARY STREET RECONSTRUCTION,500 501,RICHMOND,P-0245R HW-1684,2000,4331,325,0,0,0,0,0,4656,4331,325,0,0,0,0,0,4656,8662,650,0,0,0,0,0,9312,,VAN NAME/VAN PELT,VAN NAME/VAN PELT,cpd11-20si.pdf
NDF-CRLYN,NDF-Cromwell Rec Center RC,846,DEPT OF PARKS AND RECREATION,MAJOR RECREATIONAL FACILITIES AND FACILITY RECONSTRUCTION,500,RICHMOND,ED-0384,46000,0,9200,36800,0,0,0,46000,92000,0,9200,36800,0,0,0,46000,92000,0,18400,73600,0,0,0,92000,184000,,BOROUGH OF STATEN ISLAND,RC CROMWELL REC @ LYONS POOL SITE,cpd11-20si.pdf
NDF-VHALL,NDF-Village Hall Roof,846,DEPT OF PARKS AND RECREATION,NEIGHBORHOOD PARKS AND PLAYGROUNDS,500,RICHMOND,ED-0384,5700,75,0,100,5600,0,0,0,5775,75,0,100,5600,0,0,0,5775,150,0,200,11200,0,0,0,11550,,"CANAL STREET, WATER STREET, BAY STREET.",BAY STREET REZONING -TAPPAN VILLAGE HALL,cpd11-20si.pdf
P-500RINK,"Recon condenser at WW2 Memorial Rink, SI R005-119M",846,DEPT OF PARKS AND RECREATION,"LARGE, MAJOR AND REGIONAL PARK RECONSTRUCTION",500,RICHMOND,P-1018,0,494,56,0,0,0,0,0,550,494,56,0,0,0,0,0,550,988,112,0,0,0,0,0,1100,,MEMORIAL RINK IN STATEN ISLAND,RECONSTRUCTION OF THE RINK CONDENSERS AT THE WW2 MEMORIAL RINK,cpd11-20si.pdf
P-501ALAS,Alice Austen House-Landscape & Site Impr. R117-,846,DEPT OF PARKS AND RECREATION,NEIGHBORHOOD PARKS AND PLAYGROUNDS,500,RICHMOND,P-D020,750,74,0,1199,0,0,0,0,1273,74,0,1199,0,0,0,0,1273,148,0,2398,0,0,0,0,2546,PROJECT DELAYED DUE TO UNFORESEEN SITE/FIELD CONDITION,ALICE AUSTEN HOUSE-LANDSCAPE & SITE IMPR.,ALICE AUSTEN HOUSE-LANDSCAPE & SITE IMPR.,cpd11-20si.pdf
P-501ALIC,Alice Austen House-Exterior Lighting & Security System,846,DEPT OF PARKS AND RECREATION,"LARGE, MAJOR AND REGIONAL PARK RECONSTRUCTION",500 501,RICHMOND,P-1018,175,374,26,68,0,0,0,0,468,374,26,68,0,0,0,0,468,748,52,136,0,0,0,0,936,PROJECT DELAYED DUE TO CHANGES IN SCOPE/DESIGN,SI,ALICE AUSTIN LANDSCAPE RESTORATION R117-,cpd11-20si.pdf
P-501CLEX,Clove Lakes Pk-Adult Exercise Equipment R005-118M,846,DEPT OF PARKS AND RECREATION,NEIGHBORHOOD PARKS AND PLAYGROUNDS,500,RICHMOND,P-D020,700,424,167,0,0,0,0,0,591,424,167,0,0,0,0,0,591,848,334,0,0,0,0,0,1182,,CLOVE LAKES PK-ADULT EXERCISE EQUIPMENT,CLOVE LAKES PK-ADULT EXERCISE EQUIPMENT,cpd11-20si.pdf
P-501CLP2,Cloves Lakes Walking Path Rehab R005,846,DEPT OF PARKS AND RECREATION,"LARGE, MAJOR AND REGIONAL PARK RECONSTRUCTION",500,RICHMOND,P-D020,4250,0,100,386,3764,0,0,0,4250,0,100,386,3764,0,0,0,4250,0,200,772,7528,0,0,0,8500,,STATEN ISLAND,CLOVES LAKES WALKING PATH REHAB R005,cpd11-20si.pdf
P-501FABB,Faber & Lyons Pools -Boiler & Heater Replacement RG-714M,846,DEPT OF PARKS AND RECREATION,NEIGHBORHOOD PARKS AND PLAYGROUNDS,500,RICHMOND,P-1250,1780,2550,0,148,0,0,0,0,2698,2550,0,148,0,0,0,0,2698,5100,0,296,0,0,0,0,5396,PROJECT DELAYED DUE TO CHANGES IN SCOPE/DESIGN,"FABER PARK, STATEN ISLAND",BOILER REPLACEMENT AND HOT WATER HEATER AND ACCESSORIES,cpd11-20si.pdf
P-501FABL,"Faber Park-Install of active recreation, lighting-R008-117M",846,DEPT OF PARKS AND RECREATION,NEIGHBORHOOD PARKS AND PLAYGROUNDS,500,RICHMOND,P-1018 P-D020,5405,6243,1005,0,0,0,0,0,7248,6243,1005,0,0,0,0,0,7248,12486,2010,0,0,0,0,0,14496,,"FABER PARK, STATEN ISLAND","FABER PARK -ISTALLATION OF ACTIVE RECREATION, LIGHTING",cpd11-20si.pdf
P-501FPFA,Faber Park Rec. Center,846,DEPT OF PARKS AND RECREATION,NEIGHBORHOOD PARKS AND PLAYGROUNDS,501,RICHMOND,P-0506,272,0,272,0,0,0,0,0,272,0,272,0,0,0,0,0,272,0,544,0,0,0,0,0,544,,"2175 RICHMOND TERRACE,STATEN ISLAND, NY 10301",FIRE ALARM RECONSTRUCTION AT FABER PARK REC. CENTER.,cpd11-20si.pdf
P-501JWPK,Jones Woods Park Trail Restoration R048,846,DEPT OF PARKS AND RECREATION,NEIGHBORHOOD PARKS AND PLAYGROUNDS,500,RICHMOND,P-D020,0,0,80,0,0,0,0,0,80,0,80,0,0,0,0,0,80,0,160,0,0,0,0,0,160,,STATEN ISLAND,JONES WOODS PARK TRAIL RESTORATION R048,cpd11-20si.pdf
P-501LLCS,Luis Lopez Park Modular Comfort Station Construction,846,DEPT OF PARKS AND RECREATION,NEIGHBORHOOD PARKS AND PLAYGROUNDS,500,RICHMOND,P-0505,2396,540,0,0,0,1876,0,0,2416,540,0,0,0,1876,0,0,2416,1080,0,0,0,3752,0,0,4832,,,LUIS LOPEZ PARK MODULAR COMFORT STATION CONSTRUCTION,cpd11-20si.pdf
P-501LPFA,Lyons Pool Rec. Center,846,DEPT OF PARKS AND RECREATION,NEIGHBORHOOD PARKS AND PLAYGROUNDS,501,RICHMOND,P-0506,299,0,315,0,0,0,0,0,315,0,315,0,0,0,0,0,315,0,630,0,0,0,0,0,630,,"6 VICTORY BLVD STATEN ISLAND, NY 10301",FIRE ALARM RECONSTRUCTION AT LYONS POOL REC. CENTER,cpd11-20si.pdf
P-501MAR2,MARINERS MARSH,846,DEPT OF PARKS AND RECREATION,NEIGHBORHOOD PARKS AND PLAYGROUNDS,500 501,RICHMOND,P-D020,200,59,0,0,0,200,0,0,259,59,0,0,0,200,0,0,259,118,0,0,0,400,0,0,518,PROJECT DELAYED DUE TO CHANGES IN SCOPE/DESIGN,MARINERS MARSH,MARINERS MARSH-PHASE ?,cpd11-20si.pdf
P-501NAPL,Naple Plgr-Reconstruction R073-119M,846,DEPT OF PARKS AND RECREATION,MAJOR RECREATIONAL FACILITIES AND FACILITY RECONSTRUCTION,500,RICHMOND,P-D020,49,307,232,2883,0,0,0,0,3422,307,232,2883,0,0,0,0,3422,614,464,5766,0,0,0,0,6844,,NAPLE PLGR-NETTING SI,NAPLE PLGR-NETTING,cpd11-20si.pdf
P-501SIB2,S.I.B.G-Tuscan Garden & Lemon House R116-105M/405M,846,DEPT OF PARKS AND RECREATION,MAJOR RECREATIONAL FACILITIES AND FACILITY RECONSTRUCTION,501,RICHMOND,P-D020,3390,4463,62,0,0,0,0,0,4525,4463,62,0,0,0,0,0,4525,8926,124,0,0,0,0,0,9050,PROJECT DELAYED DUE TO UNFORESEEN SITE/FIELD CONDITION,"RICHMOND TERRACE AND SNUG HARBOR ROAD, STATEN ISLAND",CONSTRUCTION OF A TUSCAN GARDEN AND LEMON HOUSE WITH THE STATEN ISLAND BOTANICAL,cpd11-20si.pdf
P-501WEPE,WesterleighPk-Play Equipment,846,DEPT OF PARKS AND RECREATION,NEIGHBORHOOD PARKS AND PLAYGROUNDS,500,RICHMOND,P-D020,70,10,0,0,0,50,0,0,60,10,0,0,0,50,0,0,60,20,0,0,0,100,0,0,120,PROJECT DELAYED DUE TO CHANGES IN SCOPE/DESIGN,WESTERLEIGHPK-SI,WESTERLEIGHPK-PLAY EQUIPMENT,cpd11-20si.pdf
P-502CTPK,MIDLAND BEACH PROMENADE ENTRY PLAZA & PARKING LT R046-107MA2,846,DEPT OF PARKS AND RECREATION,"LARGE, MAJOR AND REGIONAL PARK RECONSTRUCTION",502,RICHMOND,HW-R005,5643,6963,121,0,0,0,0,0,7084,6963,121,0,0,0,0,0,7084,13926,242,0,0,0,0,0,14168,PROJECT DELAYED DUE TO UNFORESEEN SITE/FIELD CONDITION,,TO CONSTRUCT A CHILDRENS THEME PK NEAR THE SOUTH BEACH BOARDWALK,cpd11-20si.pdf
P-502GBFA,Greenbelt Rec. Center,846,DEPT OF PARKS AND RECREATION,NEIGHBORHOOD PARKS AND PLAYGROUNDS,502,RICHMOND,P-0506,305,0,305,0,0,0,0,0,305,0,305,0,0,0,0,0,305,0,610,0,0,0,0,0,610,,"501 BRIELLE AVENUE, STATEN ISLAND, NEW YORK 10314",FIRE ALARM RECONSTRUCTION AT GREENBELT REC. CENTER,cpd11-20si.pdf
P-502NDPK,New Dorp Center Kitchen Recon. (R016-214MA),846,DEPT OF PARKS AND RECREATION,BEACHES AND BOARDWALKS,500,RICHMOND,P-D020 P-R245 P-1018,989,479,23,487,0,0,0,0,989,479,23,487,0,0,0,0,989,958,46,974,0,0,0,0,1978,,SI,NEW DORP BEACH (126 CEDAR GROVE AVE) KITCHEN RC,cpd11-20si.pdf
P-502PIER,MIDLAND BEACH RECREATIONAL PIER & C/S / R046-100M/400M,846,DEPT OF PARKS AND RECREATION,BEACHES AND BOARDWALKS,502,RICHMOND,P-R245,9203,8593,91,0,0,0,0,0,8684,8593,91,0,0,0,0,0,8684,17186,182,0,0,0,0,0,17368,PROJECT DELAYED DUE TO CHANGES IN SCOPE/DESIGN,FT WADSWORTH TO MILLER FIELD,,cpd11-20si.pdf
P-503BFDS,Ballfields in Dugan & Schmul parks,846,DEPT OF PARKS AND RECREATION,LAND ACQUISITION AND TREE PLANTING,500,RICHMOND,P-D020,1920,1541,0,77,0,0,0,0,1618,1541,0,77,0,0,0,0,1618,3082,0,154,0,0,0,0,3236,PROJECT DELAYED DUE TO UNFORESEEN SITE/FIELD CONDITION,DUGAN AND SCHMUL PARKS,R/C OF BALLFIELDS IN DUGAN & SCHMUL PARKS,cpd11-20si.pdf
P-503CHP1,Conference House Park Pavilion R006-213M,846,DEPT OF PARKS AND RECREATION,NEIGHBORHOOD PARKS AND PLAYGROUNDS,500 503,RICHMOND,P-0245R,2750,6724,242,401,0,0,0,0,7367,6724,242,401,0,0,0,0,7367,13448,484,802,0,0,0,0,14734,PROJECT DELAYED DUE TO CHANGES IN SCOPE/DESIGN,CONFERENCE HOUSE PK PAVILION,CONFERENCE HOUSE PK PAVILION,cpd11-20si.pdf
P-503CHPV,Conference House Park Pavilion,846,DEPT OF PARKS AND RECREATION,NEIGHBORHOOD PARKS AND PLAYGROUNDS,500 503,RICHMOND,P-D020,765,131,0,0,104,0,0,0,235,131,0,0,104,0,0,0,235,262,0,0,208,0,0,0,470,PROJECT DELAYED DUE TO CHANGES IN SCOPE/DESIGN,,CONFERENCE HOUSE PARK PAVILION,cpd11-20si.pdf
P-503CRBP,CRESCENT BEACH PARK CONS 135-113MA,846,DEPT OF PARKS AND RECREATION,"LARGE, MAJOR AND REGIONAL PARK RECONSTRUCTION",500 503,RICHMOND,P-D020 P-1018,1200,2891,96,35,0,0,0,0,3022,2891,96,35,0,0,0,0,3022,5782,192,70,0,0,0,0,6044,PROJECT DELAYED DUE TO UNFORESEEN SITE/FIELD CONDITION,"CRESCENT BEACH PARK, BOROUGH OF S.I.",CONSTRUCTION OF NEW PARK,cpd11-20si.pdf
P-503DUPL,DUGAN PLAYGROUND R/C R026-,846,DEPT OF PARKS AND RECREATION,NEIGHBORHOOD PARKS AND PLAYGROUNDS,500,RICHMOND,P-D020 P-0245R,3732,256,21,3655,0,0,0,0,3932,256,21,3655,0,0,0,0,3932,512,42,7310,0,0,0,0,7864,,DUGAN PLAYGROUND R/C R026-,DUGAN PLAYGROUND R/C R026-,cpd11-20si.pdf
P-503GCPG,Greencroft Playgroud R089,846,DEPT OF PARKS AND RECREATION,NEIGHBORHOOD PARKS AND PLAYGROUNDS,503,RICHMOND,P-D020,1500,0,0,1500,0,0,0,0,1500,0,0,1500,0,0,0,0,1500,0,0,3000,0,0,0,0,3000,,STATEN ISLAND,GREENCROFT PLAYGROUD R089,cpd11-20si.pdf
P-503GCPL,Greencroft Plgr- R/C of Comfort Station R089-115M,846,DEPT OF PARKS AND RECREATION,NEIGHBORHOOD PARKS AND PLAYGROUNDS,500 503,RICHMOND,P-R245,3102,3444,102,0,0,0,0,0,3546,3444,102,0,0,0,0,0,3546,6888,204,0,0,0,0,0,7092,PROJECT DELAYED DUE TO CHANGES IN SCOPE/DESIGN,"GREENCROFT PLAYGROUND , BROOKLYN",RECONSTRUCTION OF THE COMFORT STATION AT GREENCROFT PLAYGROUND,cpd11-20si.pdf
P-503HUG,HUGEUNOT PONDS PARK EXPANSION,846,DEPT OF PARKS AND RECREATION,"LARGE, MAJOR AND REGIONAL PARK RECONSTRUCTION",500 503,RICHMOND,P-D020,350,0,0,0,0,153,0,0,153,0,0,0,0,153,0,0,153,0,0,0,0,306,0,0,306,PROJECT DELAYED DUE TO CHANGES IN SCOPE/DESIGN,BILLIOU & COMELY STS B/W HUGENOT & KINGDOM AVES,HUGEUNOT PONDS PARK EXPANSION,cpd11-20si.pdf
P-503SNCS,Seaside Nature Pk CS construction R145-119M,846,DEPT OF PARKS AND RECREATION,NEIGHBORHOOD PARKS AND PLAYGROUNDS,500 503,RICHMOND,P-D020 P-0505,1207,546,12,0,6753,0,0,0,7311,546,12,0,6753,0,0,0,7311,1092,24,0,13506,0,0,0,14622,PROJECT DELAYED DUE TO BUDGETARY CONSTRAINTS,"SEASIDE NATURE PARK, SI",THE CONSTRUCTION OF A NEW COMFORT STATION AT SEASIDE NATURE PARK,cpd11-20si.pdf
P-503TLCH,Conference House Tot Lot (Lenape plgr) RG-212M WO5,846,DEPT OF PARKS AND RECREATION,NEIGHBORHOOD PARKS AND PLAYGROUNDS,500,RICHMOND,P-D020,500,555,45,0,0,0,0,0,600,555,45,0,0,0,0,0,600,1110,90,0,0,0,0,0,1200,,CONFERENCE HOUSE PARK,CONSTRUCTION OF TOT LOT AT CONFERENCE HOUSE PARK,cpd11-20si.pdf
P-503TOTT,Tottenville Shoreline Protection - Staten Island,846,DEPT OF PARKS AND RECREATION,NEIGHBORHOOD PARKS AND PLAYGROUNDS,500,RICHMOND,PU-0100 PU-0200,19225,100,0,19200,0,0,0,0,19300,100,0,19200,0,0,0,0,19300,200,0,38400,0,0,0,0,38600,,,TOTTENVILLE SHORELINE PROTECTION - MANHATTAN,cpd11-20si.pdf
P-5ALTARF,Recon of Roofing systems at Altamont,846,DEPT OF PARKS AND RECREATION,NEIGHBORHOOD PARKS AND PLAYGROUNDS,500,RICHMOND,P-1249,302,27,262,0,0,0,0,0,289,27,262,0,0,0,0,0,289,54,524,0,0,0,0,0,578,,STATEN ISLAND,RECON OF ROOFING SYSTEMS AT ALTAMONT,cpd11-20si.pdf
P-5ANCH01,Anchor Park Site - South Pk Fresh kills DESIGN,846,DEPT OF PARKS AND RECREATION,"LARGE, MAJOR AND REGIONAL PARK RECONSTRUCTION",500,RICHMOND,P-1018 P-1321,4492,3769,141,1165,0,0,0,0,5075,3769,141,1165,0,0,0,0,5075,7538,282,2330,0,0,0,0,10150,PROJECT DELAYED DUE TO CHANGES IN SCOPE/DESIGN,SOUTH PK FRESH KILS,ANCHOR PARK SITE - SOUTH PK FRESH KILS,cpd11-20si.pdf
P-5ANCH02,Anchor Park Site - South Pk Construction /Fresh kills,846,DEPT OF PARKS AND RECREATION,"LARGE, MAJOR AND REGIONAL PARK RECONSTRUCTION",500,RICHMOND,P-1321,27000,0,0,0,0,0,27000,0,27000,0,0,0,0,0,27000,0,27000,0,0,0,0,0,54000,0,54000,,ANCHOR PARK SITE - SOUTH PK CONSTRUCTION /FRESH KILLS,ANCHOR PARK SITE - SOUTH PK CONSTRUCTION /FRESH KILLS,cpd11-20si.pdf
P-5ANCH03,Anchor Park Site - South Pk CS /Fresh kills,846,DEPT OF PARKS AND RECREATION,"LARGE, MAJOR AND REGIONAL PARK RECONSTRUCTION",500,RICHMOND,P-1321,5200,0,0,0,5200,0,0,0,5200,0,0,0,5200,0,0,0,5200,0,0,0,10400,0,0,0,10400,,ANCHOR PARK SITE - SOUTH PK CS /FRESH KILLS,ANCHOR PARK SITE - SOUTH PK CS /FRESH KILLS,cpd11-20si.pdf
P-5ARDTR,Arden Heights Wood -Trails & Parking R120-117M,846,DEPT OF PARKS AND RECREATION,NEIGHBORHOOD PARKS AND PLAYGROUNDS,500,RICHMOND,P-R245 P-0245R,0,326,1197,452,0,0,0,0,1975,326,1197,452,0,0,0,0,1975,652,2394,904,0,0,0,0,3950,PROJECT DELAYED DUE TO CHANGES IN SCOPE/DESIGN,"ARDEN HEIGHTS WOOD -TRAILS & PARKING, SI",ARDEN HEIGHTS WOOD -TRAILS & PARKING,cpd11-20si.pdf
P-5BBPAV,Multisite SI-Basketball Cours paving R,846,DEPT OF PARKS AND RECREATION,NEIGHBORHOOD PARKS AND PLAYGROUNDS,500,RICHMOND,P-0245R P-D020,555,2768,391,0,0,0,0,0,3159,2768,391,0,0,0,0,0,3159,5536,782,0,0,0,0,0,6318,,MULTISITE SI-BASKETBALL COURS PAVING,MULTISITE SI-BASKETBALL COURS PAVING,cpd11-20si.pdf
P-5BEDFGR,Bedford Green-Passive landscape,846,DEPT OF PARKS AND RECREATION,NEIGHBORHOOD PARKS AND PLAYGROUNDS,500,RICHMOND,P-D020,200,0,0,0,0,200,0,0,200,0,0,0,0,200,0,0,200,0,0,0,0,400,0,0,400,PROJECT DELAYED DUE TO CHANGES IN SCOPE/DESIGN,BEDFORD GREEN-PASSIVE LANDSCAPE,BEDFORD GREEN-PASSIVE LANDSCAPE,cpd11-20si.pdf
P-5BLOOJF,Bloomingdale Park Junior Fields Installation,846,DEPT OF PARKS AND RECREATION,NEIGHBORHOOD PARKS AND PLAYGROUNDS,500,RICHMOND,P-D020 P-R245,4625,4354,1605,0,0,0,0,0,5959,4354,1605,0,0,0,0,0,5959,8708,3210,0,0,0,0,0,11918,PROJECT DELAYED DUE TO CHANGES IN SCOPE/DESIGN,,BLOOMINGDALE PARK - INSTALLATION OF JUNIOR FIELDS,cpd11-20si.pdf
P-5BUNBCH,Buono Beach-Reconstruction of Fountain,846,DEPT OF PARKS AND RECREATION,BEACHES AND BOARDWALKS,500,RICHMOND,P-1018,131,0,131,0,0,0,0,0,131,0,131,0,0,0,0,0,131,0,262,0,0,0,0,0,262,,,BUONO BEACH-RECONSTRUCTION OF FOUNTAIN,cpd11-20si.pdf
P-5CARLPK,Carlton Park & Ida Court--Basketball Courts and Field,846,DEPT OF PARKS AND RECREATION,NEIGHBORHOOD PARKS AND PLAYGROUNDS,503,RICHMOND,P-R245 P-D020 P-1018,338,2071,84,226,0,0,0,0,2381,2071,84,226,0,0,0,0,2381,4142,168,452,0,0,0,0,4762,PROJECT DELAYED DUE TO UNFORESEEN SITE/FIELD CONDITION,,CARLTON PARK REHABILITATION,cpd11-20si.pdf
P-5CHARCS,Fairview Park - Cons. Comfort Station,846,DEPT OF PARKS AND RECREATION,MAJOR RECREATIONAL FACILITIES AND FACILITY RECONSTRUCTION,503,RICHMOND,P-D020 P-R245,3954,3258,307,0,0,0,0,0,3565,3258,307,0,0,0,0,0,3565,6516,614,0,0,0,0,0,7130,,,FAIRVEIEW PARK COMFORT STATION RECON,cpd11-20si.pdf
P-5CHARLS,Fairview Park Landscape Construction,846,DEPT OF PARKS AND RECREATION,MAJOR RECREATIONAL FACILITIES AND FACILITY RECONSTRUCTION,503,RICHMOND,P-R245 P-0245R P-D020,12299,8485,630,2507,0,0,0,0,11622,8485,630,2507,0,0,0,0,11622,16970,1260,5014,0,0,0,0,23244,,,FAIRVIEW PARK LANDSCAPE CONSTRUCTION,cpd11-20si.pdf
P-5CLAWS,RENOVATION OF CLAWSON PLAYGROUND,846,DEPT OF PARKS AND RECREATION,NEIGHBORHOOD PARKS AND PLAYGROUNDS,503,RICHMOND,P-D020 P-0245R,1900,2931,249,0,0,0,0,0,3180,2931,249,0,0,0,0,0,3180,5862,498,0,0,0,0,0,6360,,"ADELAIDE AVE., CLAWSON ST.",PARKS - CLAWSON PLAYGROUND RENOVATION,cpd11-20si.pdf
P-5CLVCHL,Recon chiller slab & header at Cloves Lake Park,846,DEPT OF PARKS AND RECREATION,NEIGHBORHOOD PARKS AND PLAYGROUNDS,500,RICHMOND,P-1250,1656,123,0,0,1300,0,0,0,1423,123,0,0,1300,0,0,0,1423,246,0,0,2600,0,0,0,2846,,CITYWIDE,RECON CHILLER SLAB & HEADER AT CLOVES LAKE PARK,cpd11-20si.pdf
P-5CLVLKP,Clove Lakes Park,846,DEPT OF PARKS AND RECREATION,NEIGHBORHOOD PARKS AND PLAYGROUNDS,500,RICHMOND,P-1018,1500,30,0,1500,0,0,0,0,1530,30,0,1500,0,0,0,0,1530,60,0,3000,0,0,0,0,3060,,"CLOVE LAKES PARK, STATEN ISLAND",CLOVE LAKES PARK,cpd11-20si.pdf
P-5CPIB12,CPI PH1- SI COMFORT STATIONS -BUNDLE 3 RG-216MA,846,DEPT OF PARKS AND RECREATION,"LARGE, MAJOR AND REGIONAL PARK RECONSTRUCTION",500,RICHMOND,P-1018,9676,8264,172,1355,0,0,0,0,9791,8264,172,1355,0,0,0,0,9791,16528,344,2710,0,0,0,0,19582,,,CPI - SI COMFORT STATIONS -BUNDLE 3 RG-216M,cpd11-20si.pdf
P-5CPIBN6,CPI - SI Comfort Stations-Bundle 2 RG-515M,846,DEPT OF PARKS AND RECREATION,"LARGE, MAJOR AND REGIONAL PARK RECONSTRUCTION",500,RICHMOND,P-1018,8076,3889,0,73,0,0,0,0,3962,3889,0,73,0,0,0,0,3962,7778,0,146,0,0,0,0,7924,PROJECT DELAYED DUE TO CHANGES IN SCOPE/DESIGN,CPI-SI COMFORT STATIONS-BUNDLE 6,CPI-SI COMFORT STATIONS-BUNDLE 2,cpd11-20si.pdf
P-5CPIDMT,CPI PH1 - DeMatti Plgd,846,DEPT OF PARKS AND RECREATION,"LARGE, MAJOR AND REGIONAL PARK RECONSTRUCTION",500,RICHMOND,P-1018 WP-0169,3375,5426,422,323,0,0,0,0,6171,5426,422,323,0,0,0,0,6171,10852,844,646,0,0,0,0,12342,PROJECT DELAYED PENDING APPROVAL OF NECESSARY PERMITS,"CPI - DEMATTI PLGD, STATEN ISLAND",CPI - DEMATTI PLGD,cpd11-20si.pdf
P-5CPIMDP,CPI PH1- McDonald Playground reconstruction,846,DEPT OF PARKS AND RECREATION,"LARGE, MAJOR AND REGIONAL PARK RECONSTRUCTION",500,RICHMOND,P-1018,4490,5798,0,100,0,0,0,0,5898,5798,0,100,0,0,0,0,5898,11596,0,200,0,0,0,0,11796,PROJECT DELAYED DUE TO UNFORESEEN SITE/FIELD CONDITION,STATEN ISLAND CPI-MCDONALD PLAYGROUND,CPI-MCDONALD PLAYGROUND RECONSTRUCTION,cpd11-20si.pdf
P-5CPIMH,CPI PH2 - Mariner's Harbor Playground-RC R036-118M,846,DEPT OF PARKS AND RECREATION,"LARGE, MAJOR AND REGIONAL PARK RECONSTRUCTION",500,RICHMOND,P-1018 P-D020,2258,3445,656,0,0,0,0,0,4101,3445,656,0,0,0,0,0,4101,6890,1312,0,0,0,0,0,8202,,CPI PH - MARINER'S HARBOR PLAYGROUND-RECONSTRUCTION,CPI PH2 - MARINER'S HARBOR PLAYGROUND-RECONSTRUCTION,cpd11-20si.pdf
P-5CPISTP,CPI PH2 - RC-Stapleton Playground- R061-116M,846,DEPT OF PARKS AND RECREATION,"LARGE, MAJOR AND REGIONAL PARK RECONSTRUCTION",500,RICHMOND,P-1018 P-D020 WP-0169,11076,10285,1477,128,0,0,0,0,11890,10285,1477,128,0,0,0,0,11890,20570,2954,256,0,0,0,0,23780,,CPI - STAPLETON PLAYGROUND-RECONSTRUCTION,CPI - STAPLETON PLAYGROUND-RECONSTRUCTION,cpd11-20si.pdf
P-5DONGAN,Dongan Plgr-reconstruction,846,DEPT OF PARKS AND RECREATION,NEIGHBORHOOD PARKS AND PLAYGROUNDS,500,RICHMOND,P-D020,3875,125,0,0,3500,0,0,0,3625,125,0,0,3500,0,0,0,3625,250,0,0,7000,0,0,0,7250,,"DONGAN PLGR-RECONSTRUCTION, SI",DONGAN PLGR-RECONSTRUCTION,cpd11-20si.pdf
P-5FABBAS,Faber Park -Remove Equipment & Install Basketball Court,846,DEPT OF PARKS AND RECREATION,"LARGE, MAJOR AND REGIONAL PARK RECONSTRUCTION",500,RICHMOND,P-D020,700,75,0,920,1046,0,0,0,2041,75,0,920,1046,0,0,0,2041,150,0,1840,2092,0,0,0,4082,,FABER PARK -REMOVE EQUIPMENT & INSTALL BASKETBALL COURT,FABER PARK -REMOVE EQUIPMENT & INSTALL BASKETBALL COURT,cpd11-20si.pdf
P-5FABRWF,Faber Park Waterfront,846,DEPT OF PARKS AND RECREATION,"LARGE, MAJOR AND REGIONAL PARK RECONSTRUCTION",500,RICHMOND,P-0501 PU-0200,1505,50,9,320,1044,0,0,0,1423,50,9,320,1044,0,0,0,1423,100,18,640,2088,0,0,0,2846,,,FABER PARK WATERFRONT,cpd11-20si.pdf
P-5FRES10,FRESH KILLS OWL HOLLOW FIELDS C/S,846,DEPT OF PARKS AND RECREATION,"LARGE, MAJOR AND REGIONAL PARK RECONSTRUCTION",500,RICHMOND,P-1321,9160,744,752,341,1114,6799,0,0,9750,744,752,341,1114,6799,0,0,9750,1488,1504,682,2228,13598,0,0,19500,,,FRESH KILLS OWL HOLLOW FIELDS C/S,cpd11-20si.pdf
P-5FRES11,Owl Hollow Parking Access Road,846,DEPT OF PARKS AND RECREATION,"LARGE, MAJOR AND REGIONAL PARK RECONSTRUCTION",500,RICHMOND,P-1321,0,0,500,0,0,0,0,0,500,0,500,0,0,0,0,0,500,0,1000,0,0,0,0,0,1000,,,OWL HOLLOW PARKING ACCESS ROAD,cpd11-20si.pdf
P-5FRESH,Fresh Kills - East Park,846,DEPT OF PARKS AND RECREATION,"LARGE, MAJOR AND REGIONAL PARK RECONSTRUCTION",500 503 502,RICHMOND,P-1321,92680,711,0,0,0,0,0,0,711,711,0,0,0,0,0,0,711,1422,0,0,0,0,0,0,1422,PROJECT DELAYED DUE TO CHANGES IN SCOPE/DESIGN,STATEN ISLAND,DEVELOP SITE,cpd11-20si.pdf
P-5FRESH9,Fresh Kills - construction of North Park R017-115M,846,DEPT OF PARKS AND RECREATION,"LARGE, MAJOR AND REGIONAL PARK RECONSTRUCTION",500 502 503,RICHMOND,P-1321,2080,26258,903,2804,0,0,0,0,29965,26258,903,2804,0,0,0,0,29965,52516,1806,5608,0,0,0,0,59930,PROJECT DELAYED DUE TO UNFORESEEN SITE/FIELD CONDITION,STATEN ISLAND,NORTH PARK MULTI-USE PATH AND WETLAND RESTORATION,cpd11-20si.pdf
P-5FRESHS,Fresh Kills - Springville Greenway bicycle path RG-410M,846,DEPT OF PARKS AND RECREATION,"LARGE, MAJOR AND REGIONAL PARK RECONSTRUCTION",500 502 503,RICHMOND,P-1018,12250,3230,0,0,0,0,0,0,3230,3230,0,0,0,0,0,0,3230,6460,0,0,0,0,0,0,6460,PROJECT DELAYED DUE TO UNFORESEEN SITE/FIELD CONDITION,"SECTION OF FRESH KILLS PARK, BOROUGH OF STATEN ISLAND","SECTION OF FRESH KILLS PARK, BOROUGH OF STATEN ISLAND",cpd11-20si.pdf
P-5GBPATH,Greenbelt Perimeter Path R013-112M,846,DEPT OF PARKS AND RECREATION,NEIGHBORHOOD PARKS AND PLAYGROUNDS,500 502,RICHMOND,P-1237,576,332,0,0,0,0,0,0,332,332,0,0,0,0,0,0,332,664,0,0,0,0,0,0,664,PROJECT DELAYED DUE TO UNFORESEEN SITE/FIELD CONDITION,,GREENBELT PERMITER PATHWAY,cpd11-20si.pdf
P-5GBRCTF,Greenbelt Rec.Cntr-Constr. of turf field,846,DEPT OF PARKS AND RECREATION,NEIGHBORHOOD PARKS AND PLAYGROUNDS,500,RICHMOND,P-D020,5500,274,18,0,5283,0,0,0,5575,274,18,0,5283,0,0,0,5575,548,36,0,10566,0,0,0,11150,,"GREENBELT REC.CNTR-CONSTR. OF TURF FIELD, SI",GREENBELT REC.CNTR-CONSTR. OF TURF FIELD,cpd11-20si.pdf
P-5GKBIKE,GREAT KILLS BICYCLE PATH R016-204MA,846,DEPT OF PARKS AND RECREATION,"LARGE, MAJOR AND REGIONAL PARK RECONSTRUCTION",503,RICHMOND,P-1322,1600,501,0,0,0,0,0,0,501,501,0,0,0,0,0,0,501,1002,0,0,0,0,0,0,1002,PROJECT DELAYED DUE TO UNFORESEEN HAZARDOUS CONDITION,"GREAT KILLS PARK, STATEN ISLAND",CONSTRUCTION OF GREAT KILLS BICYCLE PATH,cpd11-20si.pdf
P-5GRNBRC,Greenbelt Rec Ctr Partial RC R129-119M,846,DEPT OF PARKS AND RECREATION,NEIGHBORHOOD PARKS AND PLAYGROUNDS,500,RICHMOND,P-0506 P-0505,1000,90,0,0,1224,0,0,0,1314,90,0,0,1224,0,0,0,1314,180,0,0,2448,0,0,0,2628,,GREENBELT RECREATION CENTER IN SI,PARTIAL RECONSTRUCTION OF GREENBELT RECREATION CENTER IN SI,cpd11-20si.pdf
P-5IRENE,IRENE - Wolfe's Pond Park Berm,846,DEPT OF PARKS AND RECREATION,NEIGHBORHOOD PARKS AND PLAYGROUNDS,500,RICHMOND,P-1018,943,14,0,85,0,0,0,0,99,14,0,85,0,0,0,0,99,28,0,170,0,0,0,0,198,,WOLFE'S POND PARK BERM,WOLFE'S POND PARK BERM,cpd11-20si.pdf
P-5JENNRF,Recon of Roofing systems at Jennifer CS,846,DEPT OF PARKS AND RECREATION,NEIGHBORHOOD PARKS AND PLAYGROUNDS,500,RICHMOND,P-1249,72,0,62,0,0,0,0,0,62,0,62,0,0,0,0,0,62,0,124,0,0,0,0,0,124,,STATEN ISLAND,RECON OF ROOFING SYSTEMS AT JENNIFER CS,cpd11-20si.pdf
P-5LILOPL,Luis LopezPlgr- Play Equipment (R125-118M),846,DEPT OF PARKS AND RECREATION,NEIGHBORHOOD PARKS AND PLAYGROUNDS,500,RICHMOND,P-D020 P-0245R,3360,3161,277,0,0,0,0,0,3438,3161,277,0,0,0,0,0,3438,6322,554,0,0,0,0,0,6876,,LUIZ LOPEZPLGR- PLAY EQUIPMENT SI,LUIZ LOPEZPLGR- PLAY EQUIPMENT,cpd11-20si.pdf
P-5MAPLWD,Maple Woods-Passive landscape,846,DEPT OF PARKS AND RECREATION,NEIGHBORHOOD PARKS AND PLAYGROUNDS,500,RICHMOND,P-D020,200,36,0,0,0,200,0,0,236,36,0,0,0,200,0,0,236,72,0,0,0,400,0,0,472,PROJECT DELAYED DUE TO CHANGES IN SCOPE/DESIGN,MAPLE WOODS-PASSIVE LANDSCAPE,MAPLE WOODS-PASSIVE LANDSCAPE,cpd11-20si.pdf
P-5MCARPK,Gen. MacArthur Park Baseball Field Renovation R067-117M,846,DEPT OF PARKS AND RECREATION,NEIGHBORHOOD PARKS AND PLAYGROUNDS,502,RICHMOND,P-R245 P-D020 P-1018,2620,5719,848,0,0,0,0,0,6567,5719,848,0,0,0,0,0,6567,11438,1696,0,0,0,0,0,13134,PROJECT DELAYED DUE TO CHANGES IN SCOPE/DESIGN,,GEN. MACARTHUR PARK BASEBALL FIELD RENOVATION,cpd11-20si.pdf
P-5OAKBRM,Oakwood Beach Berm R016-312M,846,DEPT OF PARKS AND RECREATION,NEIGHBORHOOD PARKS AND PLAYGROUNDS,500 503,RICHMOND,P-D020,900,617,42,0,0,0,0,0,659,617,42,0,0,0,0,0,659,1234,84,0,0,0,0,0,1318,PROJECT DELAYED PENDING APPROVAL OF NECESSARY PERMITS,,OAKWOOD BEACH BERM,cpd11-20si.pdf
P-5PKTR21,FY21-Park Trees - Staten Island,846,DEPT OF PARKS AND RECREATION,LAND ACQUISITION AND TREE PLANTING,500,RICHMOND,P-0822,2000,75,2000,0,0,0,0,0,2075,75,2000,0,0,0,0,0,2075,150,4000,0,0,0,0,0,4150,,FY21-PARK TREES - STATEH ISLAND,FY21-PARK TREES - STATEH ISLAND,cpd11-20si.pdf
P-5PL15A5,$1Contract-Silver Lake Pk Path R/C WO# RG-215M,846,DEPT OF PARKS AND RECREATION,NEIGHBORHOOD PARKS AND PLAYGROUNDS,500,RICHMOND,P-1018,989,905,0,96,0,0,0,0,1001,905,0,96,0,0,0,0,1001,1810,0,192,0,0,0,0,2002,,SILVER LAKE PK PATH R/C WO#5,$1CONTRACT-SILVER LAKE PK PATH R/C WO#5,cpd11-20si.pdf
P-5PLG15B,R/C of parks & plgr in Staten Island RG-315MA1,846,DEPT OF PARKS AND RECREATION,NEIGHBORHOOD PARKS AND PLAYGROUNDS,500,RICHMOND,P-1018,3537,2747,197,486,0,0,0,0,3430,2747,197,486,0,0,0,0,3430,5494,394,972,0,0,0,0,6860,PROJECT DELAYED DUE TO UNFORESEEN SITE/FIELD CONDITION,WOLFE'S POND DOG RUN & BLOOMINGDALE BOCCE COURT-R/C,WOLFE'S POND DOG RUN & BLOOMINGDALE BOCCE COURT-R/C,cpd11-20si.pdf
P-5PNYC08,PlaNYC-Ocean Breeze Beach Parking Lot,846,DEPT OF PARKS AND RECREATION,"LARGE, MAJOR AND REGIONAL PARK RECONSTRUCTION",500,RICHMOND,P-1018,310,0,0,310,0,0,0,0,310,0,0,310,0,0,0,0,310,0,0,620,0,0,0,0,620,,PLANYC-OCEAN BREEZE BEACH PARKING LOT,PLANYC-OCEAN BREEZE BEACH PARKING LOT,cpd11-20si.pdf
P-5PRALCS,Prall Playground-Reconstruction of Comfort Station,846,DEPT OF PARKS AND RECREATION,NEIGHBORHOOD PARKS AND PLAYGROUNDS,500,RICHMOND,P-0505,1790,265,39,1410,126,0,0,0,1840,265,39,1410,126,0,0,0,1840,530,78,2820,252,0,0,0,3680,,,PRALL PLAYGROUND-RECONSTRUCTION OF COMFORT STATION,cpd11-20si.pdf
P-5PRESPL,Prescott Playground RC R085-118M,846,DEPT OF PARKS AND RECREATION,NEIGHBORHOOD PARKS AND PLAYGROUNDS,500,RICHMOND,P-R245 P-D020,5456,4220,262,0,0,0,0,0,4482,4220,262,0,0,0,0,0,4482,8440,524,0,0,0,0,0,8964,,"PRESCOTT PLGR-CREATION OF SENCORY PLGR, SI",PRESCOTT PLGR-CREATION OF SENCORY PLGR,cpd11-20si.pdf
P-5RECSI,Greenbelt Rec Ctr RC in Staten Island,846,DEPT OF PARKS AND RECREATION,NEIGHBORHOOD PARKS AND PLAYGROUNDS,500,RICHMOND,P-1018 P-0506 P-0505,965,194,49,0,1434,0,0,0,1677,194,49,0,1434,0,0,0,1677,388,98,0,2868,0,0,0,3354,PROJECT DELAYED DUE TO CHANGES IN SCOPE/DESIGN,RECON GREENBELT REC CTR IN STATEN ISLAND,RECON GREENBELT REC CTR IN STATEN ISLAND,cpd11-20si.pdf
P-5REFO20,Reforestation FY20 Staten Is,846,DEPT OF PARKS AND RECREATION,LAND ACQUISITION AND TREE PLANTING,500,RICHMOND,P-0822,1100,30,1150,0,0,0,0,0,1180,30,1150,0,0,0,0,0,1180,60,2300,0,0,0,0,0,2360,,REFORESTATION FY20 STATEN IS,REFORESTATION FY20 STATEN IS,cpd11-20si.pdf
P-5SIPOOL,Staten Island Indoor Pool,846,DEPT OF PARKS AND RECREATION,MAJOR RECREATIONAL FACILITIES AND FACILITY RECONSTRUCTION,500,RICHMOND,P-0632,50000,0,0,0,0,0,0,77200,77200,0,0,0,0,0,0,77200,77200,0,0,0,0,0,0,154400,154400,,,STATEN ISLAND INDOOR POOL,cpd11-20si.pdf
P-5SIWETL,STATEN ISLAND BOTANICAL GARDEN WETLAND RC/ R116-104M,846,DEPT OF PARKS AND RECREATION,MAJOR RECREATIONAL FACILITIES AND FACILITY RECONSTRUCTION,501,RICHMOND,P-D020,1550,905,93,0,0,0,0,0,998,905,93,0,0,0,0,0,998,1810,186,0,0,0,0,0,1996,,STATEN ISLAND,STATEN ISLAND BOTANICAL GARDEN,cpd11-20si.pdf
P-5SLVLK1,Silver Lake Park,846,DEPT OF PARKS AND RECREATION,NEIGHBORHOOD PARKS AND PLAYGROUNDS,500,RICHMOND,P-1018,1000,30,0,1000,0,0,0,0,1030,30,0,1000,0,0,0,0,1030,60,0,2000,0,0,0,0,2060,,"SILVER LAKE PARK, STATEN ISLAND",SILVER LAKE PARK,cpd11-20si.pdf
P-5TPSBF,Tappen Park & South Beach Fountain Reconstruction,846,DEPT OF PARKS AND RECREATION,NEIGHBORHOOD PARKS AND PLAYGROUNDS,500,RICHMOND,P-1018,166,26,140,0,0,0,0,0,166,26,140,0,0,0,0,0,166,52,280,0,0,0,0,0,332,,,TAPPEN PARK & SOUTH BEACH FOUNTAIN RECONSTRUCTION,cpd11-20si.pdf
P-5TRE14A,"FY14 Street Tree Planting, Staten Island CBs 1-3 (RG-1113M)",846,DEPT OF PARKS AND RECREATION,LAND ACQUISITION AND TREE PLANTING,500,RICHMOND,P-0822,1380,1417,111,0,0,0,0,0,1528,1417,111,0,0,0,0,0,1528,2834,222,0,0,0,0,0,3056,PROJECT DELAYED DUE TO CHANGES IN SCOPE/DESIGN,,PLANTING OF NEW AND REPLACEMENT STREET TREES AT VARIOUS LOCATIONS INCOMMUNITY,cpd11-20si.pdf
P-5TRE21A,"FY21 Street Trees Staten Island, CB 1-3 RG-",846,DEPT OF PARKS AND RECREATION,LAND ACQUISITION AND TREE PLANTING,500,RICHMOND,P-0822 HW-0001R,400,30,920,0,0,0,0,0,950,30,920,0,0,0,0,0,950,60,1840,0,0,0,0,0,1900,,"FY21 STREET TREES STATEN ISLAND, CB 1-3","FY21 STREET TREES STATEN ISLAND, CB 1-3",cpd11-20si.pdf
P-5TREEFA,Fairview Pk -Reforestation R153-117MA,846,DEPT OF PARKS AND RECREATION,LAND ACQUISITION AND TREE PLANTING,500,RICHMOND,P-0822,774,849,68,0,0,0,0,0,917,849,68,0,0,0,0,0,917,1698,136,0,0,0,0,0,1834,,FAIRVIEW PK -REFORESTATION,FAIRVIEW PK -REFORESTATION,cpd11-20si.pdf
P-5TRSD19,Staten Island-Tree-Damaged Sidewalk R/C,846,DEPT OF PARKS AND RECREATION,LAND ACQUISITION AND TREE PLANTING,500,RICHMOND,P-R245 P-1331,1490,1520,851,0,0,0,0,0,2371,1520,851,0,0,0,0,0,2371,3040,1702,0,0,0,0,0,4742,,STATEN ISLAND-TREE-DAMAGED SIDEWALK R/C,STATEN ISLAND-TREE-DAMAGED SIDEWALK R/C,cpd11-20si.pdf
P-5WBRKRF,Recon of Roofing systems at Willowbrook,846,DEPT OF PARKS AND RECREATION,NEIGHBORHOOD PARKS AND PLAYGROUNDS,500,RICHMOND,P-1018,321,15,279,0,0,0,0,0,294,15,279,0,0,0,0,0,294,30,558,0,0,0,0,0,588,,STATEN ISLAND,RECON OF ROOFING SYSTEMS AT WILLOWBROOK,cpd11-20si.pdf
P-5WHITEP,White Plgr-Hillside Slide Construction R012-,846,DEPT OF PARKS AND RECREATION,NEIGHBORHOOD PARKS AND PLAYGROUNDS,500,RICHMOND,P-0245R,1236,171,0,0,0,0,0,0,171,171,0,0,0,0,0,0,171,342,0,0,0,0,0,0,342,,LYMAN AVE,WHITE PLGR-HILLSIDE SLIDE CONSTRUCTION,cpd11-20si.pdf
P-5WPBERM,Wolfe's Pond Park Berm,846,DEPT OF PARKS AND RECREATION,NEIGHBORHOOD PARKS AND PLAYGROUNDS,500 503,RICHMOND,P-1018,1800,405,0,689,0,0,0,0,1094,405,0,689,0,0,0,0,1094,810,0,1378,0,0,0,0,2188,PROJECT DELAYED PENDING APPROVAL OF NECESSARY PERMITS,,WOLFE'S POND PARK BERM,cpd11-20si.pdf
P-5WPPLGR,Wolf Pond Pk Plgr R031-115M,846,DEPT OF PARKS AND RECREATION,NEIGHBORHOOD PARKS AND PLAYGROUNDS,500,RICHMOND,P-D020 P-1018,552,164,46,0,0,0,0,0,210,164,46,0,0,0,0,0,210,328,92,0,0,0,0,0,420,,WOLF POND PK PLGR,WOLF POND PK PLGR PART OF SANDY5-26,cpd11-20si.pdf
P-6PAVESI,Staten Island Pavement Reconstruction (SoGR) RG-120M,846,DEPT OF PARKS AND RECREATION,NEIGHBORHOOD PARKS AND PLAYGROUNDS,500,RICHMOND,P-1018,4500,0,0,0,0,2000,0,0,2000,0,0,0,0,2000,0,0,2000,0,0,0,0,4000,0,0,4000,,STATEN ISLAND,STATEN ISLAND PAVEMENT RECONSTRUCTION (SOGR),cpd11-20si.pdf
PV510-HLG,SIBG -SI BOTANICAL GARDEN Healing Garden R116-506M,846,DEPT OF PARKS AND RECREATION,ESSENTIAL RECONSTRUCTION OF FACILITIES,501,RICHMOND,PV-0510,1217,1120,0,53,0,0,0,0,1173,1120,0,53,0,0,0,0,1173,2240,0,106,0,0,0,0,2346,,"1000 RICHMOND TERRACE, STATEN ISLAND",DEVELOPMENT OF NEW GARDEN AREA OVERLOOKING THE WETLAND AND NEAR THE NY CHINESE,cpd11-20si.pdf
PV510-IRR,SIBG -SI BOTANICAL GARDEN Site Irrigation,846,DEPT OF PARKS AND RECREATION,ESSENTIAL RECONSTRUCTION OF FACILITIES,501,RICHMOND,PV-0510,817,805,0,165,0,0,0,0,970,805,0,165,0,0,0,0,970,1610,0,330,0,0,0,0,1940,,"1000 RICHMOND TERRACE, STATEN ISLAND",PROVIDE THREE WELLS AND UNDERGROUND WATER DISTRIBUTION SYSTEM.,cpd11-20si.pdf
SANDRP3,Crescent Beach Park Acquisition,846,DEPT OF PARKS AND RECREATION,LAND ACQUISITION AND TREE PLANTING,500,RICHMOND,PW-0319,0,0,0,0,0,0,0,0,0,0,0,0,0,0,0,0,0,0,0,0,0,0,0,0,0,,,ACQUISITION OF 4 LOTS AND 5 UNBUILT RECORD STREETS AS OPEN SPACE TO BE INCORPORATED,cpd11-20si.pdf
SANDY5-05,SANDY - Blissenbach Marina Demo (Type 3) R160-113M,846,DEPT OF PARKS AND RECREATION,NEIGHBORHOOD PARKS AND PLAYGROUNDS,500,RICHMOND,P-1018,0,254,0,102,0,0,0,0,356,254,0,102,0,0,0,0,356,508,0,204,0,0,0,0,712,PROJECT DELAYED DUE TO UNFORESEEN SITE/FIELD CONDITION,STATEN ISLAND,SANDY- BLISSENBACH MARINA DEMO & R/C,cpd11-20si.pdf
SANDY5-13,SANDY - SI Type 2 Plgrd R/C (RG-713M),846,DEPT OF PARKS AND RECREATION,NEIGHBORHOOD PARKS AND PLAYGROUNDS,500,RICHMOND,P-1018,2082,346,160,6,0,0,0,0,512,346,160,6,0,0,0,0,512,692,320,12,0,0,0,0,1024,PROJECT DELAYED PENDING APPROVAL OF NECESSARY PERMITS,SI,PLAYGROUNDS,cpd11-20si.pdf
SANDY5-16,Conference House Pk landscape (Type 3 ) R006-114M,846,DEPT OF PARKS AND RECREATION,NEIGHBORHOOD PARKS AND PLAYGROUNDS,500,RICHMOND,P-1018,2245,370,0,7,0,0,0,0,377,370,0,7,0,0,0,0,377,740,0,14,0,0,0,0,754,PROJECT DELAYED DUE TO UNFORESEEN SITE/FIELD CONDITION,"CONFERENCE HOUSE PARK, STATEN ISLAND",SANDY-R/C OF LANDSCAPE AT CONFERENCE HOUSE PARK,cpd11-20si.pdf
SANDY5-17,Tappen Park & Dolphin Fountains (Type3),846,DEPT OF PARKS AND RECREATION,NEIGHBORHOOD PARKS AND PLAYGROUNDS,500 501,RICHMOND,P-1018,383,570,44,0,0,0,0,0,614,570,44,0,0,0,0,0,614,1140,88,0,0,0,0,0,1228,PROJECT DELAYED DUE TO CHANGES IN SCOPE/DESIGN,"TAPPEN PK , SI",SANDY- R/C OF FONTAIN AT TAPPEN PK TYPE3,cpd11-20si.pdf
SANDY5-18,SANDY-Midland Beach Protective Berm Emergency,846,DEPT OF PARKS AND RECREATION,NEIGHBORHOOD PARKS AND PLAYGROUNDS,500,RICHMOND,P-1018,5492,548,55,0,0,0,0,0,603,548,55,0,0,0,0,0,603,1096,110,0,0,0,0,0,1206,PROJECT DELAYED DUE TO UNFORESEEN SITE/FIELD CONDITION,"FROM NEW DORP LANE TO OCEAN BREEZE PK, SI",EMERGENCY TEMP.PROTECTIVE BERM AT MIDLAND BCH,cpd11-20si.pdf
SANDY5-20,SANDY - Tree removals - Staten Island RG-614M,846,DEPT OF PARKS AND RECREATION,LAND ACQUISITION AND TREE PLANTING,500,RICHMOND,P-1018,815,173,11,0,0,0,0,0,184,173,11,0,0,0,0,0,184,346,22,0,0,0,0,0,368,PROJECT DELAYED DUE TO CHANGES IN SCOPE/DESIGN,BOROUGH OF STATEN ISLAND,TREE REMOVALS IN STATEN ISLAND RELATED TO SANDY,cpd11-20si.pdf
SANDY5-24,Sandy-Seaside Wildlife Nature Pk-reconstruction,846,DEPT OF PARKS AND RECREATION,MAJOR RECREATIONAL FACILITIES AND FACILITY RECONSTRUCTION,500,RICHMOND,P-1018,1135,1008,174,0,0,0,0,0,1182,1008,174,0,0,0,0,0,1182,2016,348,0,0,0,0,0,2364,,SANDY-SEASIDE WILDLIFE NATURE PK-,SANDY-SEASIDE WILDLIFE NATURE PK-RECONSTRUCTION,cpd11-20si.pdf
SANDY5-26,Sandy-R/C of playground at Wolfe's Pond Park,846,DEPT OF PARKS AND RECREATION,MAJOR RECREATIONAL FACILITIES AND FACILITY RECONSTRUCTION,500,RICHMOND,P-1018,842,480,8,1,0,0,0,0,489,480,8,1,0,0,0,0,489,960,16,2,0,0,0,0,978,PROJECT DELAYED DUE TO CHANGES IN SCOPE/DESIGN,SANDY-R/C OF WOLFE'S POND PARK,SANDY-R/C OF WOLFE'S POND PARK,cpd11-20si.pdf
SANDY5-27,Sandy-Wolfe's Pond Park-R/C of the berm,846,DEPT OF PARKS AND RECREATION,MAJOR RECREATIONAL FACILITIES AND FACILITY RECONSTRUCTION,500,RICHMOND,P-1018,2964,757,0,19,0,0,0,0,776,757,0,19,0,0,0,0,776,1514,0,38,0,0,0,0,1552,,"WOLFE'S POND PARK, SI",SANDY-R/C OF THE BERM AT WOLFE'S POND PARK,cpd11-20si.pdf
SANDY5-28,"Sandy-FDR bdwk & Midland Plgr-R/C of tthe pavements,etc",846,DEPT OF PARKS AND RECREATION,MAJOR RECREATIONAL FACILITIES AND FACILITY RECONSTRUCTION,500,RICHMOND,P-1018,651,38,0,28,0,0,0,0,66,38,0,28,0,0,0,0,66,76,0,56,0,0,0,0,132,PROJECT DELAYED DUE TO CHANGES IN SCOPE/DESIGN,"SANDY-R/C OF TTHE PAVEMENTS,ETC AT FDR BDWK & MIDLAND PLGR","SANDY-R/C OF TTHE PAVEMENTS,ETC AT FDR BDWK & MIDLAND PLGR",cpd11-20si.pdf
SANDY5-30,Sandy-New Dorp Bch Site Restor.R016-115M,846,DEPT OF PARKS AND RECREATION,MAJOR RECREATIONAL FACILITIES AND FACILITY RECONSTRUCTION,500,RICHMOND,P-1018,778,190,0,59,0,0,0,0,249,190,0,59,0,0,0,0,249,380,0,118,0,0,0,0,498,PROJECT DELAYED DUE TO UNFORESEEN SITE/FIELD CONDITION,SANDY-NEW DORP BCH,SANDY-NEW DORP BCH SITE RESTORATION,cpd11-20si.pdf
SANDY5-32,"Sandy-R/C of S. Bch-Playland Plgr, RG-212M WO 1",846,DEPT OF PARKS AND RECREATION,MAJOR RECREATIONAL FACILITIES AND FACILITY RECONSTRUCTION,500,RICHMOND,P-1018,373,138,95,0,0,0,0,0,233,138,95,0,0,0,0,0,233,276,190,0,0,0,0,0,466,PROJECT DELAYED DUE TO UNFORESEEN SITE/FIELD CONDITION,300 FATHER CAPODANO BLVD,R/C OF PLAYGROUND,cpd11-20si.pdf
SANDY5-36,SANDY - FDR BOARDWALK,846,DEPT OF PARKS AND RECREATION,BEACHES AND BOARDWALKS,500,RICHMOND,P-1018,350,47,0,0,0,26,0,0,73,47,0,0,0,26,0,0,73,94,0,0,0,52,0,0,146,PROJECT DELAYED DUE TO CHANGES IN SCOPE/DESIGN,,FDR BOARDWALK /BEACH AND SOUTH BEACH FOUNTAIN DOLPIN REPAIR,cpd11-20si.pdf
SANDY5-37,SANDY - BUONO BEACH FOUNTAIN REPAIR - R117-117MA,846,DEPT OF PARKS AND RECREATION,BEACHES AND BOARDWALKS,500,RICHMOND,P-1018,381,40,51,0,0,0,0,0,91,40,51,0,0,0,0,0,91,80,102,0,0,0,0,0,182,,,SANDY - BUONO BEACH FOUNTAIN REPAIR,cpd11-20si.pdf
SANDY5-42,Sandy-Conference House Barrier Rail RG-212M WO6,846,DEPT OF PARKS AND RECREATION,MAJOR RECREATIONAL FACILITIES AND FACILITY RECONSTRUCTION,500,RICHMOND,P-1018,293,29,6,0,0,0,0,0,35,29,6,0,0,0,0,0,35,58,12,0,0,0,0,0,70,,SANDY-CONFERENCE HOUSE BARRIER RAIL,SANDY-CONFERENCE HOUSE BARRIER RAIL,cpd11-20si.pdf
SANDY5-43,Lemon Creek Marina R079-120M,846,DEPT OF PARKS AND RECREATION,NEIGHBORHOOD PARKS AND PLAYGROUNDS,500,RICHMOND,P-1018,11807,306,11,0,1045,220,0,0,1582,306,11,0,1045,220,0,0,1582,612,22,0,2090,440,0,0,3164,,,LEMON CREEK MARINA,cpd11-20si.pdf
SANDY5-44,New Dorp Pk./Corp. Kivlehan Pk.,846,DEPT OF PARKS AND RECREATION,NEIGHBORHOOD PARKS AND PLAYGROUNDS,500,RICHMOND,P-1018,444,255,1,12,0,0,0,0,268,255,1,12,0,0,0,0,268,510,2,24,0,0,0,0,536,,,NEW DORP PK./CORP. KIVLEHAN PK.,cpd11-20si.pdf
SANDY5-45,SANDY-MacArthur Park Reconstruction,846,DEPT OF PARKS AND RECREATION,NEIGHBORHOOD PARKS AND PLAYGROUNDS,500,RICHMOND,P-1018,3342,1165,68,0,0,0,0,0,1233,1165,68,0,0,0,0,0,1233,2330,136,0,0,0,0,0,2466,,,TIMOSHENKO FIELD,cpd11-20si.pdf
SANDY5-46,Alice Austen Park (R117-115M),846,DEPT OF PARKS AND RECREATION,NEIGHBORHOOD PARKS AND PLAYGROUNDS,500,RICHMOND,P-1018,345,190,8,0,0,0,0,0,198,190,8,0,0,0,0,0,198,380,16,0,0,0,0,0,396,,,ALICE AUSTEN PARK (R117-115M),cpd11-20si.pdf
SANDY5-47,Midland Beach Bath House,846,DEPT OF PARKS AND RECREATION,MAJOR RECREATIONAL FACILITIES AND FACILITY RECONSTRUCTION,500,RICHMOND,P-1018,872,0,0,0,0,87,0,0,87,0,0,0,0,87,0,0,87,0,0,0,0,174,0,0,174,,,MIDLAND BEACH BATH HOUSE,cpd11-20si.pdf
SANDY5-48,Five Parks in SI,846,DEPT OF PARKS AND RECREATION,NEIGHBORHOOD PARKS AND PLAYGROUNDS,500,RICHMOND,P-1018,704,0,0,0,0,71,0,0,71,0,0,0,0,71,0,0,71,0,0,0,0,142,0,0,142,PROJECT DELAYED DUE TO CHANGES IN SCOPE/DESIGN,,FIVE PARKS IN SI,cpd11-20si.pdf
SANDY5-49,Fairview Park Comfort Station Construction,846,DEPT OF PARKS AND RECREATION,MAJOR RECREATIONAL FACILITIES AND FACILITY RECONSTRUCTION,503,RICHMOND,P-1018,0,50,9,0,0,0,0,0,59,50,9,0,0,0,0,0,59,100,18,0,0,0,0,0,118,,,FAIRVIEW PARK COMFORT STATION,cpd11-20si.pdf
SANDY5-50,Fairview Park Landscape Construction R153-118M,846,DEPT OF PARKS AND RECREATION,MAJOR RECREATIONAL FACILITIES AND FACILITY RECONSTRUCTION,503,RICHMOND,P-1018,0,778,225,101,0,0,0,0,1104,778,225,101,0,0,0,0,1104,1556,450,202,0,0,0,0,2208,,,FAIRVIEW PARK LANDSCAPE CONSTRUCTION,cpd11-20si.pdf
288CLOVE,REHABILITATION OF 288 CLOVE RD FACILITY,850,DEPT OF DESIGN & CONSTRUCTION,FACILITY PURCHASES AND RECONSTRUCTION,500,RICHMOND,EP-0006,30000,4699,66,3899,35600,600,0,0,44864,4699,66,3899,35600,600,0,0,44864,9398,132,7798,71200,1200,0,0,89728,,,"DEMOLITION OF EXISTING UNINHABITABLE BUILDING, CONSTRUCTION OF NEW BUILDING TO HOUSE",cpd11-20si.pdf
CO301LL,130 STUYVESANT PL - FACADE REPAIRS LOCAL LAW 11,850,DEPT OF DESIGN & CONSTRUCTION,RECONSTRUCTION/RENOVATION OF COURT FACILITIES,501,RICHMOND,CO-0301,3601,637,335,6740,0,0,0,0,7712,637,335,6740,0,0,0,0,7712,1274,670,13480,0,0,0,0,15424,PROJECT DELAYED DUE TO UNFORESEEN SITE/FIELD CONDITION,,130 STUYVESANT PL - FAÓADE REPAIRS LOCAL LAW 11,cpd11-20si.pdf
CO301PD,130 STUYVESANT PL.- PARKING GARAGE DECK,850,DEPT OF DESIGN & CONSTRUCTION,RECONSTRUCTION/RENOVATION OF COURT FACILITIES,501,RICHMOND,CO-0301,1401,832,311,3389,0,0,0,0,4532,832,311,3389,0,0,0,0,4532,1664,622,6778,0,0,0,0,9064,PROJECT DELAYED DUE TO UNFORESEEN SITE/FIELD CONDITION,,WATERPROOFING,cpd11-20si.pdf
CO302ST,18 RICHMOND TERRACE - EXTERIOR STEPS RECONSTRUCTION,850,DEPT OF DESIGN & CONSTRUCTION,RECONSTRUCTION/RENOVATION OF COURT FACILITIES,501,RICHMOND,CO-0302,2421,543,0,2354,0,0,0,0,2897,543,0,2354,0,0,0,0,2897,1086,0,4708,0,0,0,0,5794,,,DCAS - LANDMARK EXTERIOR STEPS,cpd11-20si.pdf
HAM18MHCC,Mariner's Harbor Community Center,850,DEPT OF DESIGN & CONSTRUCTION,LOW TO MODERATE INCOME PUBLIC HOUSING CONSTRUCTION,500,RICHMOND,HA-0001,5700,0,1300,4400,0,0,0,0,5700,0,1300,4400,0,0,0,0,5700,0,2600,8800,0,0,0,0,11400,,,FUNDING TO EXPAND THE COMMUNITY CENTER AT MARINER'S HARBOR,cpd11-20si.pdf
HL82SIABE,REHAB OF THE STATEN ISLAND ANIMAL SHELTER,850,DEPT OF DESIGN & CONSTRUCTION,ANIMAL CARE,,RICHMOND,HL-R001 HL-0082,2913,12225,613,0,0,0,0,0,12838,12225,613,0,0,0,0,0,12838,24450,1226,0,0,0,0,0,25676,PROJECT DELAYED DUE TO UNFORESEEN SITE/FIELD CONDITION,,REHAB OF THE STATEN ISLAND ANIMAL SHELTER,cpd11-20si.pdf
HWD104-05,RECON AND IMPROVEMENT OF AMBOY ROAD WITH HUGUENOT AVE SI,850,DEPT OF DESIGN & CONSTRUCTION,PRIMARY STREET RECONSTRUCTION,500 503,RICHMOND,HW-0001R,500,5226,0,0,0,0,0,0,5226,5226,0,0,0,0,0,0,5226,10452,0,0,0,0,0,0,10452,PROJECT DELAYED DUE TO UNFORESEEN SITE/FIELD CONDITION,,INCREASE BY 12LF THE WIDTH OF AMBOY ROAD ON A LENGTH OF 320LF; INCREASE THE RADIUS OF,cpd11-20si.pdf
HWP14RTA,CITYWIDE COMPLEX PED RAMPS (TRANSIT AUTHORITY) - SI,850,DEPT OF DESIGN & CONSTRUCTION,PEDESTRIAN RAMP CONSTRUCTION,500,RICHMOND,HW-0200,4602,6737,124,18,0,0,0,0,6879,6737,124,18,0,0,0,0,6879,13474,248,36,0,0,0,0,13758,PROJECT DELAYED DUE TO UNFORESEEN SITE/FIELD CONDITION,CITYWIDE COMPLEX PED RAMPS (TRANSIT AUTHORITY) - SI,CITYWIDE COMPLEX PED RAMPS (TRANSIT AUTHORITY) - SI,cpd11-20si.pdf
HWPR19R,Pedestrian Ramp Rehabilitation - Staten Island,850,DEPT OF DESIGN & CONSTRUCTION,PEDESTRIAN RAMP CONSTRUCTION,500,RICHMOND,HW-0200,16182,6147,9252,1746,0,0,0,0,17145,6147,9252,1746,0,0,0,0,17145,12294,18504,3492,0,0,0,0,34290,PROJECT DELAYED DUE TO UNFORESEEN SITE/FIELD CONDITION,,PEDESTRIAN RAMP REHABILITATION - STATEN ISLAND,cpd11-20si.pdf
HWR00505,VICTORY BLVD AND MANOR ROAD INTERSECTION IMPROVEMENT,850,DEPT OF DESIGN & CONSTRUCTION,PRIMARY STREET RECONSTRUCTION,500 501,RICHMOND,HW-D104 HW-0001R HW-0061,3882,12507,3237,0,0,5870,0,0,21614,12507,3237,0,0,5870,0,0,21614,25014,6474,0,0,11740,0,0,43228,PROJECT DELAYED DUE TO UNFORESEEN SITE/FIELD CONDITION,VICTORY BLVD AND MANOR ROAD,PROJECT WILL IMPROVE THE INTERSECTION OF VICTORY BLVD AND MANOR ROAD,cpd11-20si.pdf
HWR00508,AMBOY ROAD IMPROVEMENTS AT ELTINGVILLE CORRIDOR,850,DEPT OF DESIGN & CONSTRUCTION,PRIMARY STREET RECONSTRUCTION,500 503,RICHMOND,HW-R005 HW-0061 HW-0001R,3500,1907,14771,5991,0,0,0,0,22669,1907,14771,5991,0,0,0,0,22669,3814,29542,11982,0,0,0,0,45338,PROJECT DELAYED DUE TO UNFORESEEN SITE/FIELD CONDITION,AMBOY ROAD IMPROVEMENTS,AMBOY ROAD IMPROVEMENTS,cpd11-20si.pdf
HWR00510,Woodrow Rd Improvements btw Gladwin Ave & Veterans Rd East,850,DEPT OF DESIGN & CONSTRUCTION,PRIMARY STREET RECONSTRUCTION,500 503,RICHMOND,HW-R005 HW-0001R,1500,1409,0,2134,0,0,0,0,3543,1409,0,2134,0,0,0,0,3543,2818,0,4268,0,0,0,0,7086,PROJECT DELAYED DUE TO UNFORESEEN SITE/FIELD CONDITION,TO CONDUCT VARIOUS ROAD IMPROVEMENTS AT WOODROW ROAD BETWEEN BLOOMINGDALE ROAD,TO CONDUCT VARIOUS ROAD IMPROVEMENTS AT WOODROW ROAD BETWEEN BLOOMINGDALE ROAD,cpd11-20si.pdf
HWR00511,Travis Avenue Widening,850,DEPT OF DESIGN & CONSTRUCTION,PRIMARY STREET RECONSTRUCTION,500 502,RICHMOND,HW-R005 HW-0001R HW-D104,1700,1998,813,0,12551,0,0,0,15362,1998,813,0,12551,0,0,0,15362,3996,1626,0,25102,0,0,0,30724,PROJECT DELAYED DUE TO UNFORESEEN SITE/FIELD CONDITION,TO WIDEN TRAVIS AVE BTWN RICHMOND AVE & PARK DRIVE NORTH,TO WIDEN TRAVIS AVE BTWN RICHMOND AVE & PARK DRIVE NORTH,cpd11-20si.pdf
HWR00512,Richmond Valley Road,850,DEPT OF DESIGN & CONSTRUCTION,PRIMARY STREET RECONSTRUCTION,500,RICHMOND,HW-R005 HW-0061 HW-R988 HW-0001R HW-D104,3971,1535,2968,1764,4467,0,0,0,10734,1535,2968,1764,4467,0,0,0,10734,3070,5936,3528,8934,0,0,0,21468,PROJECT DELAYED DUE TO UNFORESEEN SITE/FIELD CONDITION,RICHMOND VALLEY ROAD,RICHMOND VALLEY ROAD,cpd11-20si.pdf
HWR005B,"TODT HILL ROAD CURVE REHAB,",850,DEPT OF DESIGN & CONSTRUCTION,PRIMARY STREET RECONSTRUCTION,502,RICHMOND,HW-R005 HW-0001R,3324,1403,500,0,0,0,0,13538,15441,1403,500,0,0,0,0,13538,15441,2806,1000,0,0,0,0,27076,30882,PROJECT DELAYED DUE TO CHANGES IN SCOPE/DESIGN,,,cpd11-20si.pdf
HWR005B1,TODT HILL ROAD - CIRCLE RD,850,DEPT OF DESIGN & CONSTRUCTION,PRIMARY STREET RECONSTRUCTION,500,RICHMOND,WM-0001,3150,889,0,0,1024,0,0,0,1913,889,0,0,1024,0,0,0,1913,1778,0,0,2048,0,0,0,3826,PROJECT DELAYED DUE TO UNFORESEEN SITE/FIELD CONDITION,TODT HILL ROAD - CIRCLE RD,TODT HILL ROAD - CIRCLE RD,cpd11-20si.pdf
HWR1140A,"ARTHUR KILL ROAD (PHASE I) - CLARKE AVE, RICHMOD AV, RED-366",850,DEPT OF DESIGN & CONSTRUCTION,PRIMARY STREET RECONSTRUCTION,503,RICHMOND,HW-0061 HW-1140 HW-D104,55985,5529,0,3640,0,15636,0,0,24805,5529,0,3640,0,15636,0,0,24805,11058,0,7280,0,31272,0,0,49610,PROJECT DELAYED DUE TO CHANGES IN SCOPE/DESIGN,,"RECONSTRUCTION OF EXISTING ROADWAYROADWAY RECONSTRUCTION SHALL INCLUDE NEW CURBS,",cpd11-20si.pdf
HWR1140B,ARTHUR KILL ROAD (PHASE II) - RICHMOND AVE AND HUGUENOT AVE,850,DEPT OF DESIGN & CONSTRUCTION,PRIMARY STREET RECONSTRUCTION,503,RICHMOND,WM-0001,14575,0,0,0,0,0,4559,0,4559,0,0,0,0,0,4559,0,4559,0,0,0,0,0,9118,0,9118,PROJECT DELAYED DUE TO CHANGES IN SCOPE/DESIGN,ARTHUR KILL ROAD (PHASE II) - RICHMOND AVE AND HUGUENOT AVE,ARTHUR KILL ROAD (PHASE II) - RICHMOND AVE AND HUGUENOT AVE,cpd11-20si.pdf
HWR1160,RE- ALIGN ROCKLAND AVE AT MANOR RD/MEISNER AVE,850,DEPT OF DESIGN & CONSTRUCTION,PRIMARY STREET RECONSTRUCTION,502,RICHMOND,HW-0001R,7020,178,0,0,0,21867,0,0,22045,178,0,0,0,21867,0,0,22045,356,0,0,0,43734,0,0,44090,PROJECT DELAYED DUE TO UNFORESEEN SITE/FIELD CONDITION,,,cpd11-20si.pdf
HWR300-03,ROAD WIDENING AT SOUTH AVENUE AND FOREST AVENUE,850,DEPT OF DESIGN & CONSTRUCTION,PRIMARY STREET RECONSTRUCTION,501,RICHMOND,HW-R061 HW-D104,500,6363,774,0,0,0,0,1400,8537,6363,774,0,0,0,0,1400,8537,12726,1548,0,0,0,0,2800,17074,PROJECT DELAYED DUE TO UNFORESEEN SITE/FIELD CONDITION,,ROAD WIDENING AT SOUTH AVENUE AND FOREST AVENUE,cpd11-20si.pdf
HWR669C,"RECONSTRUCTION OF ROMA, HETT, ETC",850,DEPT OF DESIGN & CONSTRUCTION,PRIMARY STREET RECONSTRUCTION,502,RICHMOND,HW-0061 WM-0001 HW-0001R SE-0002R SE-0200R HW-0669,11863,76939,7529,0,67,0,0,0,84535,76939,7529,0,67,0,0,0,84535,153878,15058,0,134,0,0,0,169070,PROJECT DELAYED DUE TO CHANGES IN SCOPE/DESIGN,,,cpd11-20si.pdf
HWR890,WOODROW RD,850,DEPT OF DESIGN & CONSTRUCTION,PRIMARY STREET RECONSTRUCTION,503,RICHMOND,HW-0890 TF-0502 TF-0002 HW-0200,19212,1651,0,0,0,0,0,18797,20448,1651,0,0,0,0,0,18797,20448,3302,0,0,0,0,0,37594,40896,PROJECT DELAYED DUE TO UNFORESEEN SITE/FIELD CONDITION,,RECONSTRUCTION OF WOODROW ROAD FR BLOOMINGDALE RD TO HUGUENOT AVENUEAND FROM,cpd11-20si.pdf
HWR919,BLOOMINGDALE ROAD,850,DEPT OF DESIGN & CONSTRUCTION,PRIMARY STREET RECONSTRUCTION,503,RICHMOND,HW-D104 HW-0919 TF-0502 TF-0002 HW-0200,10461,2321,0,0,0,250,0,35576,38147,2321,0,0,0,250,0,35576,38147,4642,0,0,0,500,0,71152,76294,PROJECT DELAYED DUE TO UNFORESEEN SITE/FIELD CONDITION,RECONSTRUCT AND WIDEN BLOOMINGDALE ROAD FROM AMBOY ROAD TO ARTHUR KILL ROAD,RECONSTRUCTION OF BLOOMINGDALE ROADRECONSTRUCTION OF THE EXISTING ROADWAYROADWAY,cpd11-20si.pdf
HWRF05R,Dubois Yard Roof,850,DEPT OF DESIGN & CONSTRUCTION,FACILITY RECONSTRUCTION,500,RICHMOND,HW-0003,700,1485,886,8243,0,0,0,0,10614,1485,886,8243,0,0,0,0,10614,2970,1772,16486,0,0,0,0,21228,PROJECT DELAYED DUE TO UNFORESEEN SITE/FIELD CONDITION,DUBOIS YARD ROOF,DUBOIS YARD ROOF,cpd11-20si.pdf
HWS2013R,PRIOR NOTICE SIDEWALKS - STATEN ISLAND,850,DEPT OF DESIGN & CONSTRUCTION,SIDEWALK RECONSTRUCTION,500,RICHMOND,HW-0200,2692,2259,0,0,0,0,0,49,2308,2259,0,0,0,0,0,49,2308,4518,0,0,0,0,0,98,4616,,PRIOR NOTICE SIDEWALKS - STATEN ISLAND,PRIOR NOTICE SIDEWALKS - STATEN ISLAND,cpd11-20si.pdf
HWS2020R,Prior Notice Sidewalks- Staten Island,850,DEPT OF DESIGN & CONSTRUCTION,SIDEWALK RECONSTRUCTION,500,RICHMOND,HW-0200 P-1018,3000,278,2849,213,0,0,0,0,3340,278,2849,213,0,0,0,0,3340,556,5698,426,0,0,0,0,6680,PROJECT DELAYED DUE TO BUDGETARY CONSTRAINTS,PRIOR NOTICE SIDEWALKS- STATEN ISLAND,PRIOR NOTICE SIDEWALKS- STATEN ISLAND,cpd11-20si.pdf
HWS2020X,Prior Notice Sidewalks- Bronx,850,DEPT OF DESIGN & CONSTRUCTION,SIDEWALK RECONSTRUCTION,500,RICHMOND,HW-0200 P-1018,5000,54,3061,207,0,0,0,0,3322,54,3061,207,0,0,0,0,3322,108,6122,414,0,0,0,0,6644,PROJECT DELAYED DUE TO BUDGETARY CONSTRAINTS,PRIOR NOTICE SIDEWALKS- BRONX,PRIOR NOTICE SIDEWALKS- BRONX,cpd11-20si.pdf
HWTRR1,Trench Restoration - Staten Island (SER002333),850,DEPT OF DESIGN & CONSTRUCTION,PRIMARY STREET RECONSTRUCTION,500,RICHMOND,HW-0001R,7011,1892,0,0,6232,0,0,0,8124,1892,0,0,6232,0,0,0,8124,3784,0,0,12464,0,0,0,16248,,,TRENCH RESTORARTION - STATEN ISLAND,cpd11-20si.pdf
LNCAL15TV,Tottenville,850,DEPT OF DESIGN & CONSTRUCTION,ESSENTIAL RECONSTRUCTION OF FACILITIES,500,RICHMOND,LN-D008 LN-D002 LN-0101M,715,690,225,0,0,0,0,0,915,690,225,0,0,0,0,0,915,1380,450,0,0,0,0,0,1830,PROJECT DELAYED DUE TO CHANGES IN SCOPE/DESIGN,,TOTTEENVILLE,cpd11-20si.pdf
LNEA13STG,ST GEORGE,850,DEPT OF DESIGN & CONSTRUCTION,ESSENTIAL RECONSTRUCTION OF FACILITIES,500 501,RICHMOND,LN-0008 LN-D008 LN-R001,3510,5232,1062,0,0,0,0,0,6294,5232,1062,0,0,0,0,0,6294,10464,2124,0,0,0,0,0,12588,PROJECT DELAYED DUE TO UNFORESEEN SITE/FIELD CONDITION,,EXTERIOR AND INTERIOR RENOVATION,cpd11-20si.pdf
LNEAL15RT,Richmond town,850,DEPT OF DESIGN & CONSTRUCTION,ESSENTIAL RECONSTRUCTION OF FACILITIES,500,RICHMOND,LN-0008,980,1614,227,0,0,0,0,0,1841,1614,227,0,0,0,0,0,1841,3228,454,0,0,0,0,0,3682,PROJECT DELAYED PENDING RESOLUTION OF LEGAL ISSUES,,RICHMONDTOWN,cpd11-20si.pdf
MIBBNC002,"Last Chance Pond BMP NC 11/12, storm & sanitary sewer constr",850,DEPT OF DESIGN & CONSTRUCTION,BLUEBELT PROGRAM,500,RICHMOND,SE-0005 SE-0200R,47890,39555,6071,0,0,0,0,0,45626,39555,6071,0,0,0,0,0,45626,79110,12142,0,0,0,0,0,91252,PROJECT DELAYED DUE TO UNFORESEEN SITE/FIELD CONDITION,,"LAST CHANCE POND BMP NC 11/12, STORM & SANITARY SEWER CONSTRUCTION AND WATER MAIN",cpd11-20si.pdf
MIBBNC003,"Strm & Sani Swr const & WM replac in Mason Ave, SI",850,DEPT OF DESIGN & CONSTRUCTION,BLUEBELT PROGRAM,502,RICHMOND,SE-0200R SE-0002R SE-0005,29452,38541,3088,0,0,0,0,0,41629,38541,3088,0,0,0,0,0,41629,77082,6176,0,0,0,0,0,83258,,,STORM & SANITARY SWEER CONSTRUCTION & WM REPLACEMENT IN MASON AVE B/TSLATER BLVD &,cpd11-20si.pdf
MIBBNC005,Storm Sewer Tributary for BMPs NC-13 and NC-14,850,DEPT OF DESIGN & CONSTRUCTION,BLUEBELT PROGRAM,502,RICHMOND,TF-0002 SE-0200R,53068,0,0,0,93,0,45357,0,45450,0,0,0,93,0,45357,0,45450,0,0,0,186,0,90714,0,90900,PROJECT DELAYED DUE TO UNFORESEEN SITE/FIELD CONDITION,,"BMP 13, 14 AND 15 STORM AND SANITARY SEWER CONSTRUCTION AND WATER MAIN REPLACEMENT IN",cpd11-20si.pdf
MIBBNC04A,BMP NC 6 and 15 storm & sanitary sewer installation,850,DEPT OF DESIGN & CONSTRUCTION,BLUEBELT PROGRAM,502,RICHMOND,SE-0005 SE-0200R SE-0002R WM-0001,34680,1420,8307,0,0,23222,0,0,32949,1420,8307,0,0,23222,0,0,32949,2840,16614,0,0,46444,0,0,65898,PROJECT DELAYED DUE TO UNFORESEEN SITE/FIELD CONDITION,,"MIBBNC04A-BMP NC 6, STORM & SANITARY SEWER INSTALLATION & WATER MAINREPLCMNT IN",cpd11-20si.pdf
MIBBNC04B,Storm and sanitary sewer installation,850,DEPT OF DESIGN & CONSTRUCTION,BLUEBELT PROGRAM,502,RICHMOND,SE-0200R SE-0002R WM-0001,30221,0,0,0,0,0,30221,0,30221,0,0,0,0,0,30221,0,30221,0,0,0,0,0,60442,0,60442,PROJECT DELAYED DUE TO UNFORESEEN SITE/FIELD CONDITION,,"MIBBNC04B-BMP NC 6, STORM AND SANITARY SEWER INSTALLATION AND WATER MAIN REPLACEMENT",cpd11-20si.pdf
MIBBNC05,Construction of BMPs NC-13 and NC-14 (SANDR01),850,DEPT OF DESIGN & CONSTRUCTION,BLUEBELT PROGRAM,502,RICHMOND,SE-0200R SE-0005 WM-0001,19512,16669,0,0,0,0,9362,0,26031,16669,0,0,0,0,9362,0,26031,33338,0,0,0,0,18724,0,52062,PROJECT DELAYED DUE TO UNFORESEEN SITE/FIELD CONDITION,,IN HYLAN BLVD. BET STOBE AVE. & SEAVER AVE.,cpd11-20si.pdf
P-5PNYC06,PlaNYC-Ocean Breeze Athletic Fac-Building Fit-Out R149-108M,850,DEPT OF DESIGN & CONSTRUCTION,"LARGE, MAJOR AND REGIONAL PARK RECONSTRUCTION",500 502,RICHMOND,P-R245 P-1018 P-0504 ED-D075,92343,106411,532,350,0,414,0,0,107707,106411,532,350,0,414,0,0,107707,212822,1064,700,0,828,0,0,215414,PROJECT DELAYED DUE TO BUDGETARY CONSTRAINTS,OCEAN BREEZE PARK IN STATEN ISLAND,CONSTRUCTION OF THE ATHLETIC FACILITY FIT-OUT,cpd11-20si.pdf
PV175AQUA,SIZ - Staten Island Zoo - Aquarium Reconstruction,850,DEPT OF DESIGN & CONSTRUCTION,ESSENTIAL RECONSTRUCTION OF FACILITIES,501,RICHMOND,PV-0175 PV-R175,1375,9616,42,0,0,0,0,0,9658,9616,42,0,0,0,0,0,9658,19232,84,0,0,0,0,0,19316,PROJECT DELAYED PENDING RESOLUTION OF LEGAL ISSUES,,"SCOPE OF WORK IS THE INSTALLATION OF NEW TANKS, WATER FILTERS AND NEWELECTRICAL",cpd11-20si.pdf
PV175ROOF,SIZ - Roof Replacement,850,DEPT OF DESIGN & CONSTRUCTION,ESSENTIAL RECONSTRUCTION OF FACILITIES,501,RICHMOND,PV-0175 PV-D175 PV-R175,3450,1673,2899,0,7,0,0,0,4579,1673,2899,0,7,0,0,0,4579,3346,5798,0,14,0,0,0,9158,PROJECT DELAYED DUE TO CHANGES IN SCOPE/DESIGN,,THE STATEN ISLAND ZOO IS REQUESTING CAPITAL FUNDS TO REPLACE THE ROOFOF THE ZOO'S MAIN,cpd11-20si.pdf
PV302BPH1,SIIAS - Building B at SHCC Phase1 Geo-Thermal & Ground Floor,850,DEPT OF DESIGN & CONSTRUCTION,ESSENTIAL RECONSTRUCTION OF FACILITIES,501,RICHMOND,PV-R302 PV-0302 PV-D302,5993,1767,2029,8280,0,0,0,0,12076,1767,2029,8280,0,0,0,0,12076,3534,4058,16560,0,0,0,0,24152,PROJECT DELAYED PENDING RESOLUTION OF LEGAL ISSUES,,SCOPE OF WORK IS THE INSTALLATION OF A GEO-THERMAL WELL FIELD WHICH WILL HEAT AND COOL,cpd11-20si.pdf
PV341BRIT,SIHS - Britton Cottage Restoration,850,DEPT OF DESIGN & CONSTRUCTION,ESSENTIAL RECONSTRUCTION OF FACILITIES,,RICHMOND,PV-0341 PV-R341 PV-D341,750,333,0,0,0,1098,0,0,1431,333,0,0,0,1098,0,0,1431,666,0,0,0,2196,0,0,2862,PROJECT DELAYED PENDING RESOLUTION OF LEGAL ISSUES,,BRITTON COTTAGE RESTORATION,cpd11-20si.pdf
PV477TEMP,SICM -Staten Island Children's Museum Temp Control System,850,DEPT OF DESIGN & CONSTRUCTION,ESSENTIAL RECONSTRUCTION OF FACILITIES,501,RICHMOND,PV-0477 PV-D477,4406,628,219,3673,0,0,0,0,4520,628,219,3673,0,0,0,0,4520,1256,438,7346,0,0,0,0,9040,,,STATEN ISLAND CHILDREN'S MUSEUM,cpd11-20si.pdf
PV490-C,SHCC - SHCC Main Hall Bldg C Roof Reconstruction,850,DEPT OF DESIGN & CONSTRUCTION,ESSENTIAL RECONSTRUCTION OF FACILITIES,,RICHMOND,PV-R490 PV-D490 PV-0490,600,603,1596,700,0,0,0,0,2899,603,1596,700,0,0,0,0,2899,1206,3192,1400,0,0,0,0,5798,PROJECT DELAYED DUE TO UNFORESEEN SITE/FIELD CONDITION,,SHCC BUILDING C ROOF RECONSTRUCTION,cpd11-20si.pdf
PV490ELEC,SHCC - Snug Harbor Cult. Ctr. Site - Wide Electrical Upgrade,850,DEPT OF DESIGN & CONSTRUCTION,ESSENTIAL RECONSTRUCTION OF FACILITIES,501,RICHMOND,PV-0490 PV-D490 PV-0467,5175,3654,3443,1971,0,0,0,0,9068,3654,3443,1971,0,0,0,0,9068,7308,6886,3942,0,0,0,0,18136,PROJECT DELAYED DUE TO UNFORESEEN SITE/FIELD CONDITION,"1000 RICHMOND TERRACE, STATEN ISLAND",PHASE 1 WILL INCLIUDE THE INSTALLATION OF NEW ELECTRICAL SERVICE ROOMWHICH WILL BE CODE,cpd11-20si.pdf
PV490-INF,SHCC - Site-wide Infrastructure Upgrade,850,DEPT OF DESIGN & CONSTRUCTION,ESSENTIAL RECONSTRUCTION OF FACILITIES,501,RICHMOND,PV-0490 PV-D490 PV-R490,11000,5107,9283,0,0,0,0,0,14390,5107,9283,0,0,0,0,0,14390,10214,18566,0,0,0,0,0,28780,PROJECT DELAYED DUE TO UNFORESEEN SITE/FIELD CONDITION,,"SITE-WIDE HVAC UPGRADE FOR SNUG HARBOR CAMPUS, INCLUDING COMPLETE REPLACEMENT OF",cpd11-20si.pdf
PV490-Q3,"SHCC - Snug Harbor Cult. Ctr. Music Hall, Dressing Rooms",850,DEPT OF DESIGN & CONSTRUCTION,ESSENTIAL RECONSTRUCTION OF FACILITIES,501,RICHMOND,PV-0490,3634,19102,1094,0,0,0,0,0,20196,19102,1094,0,0,0,0,0,20196,38204,2188,0,0,0,0,0,40392,PROJECT DELAYED PENDING RESOLUTION OF LEGAL ISSUES,"1000 RICHMOND TERRACE, STATEN ISLAND NY 10301",PROJECT SCOPE OF WORK IS TO SECURE FOR SHCC A FDNY CODE COMPLIANT FIRE ALARM FOR THE,cpd11-20si.pdf
PVC341-M,SIHS - SIHS TYSEN COURT RECONSTRUCTION,850,DEPT OF DESIGN & CONSTRUCTION,ESSENTIAL RECONSTRUCTION OF FACILITIES,502,RICHMOND,PV-D341 PV-0341,2825,12048,397,0,0,0,0,0,12445,12048,397,0,0,0,0,0,12445,24096,794,0,0,0,0,0,24890,PROJECT DELAYED PENDING RESOLUTION OF LEGAL ISSUES,NA,,cpd11-20si.pdf
PW348-74,FUEL TANK REPLACEMENT,850,DEPT OF DESIGN & CONSTRUCTION,LEGAL MANDATES AND CORRECTION OF UNSAFE CONDITIONS,,RICHMOND,PW-0348,12500,19000,11334,660,0,0,0,0,30994,19000,11334,660,0,0,0,0,30994,38000,22668,1320,0,0,0,0,61988,PROJECT DELAYED DUE TO BUDGETARY CONSTRAINTS,,FUEL TANKS,cpd11-20si.pdf
PWD5SOUTH,SOUTH SHORE LITTLE LEAGUE,850,DEPT OF DESIGN & CONSTRUCTION,MISCELLANEOUS CONSTRUCTION,503,RICHMOND,PW-D077 P-D020 PW-D005 PW-0077,1150,9439,52,0,377,0,0,0,9868,9439,52,0,377,0,0,0,9868,18878,104,0,754,0,0,0,19736,PROJECT DELAYED DUE TO UNFORESEEN SITE/FIELD CONDITION,,"500K FOR REHAB EXISTING FIELD AND INSTALL STADIUM SEATING, LIGHTS ANDSCOREBOARD. $150K",cpd11-20si.pdf
RED-366,WM WORK IN ARTHUR KILL RD BTW RICHMOND & ABINGTON AVES,850,DEPT OF DESIGN & CONSTRUCTION,TRUNK AND DISTRIBUTION MAIN REPLACEMENT,503,RICHMOND,WM-0001,589,187,0,0,0,9652,0,0,9839,187,0,0,0,9652,0,0,9839,374,0,0,0,19304,0,0,19678,PROJECT DELAYED DUE TO BUDGETARY CONSTRAINTS,,WATER MAIN WORK IN ARTHUR KILL RD BETWEEN RICHMOND AVE & ABINGDON AVE,cpd11-20si.pdf
RED-369,"CORE WM AREA CONTRACT, S.I. & BKLYN",850,DEPT OF DESIGN & CONSTRUCTION,TRUNK AND DISTRIBUTION MAIN REPLACEMENT,500,RICHMOND,WM-0001,3000,4195,219,0,0,0,0,0,4414,4195,219,0,0,0,0,0,4414,8390,438,0,0,0,0,0,8828,PROJECT DELAYED DUE TO UNFORESEEN SITE/FIELD CONDITION,,"RECONSTRUCTION OF WATER MAINS, S.I. & BKLYN",cpd11-20si.pdf
RED-372,"WM, PART OF RECON TRAVIS AVE FORM PARK DR N TO DRAPER PL",850,DEPT OF DESIGN & CONSTRUCTION,AUGMENTATION OF WATER SUPPLY SYSTEMS,501,RICHMOND,WM-0001 SE-0002R,901,150,0,0,3695,0,0,0,3845,150,0,0,3695,0,0,0,3845,300,0,0,7390,0,0,0,7690,PROJECT DELAYED DUE TO UNFORESEEN SITE/FIELD CONDITION,,"WM, PART OF RECON TRAVIS AVE FORM PARK DR N TO DRAPER PL",cpd11-20si.pdf
RED-376,Water Main Replacment and/or Lining in Clove Road,850,DEPT OF DESIGN & CONSTRUCTION,TRUNK AND DISTRIBUTION MAIN REPLACEMENT,501 502,RICHMOND,WM-0001,4821,10566,519,0,0,0,0,0,11085,10566,519,0,0,0,0,0,11085,21132,1038,0,0,0,0,0,22170,,,"WATER MAIN REPLCMNT AND/OR LINING IN CLOVE RD B/W MOSEL AVE & LAKEVIEW TERR., ETC.",cpd11-20si.pdf
RED-381,(SANDHWSI) Storm swr replacement ext. in Harold Avenue,850,DEPT OF DESIGN & CONSTRUCTION,REPLACEMENT OR AUGMENTATION OF EXISTING SYSTEMS,503,RICHMOND,SE-0200R WM-0001 EP-0007,2880,0,4105,0,0,0,0,0,4105,0,4105,0,0,0,0,0,4105,0,8210,0,0,0,0,0,8210,,,(SANDHWS) STORM SEWER EXTENSIONS IN HAROLD AVE FROM BAYVIEW TERRACE TO OCEAN,cpd11-20si.pdf
RED-386,"Water Main replacement, South & Arlington Aves, SI",850,DEPT OF DESIGN & CONSTRUCTION,AUGMENTATION OF WATER SUPPLY SYSTEMS,501,RICHMOND,WM-0001,7197,400,222,0,8421,0,0,0,9043,400,222,0,8421,0,0,0,9043,800,444,0,16842,0,0,0,18086,,,"INSTALLATION OF DISTRIBUTION WATER MAINS, SOUTH AVE B/T RICHMOND TERRACE, NETHERLAND",cpd11-20si.pdf
REDA-002,Accelerated Distribution WM replcmnt & sewer rehab,850,DEPT OF DESIGN & CONSTRUCTION,TRUNK AND DISTRIBUTION MAIN REPLACEMENT,500,RICHMOND,WM-0001,22090,21450,54,0,0,0,0,0,21504,21450,54,0,0,0,0,0,21504,42900,108,0,0,0,0,0,43008,,,"ACCELERATED DISTRIBUTION WATER MAIN REPLCMNT & SEWER REHABILITATION/REPLACEMENT,",cpd11-20si.pdf
REDA-003,Accelerated Distribution WM replcmnt & sewer rehab,850,DEPT OF DESIGN & CONSTRUCTION,TRUNK AND DISTRIBUTION MAIN REPLACEMENT,500,RICHMOND,WM-0001 SE-0002R SE-0200R,17175,33400,54,0,0,0,0,0,33454,33400,54,0,0,0,0,0,33454,66800,108,0,0,0,0,0,66908,PROJECT DELAYED DUE TO UNFORESEEN SITE/FIELD CONDITION,,"ACCELERATED DISTRIBUTION WATER MAIN REPLCMNT & SEWER REHABILITATION/REPLACEMENT,",cpd11-20si.pdf
S136-367,Staten Island 1 and 3 Garage Construction + SOLARGR10,850,DEPT OF DESIGN & CONSTRUCTION,GARAGES AND FACILITIES,501 503,RICHMOND,S-0136 PU-0025,143872,45789,124626,6501,0,0,0,0,176916,45789,124626,6501,0,0,0,0,176916,91578,249252,13002,0,0,0,0,353832,PROJECT DELAYED DUE TO UNFORESEEN SITE/FIELD CONDITION,,CONSTRUCTION OF NEW GARAGE,cpd11-20si.pdf
S136-383S,STATEN ISLAND 3 GARAGE HVAC,850,DEPT OF DESIGN & CONSTRUCTION,GARAGES AND FACILITIES,503,RICHMOND,S-0136,477,1836,21478,2139,0,0,0,0,25453,1836,21478,2139,0,0,0,0,25453,3672,42956,4278,0,0,0,0,50906,PROJECT DELAYED DUE TO CHANGES IN SCOPE/DESIGN,,HVAC REPLACEMENT,cpd11-20si.pdf
SAND669C,"Reconstruction of Roma,Hett,Etc - Hurricane Sandy",850,DEPT OF DESIGN & CONSTRUCTION,PRIMARY STREET RECONSTRUCTION,500,RICHMOND,HW-0001R,3748,171,38,0,92,0,0,0,301,171,38,0,92,0,0,0,301,342,76,0,184,0,0,0,602,PROJECT DELAYED DUE TO UNFORESEEN SITE/FIELD CONDITION,"RECONSTRUCTION OF ROMA,HETT,ETC - HURRICANE SANDY","RECONSTRUCTION OF ROMA,HETT,ETC - HURRICANE SANDY",cpd11-20si.pdf
SANDHW14,Reconstruction of South Beach - Hurricane Sandy - RED-375,850,DEPT OF DESIGN & CONSTRUCTION,PRIMARY STREET RECONSTRUCTION,500,RICHMOND,HW-0001R TF-0502,21204,6472,710,0,0,0,0,0,7182,6472,710,0,0,0,0,0,7182,12944,1420,0,0,0,0,0,14364,PROJECT DELAYED DUE TO UNFORESEEN SITE/FIELD CONDITION,RECONSTRUCTION OF SOUTH BEACH - HURRICANE SANDY,RECONSTRUCTION OF SOUTH BEACH - HURRICANE SANDY,cpd11-20si.pdf
SANDHW15,Reconstruction of Midland Beach - Hurricane Sandy,850,DEPT OF DESIGN & CONSTRUCTION,PRIMARY STREET RECONSTRUCTION,500,RICHMOND,WM-0001 HW-0001R,12825,4151,331,0,0,0,0,0,4482,4151,331,0,0,0,0,0,4482,8302,662,0,0,0,0,0,8964,PROJECT DELAYED DUE TO UNFORESEEN SITE/FIELD CONDITION,RECONSTRUCTION OF MIDLAND BEACH - HURRICANE SANDY,RECONSTRUCTION OF MIDLAND BEACH - HURRICANE SANDY,cpd11-20si.pdf
SANDHWSI,Non When & Where - Staten Island - Hurricane Sandy,850,DEPT OF DESIGN & CONSTRUCTION,PRIMARY STREET RECONSTRUCTION,500,RICHMOND,HW-0001R HW-0200 TF-0002 TF-0502,7589,578,4389,0,0,0,0,0,4967,578,4389,0,0,0,0,0,4967,1156,8778,0,0,0,0,0,9934,PROJECT DELAYED DUE TO UNFORESEEN SITE/FIELD CONDITION,NON WHEN AND WHERE - STATEN ISLAND HURRICANE SANDY,NON WHEN AND WHERE - STATEN ISLAND HURRICANE SANDY,cpd11-20si.pdf
SANDR01,Hylan Blvd Streetscape Improvements (MIBBNC05),850,DEPT OF DESIGN & CONSTRUCTION,PRIMARY STREET RECONSTRUCTION,500,RICHMOND,HW-0001R,1800,1596,570,0,0,0,0,0,2166,1596,570,0,0,0,0,0,2166,3192,1140,0,0,0,0,0,4332,PROJECT DELAYED DUE TO BUDGETARY CONSTRAINTS,HYLAN BLVD STREETSCAPE IMPROVEMENTS,HYLAN BLVD STREETSCAPE IMPROVEMENTS,cpd11-20si.pdf
SE-734,"SE-734 SAN SEWER IN RICHARD AVE, SI",850,DEPT OF DESIGN & CONSTRUCTION,EXTENSIONS TO ACCOMMODATE NEW DEVELOPMENT,503,RICHMOND,WM-0001,5405,22624,0,131,0,0,0,0,22755,22624,0,131,0,0,0,0,22755,45248,0,262,0,0,0,0,45510,PROJECT DELAYED DUE TO UNFORESEEN SITE/FIELD CONDITION,CONSTRUCTION OF SANITARY SEWERS IN RICHARD AVE FROM EASTWOOD AVE TO CLEARMONT AVE,"CONSTRUCTION OF SANITARY SEWERS IN RICHARD AVE FROM EASTWOOD AVE TO CLAVE,IN STATEN",cpd11-20si.pdf
SE-740B,SANITARY SEWERS IN ROCKLAND AVENUE,850,DEPT OF DESIGN & CONSTRUCTION,EXTENSIONS TO ACCOMMODATE NEW DEVELOPMENT,502,RICHMOND,SE-0740 WM-0001,10232,770,172,0,0,0,0,9798,10740,770,172,0,0,0,0,9798,10740,1540,344,0,0,0,0,19596,21480,PROJECT DELAYED DUE TO BUDGETARY CONSTRAINTS,SANITARY SEWERS IN ROCKLAND AVENUE,SANITARY SEWERS IN ROCKLAND AVENUE,cpd11-20si.pdf
SE-751,CHESTER AV - IRVINGTON ST AND ARBUTUS AVE,850,DEPT OF DESIGN & CONSTRUCTION,EXTENSIONS TO ACCOMMODATE NEW DEVELOPMENT,503,RICHMOND,SE-0002R WM-0001 SE-0200R,15870,2831,0,295,18301,0,0,0,21427,2831,0,295,18301,0,0,0,21427,5662,0,590,36602,0,0,0,42854,PROJECT DELAYED DUE TO UNFORESEEN SITE/FIELD CONDITION,CHESTER AV - IRVINGTON ST AND ARBUTUS AVE,CHESTER AV - IRVINGTON ST AND ARBUTUS AVE,cpd11-20si.pdf
SE-796,SANITARY SEWER IN RICHMOND VALLEY ROAD,850,DEPT OF DESIGN & CONSTRUCTION,EXTENSIONS TO ACCOMMODATE NEW DEVELOPMENT,503,RICHMOND,SE-0200R,18202,30088,180,0,0,0,0,0,30268,30088,180,0,0,0,0,0,30268,60176,360,0,0,0,0,0,60536,PROJECT DELAYED DUE TO UNFORESEEN SITE/FIELD CONDITION,,SANITARY SEWER IN RICHMOND VALLEY ROAD,cpd11-20si.pdf
SE-803,SAN & STRM SEWER IN RAMBLE ROAD B/T ADRIENNE PL & DENT ROAD,850,DEPT OF DESIGN & CONSTRUCTION,BLUEBELT PROGRAM,503,RICHMOND,SE-0002R WM-0001 SE-0200R SE-0005,12672,44954,4534,0,0,0,0,0,49488,44954,4534,0,0,0,0,0,49488,89908,9068,0,0,0,0,0,98976,PROJECT DELAYED DUE TO UNFORESEEN SITE/FIELD CONDITION,,SAN & STRM SEWER IN RAMBLE ROAD B/T ADRIENNE PL & DENT ROAD,cpd11-20si.pdf
SE-812,Sanitary & Storm swr in Page Av b/t Amboy Rd & Estella Pl,850,DEPT OF DESIGN & CONSTRUCTION,EXTENSIONS TO ACCOMMODATE NEW DEVELOPMENT,503,RICHMOND,HW-D104 HW-R005 SE-0200R SE-0002R WM-0001 HW-0001R SE-0005 HW-0061,15518,62324,2840,0,0,0,0,0,65164,62324,2840,0,0,0,0,0,65164,124648,5680,0,0,0,0,0,130328,PROJECT DELAYED DUE TO UNFORESEEN SITE/FIELD CONDITION,,SANITARY & STORM SWR IN PAGE AV B/T AMBOY RD & ESTELLA PL,cpd11-20si.pdf
SE-846,"New Storm & Sanitary Sewers Snug Harbor area, SI",850,DEPT OF DESIGN & CONSTRUCTION,BLUEBELT PROGRAM,501,RICHMOND,SE-0200R SE-0002R WM-0001 SE-0005,25884,600,0,0,0,0,0,23662,24262,600,0,0,0,0,0,23662,24262,1200,0,0,0,0,0,47324,48524,PROJECT DELAYED DUE TO UNFORESEEN SITE/FIELD CONDITION,,NEW STORM AND SAITARY SEWER EXTENSION AND REPLACMENT AND WM REPLACEMENT. RICHMOND,cpd11-20si.pdf
SER002237,Sanitary and Storm Sewer in Manee Avenue,850,DEPT OF DESIGN & CONSTRUCTION,REPLACEMENT OR AUGMENTATION OF EXISTING SYSTEMS,503,RICHMOND,SE-0002R SE-0200R,4113,0,0,0,4113,0,0,0,4113,0,0,0,4113,0,0,0,4113,0,0,0,8226,0,0,0,8226,PROJECT DELAYED DUE TO UNFORESEEN SITE/FIELD CONDITION,,"SANITARY AND STORM SEWER IN MANEE AVENUE BETWEEN AMBOY ROAD AND DEAD END, ETC",cpd11-20si.pdf
SER002274,"SAN SWR IN TWOMBLEY, HOPKINS, CEBRA, AVENUE",850,DEPT OF DESIGN & CONSTRUCTION,REPLACEMENT OF CHRONICALLY FAILING COMPONENTS,501 503,RICHMOND,SE-0200R,1071,4119,42,0,0,0,0,0,4161,4119,42,0,0,0,0,0,4161,8238,84,0,0,0,0,0,8322,PROJECT DELAYED DUE TO UNFORESEEN SITE/FIELD CONDITION,,SANITARY SEWER IN TWOMBLEY AVENUE (HOPKINS AVE. BUFFALO AVE) HOPKINS AVENUE (TWOMBLEY,cpd11-20si.pdf
SER002311,SAN & STRM SWR IN BERTRAM AV B/T ZEPHYR AV & HYLAN BLVD. ETC,850,DEPT OF DESIGN & CONSTRUCTION,EXTENSIONS TO ACCOMMODATE NEW DEVELOPMENT,503,RICHMOND,SE-0200R,6526,25536,317,0,0,0,0,0,25853,25536,317,0,0,0,0,0,25853,51072,634,0,0,0,0,0,51706,PROJECT DELAYED DUE TO UNFORESEEN SITE/FIELD CONDITION,,SAN & STRM SWR IN BERTRAM AV B/T ZEPHYR AV & HYLAN BLVD. ETC,cpd11-20si.pdf
SER002317,SAN & STRM SEWER IN HALPIN AVE,850,DEPT OF DESIGN & CONSTRUCTION,BLUEBELT PROGRAM,503,RICHMOND,SE-0002R SE-0200R WM-0001 SE-0005,11969,2737,181,0,1025,15484,0,0,19427,2737,181,0,1025,15484,0,0,19427,5474,362,0,2050,30968,0,0,38854,PROJECT DELAYED DUE TO UNFORESEEN SITE/FIELD CONDITION,,SAN & STRM SEWER IN HALPIN AVE,cpd11-20si.pdf
SER002320,SAN & STRM SWR IN DAHLIA ST B/T ROSEDALE AV & DEAD END ETC,850,DEPT OF DESIGN & CONSTRUCTION,EXTENSIONS TO ACCOMMODATE NEW DEVELOPMENT,503,RICHMOND,SE-0002R SE-0200R EP-0007 SE-1000 WM-0001,1799,5240,594,83,0,0,0,0,5917,5240,594,83,0,0,0,0,5917,10480,1188,166,0,0,0,0,11834,PROJECT DELAYED DUE TO UNFORESEEN SITE/FIELD CONDITION,,SAN & STRM SWR IN DAHLIA ST B/T ROSEDALE AV & DEAD END ETC,cpd11-20si.pdf
SER002323,SAN & STRM SWRS,850,DEPT OF DESIGN & CONSTRUCTION,EXTENSIONS TO ACCOMMODATE NEW DEVELOPMENT,501,RICHMOND,SE-0944 SE-0002R WM-0001,2711,10702,384,0,0,0,0,0,11086,10702,384,0,0,0,0,0,11086,21404,768,0,0,0,0,0,22172,,,"SAN & STRM SWR. CASTLE AVE B/T VAN NAME & SIMONSON AVE, SI",cpd11-20si.pdf
SER002324,New sanitary sewers in Camden ave. Staten Island,850,DEPT OF DESIGN & CONSTRUCTION,REPLACEMENT OR AUGMENTATION OF EXISTING SYSTEMS,503,RICHMOND,SE-0002R WM-0001 SE-0200R,2358,1304,1716,0,3722,0,0,0,6742,1304,1716,0,3722,0,0,0,6742,2608,3432,0,7444,0,0,0,13484,PROJECT DELAYED DUE TO UNFORESEEN SITE/FIELD CONDITION,,NEW SANITARY SEWERS IN CAMDEN AVE. STATEN ISLAND,cpd11-20si.pdf
SER002326,Storm and Sanitary Sewers in Wardwell Ave. S.I.,850,DEPT OF DESIGN & CONSTRUCTION,REPLACEMENT OR AUGMENTATION OF EXISTING SYSTEMS,501,RICHMOND,SE-0002R SE-0200R WM-0001,14281,20575,1330,0,0,0,0,0,21905,20575,1330,0,0,0,0,0,21905,41150,2660,0,0,0,0,0,43810,PROJECT DELAYED DUE TO UNFORESEEN SITE/FIELD CONDITION,,STORM AND SANITARY SEWERS IN WARDWELL AVE. BETWEEN LEONARD AVE AND DEAD END. PLUS,cpd11-20si.pdf
SER002329,"SAN, STM & WM IN LANDMARK COLONY",850,DEPT OF DESIGN & CONSTRUCTION,REPLACEMENT OR AUGMENTATION OF EXISTING SYSTEMS,500,RICHMOND,SE-0002R SE-0200R WM-0001,10046,440,0,13464,0,0,0,0,13904,440,0,13464,0,0,0,0,13904,880,0,26928,0,0,0,0,27808,,,"STORM, SAN & WM IN LANDMARK COLONY",cpd11-20si.pdf
SER200127,STORM SEWER IN ROCKLAND AV - RICHMOND RD AND MEISNER AV,850,DEPT OF DESIGN & CONSTRUCTION,EXTENSIONS TO ACCOMMODATE NEW DEVELOPMENT,502,RICHMOND,SE-0200R,3768,48,0,0,0,0,3721,0,3769,48,0,0,0,0,3721,0,3769,96,0,0,0,0,7442,0,7538,PROJECT DELAYED DUE TO CHANGES IN SCOPE/DESIGN,STORM SEWER IN ROCKLAND AV - RICHMOND RD AND MEISNER AV,STORM SEWER IN ROCKLAND AV - RICHMOND RD AND MEISNER AV,cpd11-20si.pdf
SER200128,STORM SEWER (BMP) IN ROCKLAND AV - RICHMOND RD & MEISNER AV,850,DEPT OF DESIGN & CONSTRUCTION,EXTENSIONS TO ACCOMMODATE NEW DEVELOPMENT,502,RICHMOND,SE-0200R,118,0,0,100,0,0,0,0,100,0,0,100,0,0,0,0,100,0,0,200,0,0,0,0,200,PROJECT DELAYED DUE TO CHANGES IN SCOPE/DESIGN,STORM SEWER (BMP) IN ROCKLAND AV - RICHMOND RD & MEISNER AV,STORM SEWER (BMP) IN ROCKLAND AV - RICHMOND RD & MEISNER AV,cpd11-20si.pdf
SER200151,"Stm & Sani swr ext. & WM replacement Amboy Rd, SI",850,DEPT OF DESIGN & CONSTRUCTION,EXTENSIONS TO ACCOMMODATE NEW DEVELOPMENT,503,RICHMOND,SE-0200R SE-0002R WM-0001 SE-0944,5654,13741,477,0,0,0,0,0,14218,13741,477,0,0,0,0,0,14218,27482,954,0,0,0,0,0,28436,,,"STORM & SANITARY SEWERS & WM REPLACEMNT AMBOY RD & SO. RAILROAD AVE, SI",cpd11-20si.pdf
SER200153,STORM SEWER IN FOREST HILL RD - TRAVIS AV & ROCKLAND AV,850,DEPT OF DESIGN & CONSTRUCTION,EXTENSIONS TO ACCOMMODATE NEW DEVELOPMENT,502,RICHMOND,SE-0200R,409,11,0,0,0,0,0,348,359,11,0,0,0,0,0,348,359,22,0,0,0,0,0,696,718,PROJECT DELAYED DUE TO CHANGES IN SCOPE/DESIGN,STORM SEWER IN FOREST HILL RD - TRAVIS AV & ROCKLAND AV,STORM SEWER IN FOREST HILL RD - TRAVIS AV & ROCKLAND AV,cpd11-20si.pdf
SER200200,"NEW STORM SEWER EXTENSION, VARIOUS LOC IN STATEN ISLAND",850,DEPT OF DESIGN & CONSTRUCTION,EXTENSIONS TO ACCOMMODATE NEW DEVELOPMENT,,RICHMOND,SE-0002R SE-0200R EP-0007,2434,7748,765,0,0,0,0,0,8513,7748,765,0,0,0,0,0,8513,15496,1530,0,0,0,0,0,17026,PROJECT DELAYED DUE TO BUDGETARY CONSTRAINTS,,NEW STORM SEWER IN O'GORMAN AVE. BTWN. BARTOW STREET AND TAUNTON STRAT,cpd11-20si.pdf
SER200202,New Stm. Swr. Ext. in Eagan Ave. S.I.,850,DEPT OF DESIGN & CONSTRUCTION,REPLACEMENT OR AUGMENTATION OF EXISTING SYSTEMS,503,RICHMOND,SE-0200R SE-0944 SE-0002R,4266,32601,742,0,0,0,0,0,33343,32601,742,0,0,0,0,0,33343,65202,1484,0,0,0,0,0,66686,PROJECT DELAYED DUE TO CHANGES IN SCOPE/DESIGN,,NEW STM. SWR. EXT. IN EAGAN AVE. AND WATER MAIN REPAIR IN KEEGANS LANE.,cpd11-20si.pdf
SER200219,storm swr ext in Cleveland Pl & Fingerboard Rd,850,DEPT OF DESIGN & CONSTRUCTION,EXTENSIONS TO ACCOMMODATE NEW DEVELOPMENT,501,RICHMOND,SE-0200R SE-0002R WM-0001 EP-0007 SE-1000,550,3483,484,0,0,0,0,0,3967,3483,484,0,0,0,0,0,3967,6966,968,0,0,0,0,0,7934,PROJECT DELAYED DUE TO UNFORESEEN SITE/FIELD CONDITION,,STORM SWR EXTENSION IN CLEVELAND PL & FINGERBOARD RD,cpd11-20si.pdf
SER200226,STORM AND SANITARY SEWERS & WM WORK IN TRAVIS AREA,850,DEPT OF DESIGN & CONSTRUCTION,EXTENSIONS TO ACCOMMODATE NEW DEVELOPMENT,500 502,RICHMOND,SE-0200R HW-0200 WM-0001 SE-0002R,13223,38288,3847,0,0,0,0,0,42135,38288,3847,0,0,0,0,0,42135,76576,7694,0,0,0,0,0,84270,PROJECT DELAYED DUE TO CHANGES IN SCOPE/DESIGN,,"STORM, SANITARY AND WATER MAIN WORK IN TRAVIS AREA.",cpd11-20si.pdf
SER200232,"STORM,SANIT SEWERS & WATER MAIN IN XENIA ST",850,DEPT OF DESIGN & CONSTRUCTION,REPLACEMENT OR AUGMENTATION OF EXISTING SYSTEMS,501,RICHMOND,HW-0200 SE-0200R SE-0002R WM-0001 EP-0007 SE-1000,1419,1101,5645,0,0,0,0,0,6746,1101,5645,0,0,0,0,0,6746,2202,11290,0,0,0,0,0,13492,PROJECT DELAYED DUE TO UNFORESEEN SITE/FIELD CONDITION,,STORM SANITARY SEWERS AND WATER MAIN IN XENIA STREET BETWEEN HURLBERTSTREET AND,cpd11-20si.pdf
SER200235,"Storm Sewer Extension in Richmond Ave & Amboy Rd, SI",850,DEPT OF DESIGN & CONSTRUCTION,EXTENSIONS TO ACCOMMODATE NEW DEVELOPMENT,503,RICHMOND,SE-0200R,3143,10460,929,0,0,145,0,0,11534,10460,929,0,0,145,0,0,11534,20920,1858,0,0,290,0,0,23068,PROJECT DELAYED DUE TO UNFORESEEN SITE/FIELD CONDITION,,"STRM SWR EXT RICHMOND AVE & AMBOY RD, SI",cpd11-20si.pdf
SER200236,"STRM SWR EXT & WM WORK IN NORTH AV, ETC.",850,DEPT OF DESIGN & CONSTRUCTION,REPLACEMENT OR AUGMENTATION OF EXISTING SYSTEMS,501,RICHMOND,HW-0200 TF-0002 SE-0200R EP-0007 SE-1000 SE-0002R WM-0001,1998,1325,109,8899,0,0,0,0,10333,1325,109,8899,0,0,0,0,10333,2650,218,17798,0,0,0,0,20666,,,"STRM SWR EXT & WM WORK IN NORTH AV, B/T NEAL DOW AV & LIVERMORE AV, STRM SWR EXT IN",cpd11-20si.pdf
SER200241,STRM & SWR IN BLOOMINGTON RD B/T AUTHUR KILL RD & PITNEY AVE,850,DEPT OF DESIGN & CONSTRUCTION,EXTENSIONS TO ACCOMMODATE NEW DEVELOPMENT,503,RICHMOND,SE-0002R,4658,19603,55,0,0,0,0,0,19658,19603,55,0,0,0,0,0,19658,39206,110,0,0,0,0,0,39316,PROJECT DELAYED DUE TO UNFORESEEN SITE/FIELD CONDITION,,"STRM & SWR IN BLOOMINGTON RD B/T AUTHUR KILL RD & PITNEY AVE, ETC (HWR-919)",cpd11-20si.pdf
SER200245,"NEW STRM SWR & WM REPLACEMT IN ACACIA AV, ETC.",850,DEPT OF DESIGN & CONSTRUCTION,REPLACEMENT OR AUGMENTATION OF EXISTING SYSTEMS,503,RICHMOND,SE-0002R SE-0200R SE-0005 WM-0001 EP-0007 HW-0200,21157,32697,4416,0,0,0,0,0,37113,32697,4416,0,0,0,0,0,37113,65394,8832,0,0,0,0,0,74226,PROJECT DELAYED DUE TO UNFORESEEN SITE/FIELD CONDITION,,NEW STORM SEWER AND WATER MAIN REPLACEMENT IN ACACIA AVENUE BETWEEN DEAD END AND,cpd11-20si.pdf
SER200247,New Storm Sewers in King St,850,DEPT OF DESIGN & CONSTRUCTION,REPLACEMENT OR AUGMENTATION OF EXISTING SYSTEMS,503,RICHMOND,SE-0002R WM-0001 WM-0006 SE-0200R,3406,489,0,6979,0,0,0,0,7468,489,0,6979,0,0,0,0,7468,978,0,13958,0,0,0,0,14936,,,NEW STORM SEWERS IN KING ST BETWEEN PRESTON AVE AND RIDGECREST AVE ETC,cpd11-20si.pdf
SER200251,EXT OF STRM SWR AND WM WORK IN 3RD ST,850,DEPT OF DESIGN & CONSTRUCTION,REPLACEMENT OR AUGMENTATION OF EXISTING SYSTEMS,502,RICHMOND,SE-0200R WM-0001 SE-0002R SE-1000 EP-0007 HW-0200,5354,1030,258,14853,0,0,0,0,16141,1030,258,14853,0,0,0,0,16141,2060,516,29706,0,0,0,0,32282,,,"EXT OF STRM SWR AND WM WORK IN 3RD ST, B/T NEW DORP LA AND STEELE AV",cpd11-20si.pdf
SER200255,"Stm. Swr. Ext. W. Cedarview Ave b/t Wolverine&Gilbert st, SI",850,DEPT OF DESIGN & CONSTRUCTION,REPLACEMENT OR AUGMENTATION OF EXISTING SYSTEMS,503,RICHMOND,SE-0200R SE-0002R,1470,8623,334,0,0,0,0,0,8957,8623,334,0,0,0,0,0,8957,17246,668,0,0,0,0,0,17914,,,STORM. SWR. EXTENSION AND WATER MAIN REPLACEMENT ON W. CEDARVIEW AVE B/T GILBERT &,cpd11-20si.pdf
SER200258,Sanitary and Storm Sewer in West Castor Place between Alvers,850,DEPT OF DESIGN & CONSTRUCTION,REPLACEMENT OR AUGMENTATION OF EXISTING SYSTEMS,503,RICHMOND,SE-0200R SE-0002R WM-0001 HW-0200 EP-0007 SE-0005,6587,1996,18174,0,0,0,0,0,20170,1996,18174,0,0,0,0,0,20170,3992,36348,0,0,0,0,0,40340,PROJECT DELAYED DUE TO UNFORESEEN SITE/FIELD CONDITION,,SANITARY AND STORM SEWER BETWEEN WEST CASTOR PLACE AND BETWEEN ALVERSON AVENUE,cpd11-20si.pdf
SER200261,Storm sewer in Roma Ave bet Tysens Lane & Ebbits Street,850,DEPT OF DESIGN & CONSTRUCTION,EXTENSIONS TO ACCOMMODATE NEW DEVELOPMENT,502,RICHMOND,SE-0200R WM-0001,1976,500,0,0,2312,0,0,0,2812,500,0,0,2312,0,0,0,2812,1000,0,0,4624,0,0,0,5624,PROJECT DELAYED DUE TO UNFORESEEN SITE/FIELD CONDITION,,STORM SEWER IN ROMA AVE BET TYSENS LANE & EBBITS STREET,cpd11-20si.pdf
SER200285,"NEW STM. SWR EXT. & WM REPL IN TODT HILL RD., SI",850,DEPT OF DESIGN & CONSTRUCTION,BLUEBELT PROGRAM,502,RICHMOND,SE-0200R WM-0001 SE-0005,7249,1080,0,0,14193,0,0,0,15273,1080,0,0,14193,0,0,0,15273,2160,0,0,28386,0,0,0,30546,PROJECT DELAYED DUE TO UNFORESEEN SITE/FIELD CONDITION,,NEW STM. SWR EXT. & WM REPL ACEMENT IN TODT HILL RD BETWEEN WILLOW POND RD & FOUR,cpd11-20si.pdf
SER200290,New Storm Sewer Ext & Water Main Replacement in Forest Ave,850,DEPT OF DESIGN & CONSTRUCTION,EXTENSIONS TO ACCOMMODATE NEW DEVELOPMENT,501,RICHMOND,SE-0200R WM-0001 SE-0002R,3675,650,0,0,0,3675,0,0,4325,650,0,0,0,3675,0,0,4325,1300,0,0,0,7350,0,0,8650,PROJECT DELAYED DUE TO UNFORESEEN SITE/FIELD CONDITION,,NEW STROM SEWER EXT & WATER MAIN REPLACEMENT IN FOREST AVE BETWEEN BROADWAY AND,cpd11-20si.pdf
SER200292,SAN & STRM SWR REPLACMT & WM WORK IN FLOYD ST,850,DEPT OF DESIGN & CONSTRUCTION,REPLACEMENT OR AUGMENTATION OF EXISTING SYSTEMS,501,RICHMOND,SE-0002R SE-0200R WM-0001,18099,600,0,0,13923,0,0,0,14523,600,0,0,13923,0,0,0,14523,1200,0,0,27846,0,0,0,29046,PROJECT DELAYED DUE TO UNFORESEEN SITE/FIELD CONDITION,,SAN & STRM SWR REPLACMT & WM WORK IN FLOYD ST,cpd11-20si.pdf
SER200309,"Strm swr R+Ext & WM Work, Maguire Avenue",850,DEPT OF DESIGN & CONSTRUCTION,REPLACEMENT OR AUGMENTATION OF EXISTING SYSTEMS,503,RICHMOND,SE-0200R WM-0001,5047,125,0,0,0,5048,0,0,5173,125,0,0,0,5048,0,0,5173,250,0,0,0,10096,0,0,10346,PROJECT DELAYED DUE TO UNFORESEEN SITE/FIELD CONDITION,,REPLACEMENT AND EXTENSION OF STORM SEWER IN MAGURIE AVENUE BETWEEN DEPEW PLACE AND,cpd11-20si.pdf
SER200552,STRM & SAN SWR AND WM WORK IN GRANITE AV,850,DEPT OF DESIGN & CONSTRUCTION,REPLACEMENT OR AUGMENTATION OF EXISTING SYSTEMS,501,RICHMOND,SE-0200R SE-0002R WM-0001,5603,382,0,0,0,4313,0,0,4695,382,0,0,0,4313,0,0,4695,764,0,0,0,8626,0,0,9390,PROJECT DELAYED DUE TO UNFORESEEN SITE/FIELD CONDITION,,"STRM & SAN SWR AND WM WORK IN GRANITE AV, B/T WALKER ST & DAVID PL",cpd11-20si.pdf
SER20079,"RECON OF STORM SEWER, WILLOW AV(TOMPKINS-EDGEWATER AVS)",850,DEPT OF DESIGN & CONSTRUCTION,REPLACEMENT OF CHRONICALLY FAILING COMPONENTS,501,RICHMOND,SE-0200R SE-0002R WM-0001 SE-0944 SE-1000 HW-0200 EP-0007,1343,709,13446,0,0,0,0,0,14155,709,13446,0,0,0,0,0,14155,1418,26892,0,0,0,0,0,28310,PROJECT DELAYED DUE TO UNFORESEEN SITE/FIELD CONDITION,N/A,,cpd11-20si.pdf
SOLARDOS2,Staten Island 3 Garage HVAC,850,DEPT OF DESIGN & CONSTRUCTION,"BUILDING CONSTRUCTION, RECONSTRUCTION OR RETROFIT",503,RICHMOND,PU-0025,755,65,1455,2009,0,0,0,0,3529,65,1455,2009,0,0,0,0,3529,130,2910,4018,0,0,0,0,7058,PROJECT DELAYED DUE TO UNFORESEEN SITE/FIELD CONDITION,,,cpd11-20si.pdf
SOLARGR10,DSNY - PV INSTALLATION ON NEW GARAGE- STATEN ISLAND 1/3,850,DEPT OF DESIGN & CONSTRUCTION,DISTRIBUTED GENERATION,501,RICHMOND,PU-0025,7601,335,6751,1400,0,0,0,0,8486,335,6751,1400,0,0,0,0,8486,670,13502,2800,0,0,0,0,16972,,,DSNY - PV INSTALLATION ON NEW GARAGE- STATEN ISLAND 1/3,cpd11-20si.pdf
CO276EXT2,100 Richmond Terrace - Family Court/ Exterior,856,DEPT OF CITYWIDE ADMIN SERVS,RECONSTRUCTION/RENOVATION OF COURT FACILITIES,501,RICHMOND,CO-0276,4414,0,0,0,0,0,0,4414,4414,0,0,0,0,0,0,4414,4414,0,0,0,0,0,0,8828,8828,PROJECT DELAYED DUE TO BUDGETARY CONSTRAINTS,,EXTERIOR OF COURTHOUSE,cpd11-20si.pdf
CO287R-1,DASNY - NEW STATEN ISLAND SUPREME COURT,856,DEPT OF CITYWIDE ADMIN SERVS,CONSTRUCTION OF NEW COURT FACILITIES,501,RICHMOND,CO-0287,213781,5726,0,1976,0,0,0,0,7702,5726,0,1976,0,0,0,0,7702,11452,0,3952,0,0,0,0,15404,PROJECT DELAYED DUE TO CHANGES IN SCOPE/DESIGN,"STATEN ISLAND, NY 10301",CONSTRUCTION OF AN ENTIRE NEW BUILDING,cpd11-20si.pdf
CO301FA,130 STUYVESANT PL.- FIRE ALARM/SPRINKLER,856,DEPT OF CITYWIDE ADMIN SERVS,RECONSTRUCTION/RENOVATION OF COURT FACILITIES,501,RICHMOND,CO-0301,13000,0,0,1000,0,12000,0,0,13000,0,0,1000,0,12000,0,0,13000,0,0,2000,0,24000,0,0,26000,PROJECT DELAYED DUE TO BUDGETARY CONSTRAINTS,,130 STUYVESANT PL.- FIRE ALARM/SPRINKLER,cpd11-20si.pdf
CO301HV1,130 STUYVESANT PL.- CHILLER AND BOILER,856,DEPT OF CITYWIDE ADMIN SERVS,RECONSTRUCTION/RENOVATION OF COURT FACILITIES,501,RICHMOND,CO-0301,5791,0,0,345,0,5426,0,0,5771,0,0,345,0,5426,0,0,5771,0,0,690,0,10852,0,0,11542,,,130 STUYVESANT PLACE - CHILLER AND BOILER REPLACEMEN,cpd11-20si.pdf
EO26-0072,NYPD - 123RD PRECINCT,856,DEPT OF CITYWIDE ADMIN SERVS,"BUILDING CONSTRUCTION, RECONSTRUCTION OR RETROFIT",501,RICHMOND,PU-0025,300,0,0,300,0,0,0,0,300,0,0,300,0,0,0,0,300,0,0,600,0,0,0,0,600,PROJECT DELAYED DUE TO CHANGES IN SCOPE/DESIGN,,IA/SQ,cpd11-20si.pdf
EO26-0076,NYPD - 122ND PRECINCT,856,DEPT OF CITYWIDE ADMIN SERVS,"BUILDING CONSTRUCTION, RECONSTRUCTION OR RETROFIT",501,RICHMOND,PU-0025,300,0,0,299,0,0,0,0,299,0,0,299,0,0,0,0,299,0,0,598,0,0,0,0,598,PROJECT DELAYED DUE TO CHANGES IN SCOPE/DESIGN,,IA/SQ,cpd11-20si.pdf
PW29310R,10 RICHMOND TERRACE - FIRE ALARM,856,DEPT OF CITYWIDE ADMIN SERVS,LEGAL MANDATES AND CORRECTION OF UNSAFE CONDITIONS,501,RICHMOND,PW-0293,11216,0,792,1389,8870,0,0,0,11051,0,792,1389,8870,0,0,0,11051,0,1584,2778,17740,0,0,0,22102,PROJECT DELAYED DUE TO BUDGETARY CONSTRAINTS,,10 RICHMOND TERRACE - FIRE ALARM,cpd11-20si.pdf
PW326DOFR,DOF - 350 ST. MARK'S PLACE - LEASED SPACE,856,DEPT OF CITYWIDE ADMIN SERVS,RENOVATION OF LEASED SPACE,501,RICHMOND,PW-0326,1544,0,0,0,0,1591,0,0,1591,0,0,0,0,1591,0,0,1591,0,0,0,0,3182,0,0,3182,PROJECT DELAYED DUE TO BUDGETARY CONSTRAINTS,,350 ST. MARK'S PLACE - DOF LEASED SPACE,cpd11-20si.pdf
PW326RAR,LAW DEPT - RAISE THE AGE -SI,856,DEPT OF CITYWIDE ADMIN SERVS,RENOVATION OF LEASED SPACE,501,RICHMOND,PW-0326,2697,0,0,2697,0,0,0,0,2697,0,0,2697,0,0,0,0,2697,0,0,5394,0,0,0,0,5394,,,LAW DEPT - RAISE THE AGE -SI,cpd11-20si.pdf
PW326RHP,OCA RELOCATION FROM HOMEPORT - STATEN ISLAND,856,DEPT OF CITYWIDE ADMIN SERVS,RENOVATION OF LEASED SPACE,500 501,RICHMOND,ED-0075,1012,2767,160,0,0,0,0,0,2927,2767,160,0,0,0,0,0,2927,5534,320,0,0,0,0,0,5854,PROJECT DELAYED DUE TO CHANGES IN SCOPE/DESIGN,,RELOCATION FROM HOMEPORT - STATEN ISLAND - DUE TO MAYOR'S REDEVELOPMENT PLAN,cpd11-20si.pdf
PW77501BL,10 RICHMOND TERR.- BOILER REPLACEMENT,856,DEPT OF CITYWIDE ADMIN SERVS,REHABILITATION OF CITY-OWNED OFFICE SPACE,501,RICHMOND,PW-0077,1307,0,0,200,985,0,0,0,1185,0,0,200,985,0,0,0,1185,0,0,400,1970,0,0,0,2370,,,SQ FT,cpd11-20si.pdf
PW77501DB,10 RICHMOND TERRACE - 2nd & 3rd FLs DOB RENOVATION,856,DEPT OF CITYWIDE ADMIN SERVS,REHABILITATION OF CITY-OWNED OFFICE SPACE,501,RICHMOND,PW-0077,6322,0,0,0,893,0,4909,0,5802,0,0,0,893,0,4909,0,5802,0,0,0,1786,0,9818,0,11604,,,SQ/IA,cpd11-20si.pdf
PW77501EL,10 RICHMOND TERRACE- ELECTRICAL UPGRADE,856,DEPT OF CITYWIDE ADMIN SERVS,REHABILITATION OF CITY-OWNED OFFICE SPACE,500 501,RICHMOND,PW-0077,5900,3770,0,110,0,0,0,0,3880,3770,0,110,0,0,0,0,3880,7540,0,220,0,0,0,0,7760,PROJECT DELAYED DUE TO BUDGETARY CONSTRAINTS,,10 RICHMOND TERRACE ELECTRICAL UPGRADE,cpd11-20si.pdf
PW77SEC3,130 STUYVESANT PLACE- SECURITY BARRIER SI DA,856,DEPT OF CITYWIDE ADMIN SERVS,REHABILITATION OF CITY-OWNED OFFICE SPACE,501,RICHMOND,PW-0077,292,0,0,181,0,0,0,0,181,0,0,181,0,0,0,0,181,0,0,362,0,0,0,0,362,PROJECT DELAYED DUE TO BUDGETARY CONSTRAINTS,,130 STUYVESANT PLACE SECURITY BARRIER FOR SI DA,cpd11-20si.pdf
PWR077MUR,18 RICHMOND TERRACE- STATEN ISLAND COURTHOUSE MURALS,856,DEPT OF CITYWIDE ADMIN SERVS,REHABILITATION OF COURT BUILDINGS,501,RICHMOND,PW-R077,50,0,0,0,0,0,0,50,50,0,0,0,0,0,0,50,50,0,0,0,0,0,0,100,100,PROJECT DELAYED DUE TO BUDGETARY CONSTRAINTS,,PERFORM NECESSARY CONSTRUCTION ASSOCIATED WITH THE TRANSFER OF COURTHOUSE MURALS,cpd11-20si.pdf
PWR77GRGE,ST. GEORGE COURTHOUSE & HYATT STREET PLAZA,856,DEPT OF CITYWIDE ADMIN SERVS,REHABILITATION OF CITY-OWNED OFFICE SPACE,500 501,RICHMOND,PW-R077,1518,0,0,0,0,0,780,0,780,0,0,0,0,0,780,0,780,0,0,0,0,0,1560,0,1560,PROJECT DELAYED DUE TO BUDGETARY CONSTRAINTS,,ST. GEORGE COURTHOUSE & HYATT STREET PLAZA,cpd11-20si.pdf
STGESPLND,ST. GEORGE ESPLANADE,856,DEPT OF CITYWIDE ADMIN SERVS,WATERFRONT DEVELOPMENT,501,RICHMOND,PW-R077,4760,3317,0,800,0,0,0,0,4117,3317,0,800,0,0,0,0,4117,6634,0,1600,0,0,0,0,8234,PROJECT DELAYED DUE TO CHANGES IN SCOPE/DESIGN,ST. GEORGE ESPLANADE STATEN ISLAND,RECONSTRUCTION,cpd11-20si.pdf
DATACENTR,FISA Alternative Data Center,858,DEPT OF INFO TECH & TELECOMM,RENOVATION OF LEASED SPACE,501,RICHMOND,PW-0326,30450,2435,0,8000,5207,0,0,0,15642,2435,0,8000,5207,0,0,0,15642,4870,0,16000,10414,0,0,0,31284,,,DOITT BACK UP FACILITY TO BE MOVED TO CORPORATE COMMONS,cpd11-20si.pdf
